YearKey;MonthKey;WeekKey;Date;Ålder;KVINNOR;MAN;TOTAL
2016;December;49;2016-12-01 00:00;0;143;169;312
2016;December;49;2016-12-01 00:00;1;166;183;349
2016;December;49;2016-12-01 00:00;2;168;194;362
2016;December;49;2016-12-01 00:00;3;189;210;399
2016;December;49;2016-12-01 00:00;4;190;185;375
2016;December;49;2016-12-01 00:00;5;203;226;429
2016;December;49;2016-12-01 00:00;6;205;223;428
2016;December;49;2016-12-01 00:00;7;196;210;406
2016;December;49;2016-12-01 00:00;8;188;186;374
2016;December;49;2016-12-01 00:00;9;180;198;378
2016;December;49;2016-12-01 00:00;10;218;199;417
2016;December;49;2016-12-01 00:00;11;183;202;385
2016;December;49;2016-12-01 00:00;12;183;195;378
2016;December;49;2016-12-01 00:00;13;177;184;361
2016;December;49;2016-12-01 00:00;14;175;216;391
2016;December;49;2016-12-01 00:00;15;143;177;320
2016;December;49;2016-12-01 00:00;16;180;202;382
2016;December;49;2016-12-01 00:00;17;180;190;370
2016;December;49;2016-12-01 00:00;18;157;169;326
2016;December;49;2016-12-01 00:00;19;160;198;358
2016;December;49;2016-12-01 00:00;20;171;172;343
2016;December;49;2016-12-01 00:00;21;154;185;339
2016;December;49;2016-12-01 00:00;22;166;182;348
2016;December;49;2016-12-01 00:00;23;185;190;375
2016;December;49;2016-12-01 00:00;24;168;199;367
2016;December;49;2016-12-01 00:00;25;161;224;385
2016;December;49;2016-12-01 00:00;26;179;192;371
2016;December;49;2016-12-01 00:00;27;147;174;321
2016;December;49;2016-12-01 00:00;28;166;175;341
2016;December;49;2016-12-01 00:00;29;166;186;352
2016;December;49;2016-12-01 00:00;30;154;166;320
2016;December;49;2016-12-01 00:00;31;164;169;333
2016;December;49;2016-12-01 00:00;32;175;166;341
2016;December;49;2016-12-01 00:00;33;199;171;370
2016;December;49;2016-12-01 00:00;34;195;187;382
2016;December;49;2016-12-01 00:00;35;155;170;325
2016;December;49;2016-12-01 00:00;36;219;184;403
2016;December;49;2016-12-01 00:00;37;202;156;358
2016;December;49;2016-12-01 00:00;38;180;200;380
2016;December;49;2016-12-01 00:00;39;179;197;376
2016;December;49;2016-12-01 00:00;40;212;214;426
2016;December;49;2016-12-01 00:00;41;218;238;456
2016;December;49;2016-12-01 00:00;42;225;269;494
2016;December;49;2016-12-01 00:00;43;203;216;419
2016;December;49;2016-12-01 00:00;44;224;245;469
2016;December;49;2016-12-01 00:00;45;215;216;431
2016;December;49;2016-12-01 00:00;46;209;215;424
2016;December;49;2016-12-01 00:00;47;210;200;410
2016;December;49;2016-12-01 00:00;48;219;226;445
2016;December;49;2016-12-01 00:00;49;245;236;481
2016;December;49;2016-12-01 00:00;50;186;224;410
2016;December;49;2016-12-01 00:00;51;198;213;411
2016;December;49;2016-12-01 00:00;52;191;223;414
2016;December;49;2016-12-01 00:00;53;181;216;397
2016;December;49;2016-12-01 00:00;54;188;188;376
2016;December;49;2016-12-01 00:00;55;155;167;322
2016;December;49;2016-12-01 00:00;56;158;153;311
2016;December;49;2016-12-01 00:00;57;158;171;329
2016;December;49;2016-12-01 00:00;58;154;162;316
2016;December;49;2016-12-01 00:00;59;148;163;311
2016;December;49;2016-12-01 00:00;60;146;154;300
2016;December;49;2016-12-01 00:00;61;137;130;267
2016;December;49;2016-12-01 00:00;62;137;140;277
2016;December;49;2016-12-01 00:00;63;150;144;294
2016;December;49;2016-12-01 00:00;64;144;161;305
2016;December;49;2016-12-01 00:00;65;147;142;289
2016;December;49;2016-12-01 00:00;66;146;159;305
2016;December;49;2016-12-01 00:00;67;156;166;322
2016;December;49;2016-12-01 00:00;68;176;167;343
2016;December;49;2016-12-01 00:00;69;168;165;333
2016;December;49;2016-12-01 00:00;70;186;153;339
2016;December;49;2016-12-01 00:00;71;189;181;370
2016;December;49;2016-12-01 00:00;72;157;165;322
2016;December;49;2016-12-01 00:00;73;159;172;331
2016;December;49;2016-12-01 00:00;74;144;139;283
2016;December;49;2016-12-01 00:00;75;115;107;222
2016;December;49;2016-12-01 00:00;76;86;127;213
2016;December;49;2016-12-01 00:00;77;91;98;189
2016;December;49;2016-12-01 00:00;78;98;81;179
2016;December;49;2016-12-01 00:00;79;83;84;167
2016;December;49;2016-12-01 00:00;80;93;75;168
2016;December;49;2016-12-01 00:00;81;67;68;135
2016;December;49;2016-12-01 00:00;82;75;52;127
2016;December;49;2016-12-01 00:00;83;61;50;111
2016;December;49;2016-12-01 00:00;84;36;42;78
2016;December;49;2016-12-01 00:00;85;51;34;85
2016;December;49;2016-12-01 00:00;86;49;31;80
2016;December;49;2016-12-01 00:00;87;39;27;66
2016;December;49;2016-12-01 00:00;88;34;23;57
2016;December;49;2016-12-01 00:00;89;34;14;48
2016;December;49;2016-12-01 00:00;90;27;15;42
2016;December;49;2016-12-01 00:00;91;22;10;32
2016;December;49;2016-12-01 00:00;92;15;10;25
2016;December;49;2016-12-01 00:00;93;13;9;22
2016;December;49;2016-12-01 00:00;94;17;5;22
2016;December;49;2016-12-01 00:00;95;7;5;12
2016;December;49;2016-12-01 00:00;96;4;4;8
2016;December;49;2016-12-01 00:00;97;0;1;1
2016;December;49;2016-12-01 00:00;98;2;2;4
2016;December;49;2016-12-01 00:00;99;1;2;3
2016;December;49;2016-12-01 00:00;104;1;0;1
2016;December;50;2016-12-07 00:00;0;143;169;312
2016;December;50;2016-12-07 00:00;1;166;185;351
2016;December;50;2016-12-07 00:00;2;168;195;363
2016;December;50;2016-12-07 00:00;3;190;210;400
2016;December;50;2016-12-07 00:00;4;190;189;379
2016;December;50;2016-12-07 00:00;5;203;228;431
2016;December;50;2016-12-07 00:00;6;205;223;428
2016;December;50;2016-12-07 00:00;7;196;210;406
2016;December;50;2016-12-07 00:00;8;189;187;376
2016;December;50;2016-12-07 00:00;9;180;198;378
2016;December;50;2016-12-07 00:00;10;219;199;418
2016;December;50;2016-12-07 00:00;11;185;202;387
2016;December;50;2016-12-07 00:00;12;183;195;378
2016;December;50;2016-12-07 00:00;13;177;184;361
2016;December;50;2016-12-07 00:00;14;175;216;391
2016;December;50;2016-12-07 00:00;15;144;177;321
2016;December;50;2016-12-07 00:00;16;180;202;382
2016;December;50;2016-12-07 00:00;17;180;190;370
2016;December;50;2016-12-07 00:00;18;156;170;326
2016;December;50;2016-12-07 00:00;19;160;199;359
2016;December;50;2016-12-07 00:00;20;171;173;344
2016;December;50;2016-12-07 00:00;21;149;185;334
2016;December;50;2016-12-07 00:00;22;166;181;347
2016;December;50;2016-12-07 00:00;23;184;189;373
2016;December;50;2016-12-07 00:00;24;170;198;368
2016;December;50;2016-12-07 00:00;25;161;226;387
2016;December;50;2016-12-07 00:00;26;179;191;370
2016;December;50;2016-12-07 00:00;27;147;173;320
2016;December;50;2016-12-07 00:00;28;165;175;340
2016;December;50;2016-12-07 00:00;29;168;186;354
2016;December;50;2016-12-07 00:00;30;154;166;320
2016;December;50;2016-12-07 00:00;31;166;172;338
2016;December;50;2016-12-07 00:00;32;176;166;342
2016;December;50;2016-12-07 00:00;33;199;170;369
2016;December;50;2016-12-07 00:00;34;196;187;383
2016;December;50;2016-12-07 00:00;35;154;169;323
2016;December;50;2016-12-07 00:00;36;221;184;405
2016;December;50;2016-12-07 00:00;37;202;156;358
2016;December;50;2016-12-07 00:00;38;179;200;379
2016;December;50;2016-12-07 00:00;39;180;197;377
2016;December;50;2016-12-07 00:00;40;214;214;428
2016;December;50;2016-12-07 00:00;41;218;239;457
2016;December;50;2016-12-07 00:00;42;224;269;493
2016;December;50;2016-12-07 00:00;43;203;217;420
2016;December;50;2016-12-07 00:00;44;224;245;469
2016;December;50;2016-12-07 00:00;45;215;216;431
2016;December;50;2016-12-07 00:00;46;210;217;427
2016;December;50;2016-12-07 00:00;47;210;200;410
2016;December;50;2016-12-07 00:00;48;219;227;446
2016;December;50;2016-12-07 00:00;49;245;234;479
2016;December;50;2016-12-07 00:00;50;185;224;409
2016;December;50;2016-12-07 00:00;51;197;213;410
2016;December;50;2016-12-07 00:00;52;191;221;412
2016;December;50;2016-12-07 00:00;53;181;214;395
2016;December;50;2016-12-07 00:00;54;188;188;376
2016;December;50;2016-12-07 00:00;55;155;166;321
2016;December;50;2016-12-07 00:00;56;155;151;306
2016;December;50;2016-12-07 00:00;57;158;170;328
2016;December;50;2016-12-07 00:00;58;154;162;316
2016;December;50;2016-12-07 00:00;59;148;162;310
2016;December;50;2016-12-07 00:00;60;146;154;300
2016;December;50;2016-12-07 00:00;61;137;130;267
2016;December;50;2016-12-07 00:00;62;136;141;277
2016;December;50;2016-12-07 00:00;63;150;144;294
2016;December;50;2016-12-07 00:00;64;144;161;305
2016;December;50;2016-12-07 00:00;65;147;142;289
2016;December;50;2016-12-07 00:00;66;146;159;305
2016;December;50;2016-12-07 00:00;67;156;166;322
2016;December;50;2016-12-07 00:00;68;175;165;340
2016;December;50;2016-12-07 00:00;69;167;165;332
2016;December;50;2016-12-07 00:00;70;186;153;339
2016;December;50;2016-12-07 00:00;71;189;180;369
2016;December;50;2016-12-07 00:00;72;156;165;321
2016;December;50;2016-12-07 00:00;73;158;171;329
2016;December;50;2016-12-07 00:00;74;144;139;283
2016;December;50;2016-12-07 00:00;75;115;107;222
2016;December;50;2016-12-07 00:00;76;86;127;213
2016;December;50;2016-12-07 00:00;77;91;98;189
2016;December;50;2016-12-07 00:00;78;98;81;179
2016;December;50;2016-12-07 00:00;79;83;84;167
2016;December;50;2016-12-07 00:00;80;93;75;168
2016;December;50;2016-12-07 00:00;81;67;68;135
2016;December;50;2016-12-07 00:00;82;75;52;127
2016;December;50;2016-12-07 00:00;83;61;50;111
2016;December;50;2016-12-07 00:00;84;36;42;78
2016;December;50;2016-12-07 00:00;85;51;34;85
2016;December;50;2016-12-07 00:00;86;49;31;80
2016;December;50;2016-12-07 00:00;87;39;27;66
2016;December;50;2016-12-07 00:00;88;34;23;57
2016;December;50;2016-12-07 00:00;89;34;14;48
2016;December;50;2016-12-07 00:00;90;27;15;42
2016;December;50;2016-12-07 00:00;91;22;10;32
2016;December;50;2016-12-07 00:00;92;15;10;25
2016;December;50;2016-12-07 00:00;93;13;9;22
2016;December;50;2016-12-07 00:00;94;17;3;20
2016;December;50;2016-12-07 00:00;95;7;5;12
2016;December;50;2016-12-07 00:00;96;4;4;8
2016;December;50;2016-12-07 00:00;97;0;1;1
2016;December;50;2016-12-07 00:00;98;2;2;4
2016;December;50;2016-12-07 00:00;99;1;2;3
2016;December;50;2016-12-07 00:00;104;1;0;1
2016;December;51;2016-12-14 00:00;0;146;172;318
2016;December;51;2016-12-14 00:00;1;167;187;354
2016;December;51;2016-12-14 00:00;2;168;196;364
2016;December;51;2016-12-14 00:00;3;190;210;400
2016;December;51;2016-12-14 00:00;4;190;190;380
2016;December;51;2016-12-14 00:00;5;203;228;431
2016;December;51;2016-12-14 00:00;6;206;223;429
2016;December;51;2016-12-14 00:00;7;196;210;406
2016;December;51;2016-12-14 00:00;8;189;187;376
2016;December;51;2016-12-14 00:00;9;180;198;378
2016;December;51;2016-12-14 00:00;10;219;199;418
2016;December;51;2016-12-14 00:00;11;186;202;388
2016;December;51;2016-12-14 00:00;12;183;195;378
2016;December;51;2016-12-14 00:00;13;177;184;361
2016;December;51;2016-12-14 00:00;14;175;216;391
2016;December;51;2016-12-14 00:00;15;144;177;321
2016;December;51;2016-12-14 00:00;16;180;201;381
2016;December;51;2016-12-14 00:00;17;180;190;370
2016;December;51;2016-12-14 00:00;18;157;170;327
2016;December;51;2016-12-14 00:00;19;160;199;359
2016;December;51;2016-12-14 00:00;20;171;172;343
2016;December;51;2016-12-14 00:00;21;150;185;335
2016;December;51;2016-12-14 00:00;22;164;184;348
2016;December;51;2016-12-14 00:00;23;185;188;373
2016;December;51;2016-12-14 00:00;24;171;198;369
2016;December;51;2016-12-14 00:00;25;161;224;385
2016;December;51;2016-12-14 00:00;26;179;192;371
2016;December;51;2016-12-14 00:00;27;147;174;321
2016;December;51;2016-12-14 00:00;28;166;176;342
2016;December;51;2016-12-14 00:00;29;169;187;356
2016;December;51;2016-12-14 00:00;30;153;165;318
2016;December;51;2016-12-14 00:00;31;167;174;341
2016;December;51;2016-12-14 00:00;32;176;167;343
2016;December;51;2016-12-14 00:00;33;200;171;371
2016;December;51;2016-12-14 00:00;34;196;187;383
2016;December;51;2016-12-14 00:00;35;154;170;324
2016;December;51;2016-12-14 00:00;36;221;186;407
2016;December;51;2016-12-14 00:00;37;202;159;361
2016;December;51;2016-12-14 00:00;38;179;200;379
2016;December;51;2016-12-14 00:00;39;180;197;377
2016;December;51;2016-12-14 00:00;40;214;214;428
2016;December;51;2016-12-14 00:00;41;218;240;458
2016;December;51;2016-12-14 00:00;42;224;270;494
2016;December;51;2016-12-14 00:00;43;203;217;420
2016;December;51;2016-12-14 00:00;44;224;245;469
2016;December;51;2016-12-14 00:00;45;215;217;432
2016;December;51;2016-12-14 00:00;46;210;218;428
2016;December;51;2016-12-14 00:00;47;210;200;410
2016;December;51;2016-12-14 00:00;48;219;227;446
2016;December;51;2016-12-14 00:00;49;244;233;477
2016;December;51;2016-12-14 00:00;50;187;224;411
2016;December;51;2016-12-14 00:00;51;197;213;410
2016;December;51;2016-12-14 00:00;52;191;222;413
2016;December;51;2016-12-14 00:00;53;181;215;396
2016;December;51;2016-12-14 00:00;54;187;188;375
2016;December;51;2016-12-14 00:00;55;155;166;321
2016;December;51;2016-12-14 00:00;56;155;151;306
2016;December;51;2016-12-14 00:00;57;158;170;328
2016;December;51;2016-12-14 00:00;58;153;161;314
2016;December;51;2016-12-14 00:00;59;148;162;310
2016;December;51;2016-12-14 00:00;60;146;154;300
2016;December;51;2016-12-14 00:00;61;137;130;267
2016;December;51;2016-12-14 00:00;62;136;141;277
2016;December;51;2016-12-14 00:00;63;150;144;294
2016;December;51;2016-12-14 00:00;64;144;161;305
2016;December;51;2016-12-14 00:00;65;146;142;288
2016;December;51;2016-12-14 00:00;66;145;159;304
2016;December;51;2016-12-14 00:00;67;156;166;322
2016;December;51;2016-12-14 00:00;68;175;165;340
2016;December;51;2016-12-14 00:00;69;167;165;332
2016;December;51;2016-12-14 00:00;70;186;153;339
2016;December;51;2016-12-14 00:00;71;189;180;369
2016;December;51;2016-12-14 00:00;72;156;165;321
2016;December;51;2016-12-14 00:00;73;158;171;329
2016;December;51;2016-12-14 00:00;74;144;139;283
2016;December;51;2016-12-14 00:00;75;115;107;222
2016;December;51;2016-12-14 00:00;76;86;127;213
2016;December;51;2016-12-14 00:00;77;91;98;189
2016;December;51;2016-12-14 00:00;78;98;81;179
2016;December;51;2016-12-14 00:00;79;83;84;167
2016;December;51;2016-12-14 00:00;80;93;75;168
2016;December;51;2016-12-14 00:00;81;67;68;135
2016;December;51;2016-12-14 00:00;82;75;51;126
2016;December;51;2016-12-14 00:00;83;61;50;111
2016;December;51;2016-12-14 00:00;84;36;42;78
2016;December;51;2016-12-14 00:00;85;51;33;84
2016;December;51;2016-12-14 00:00;86;49;31;80
2016;December;51;2016-12-14 00:00;87;38;27;65
2016;December;51;2016-12-14 00:00;88;34;23;57
2016;December;51;2016-12-14 00:00;89;34;14;48
2016;December;51;2016-12-14 00:00;90;27;15;42
2016;December;51;2016-12-14 00:00;91;22;10;32
2016;December;51;2016-12-14 00:00;92;14;10;24
2016;December;51;2016-12-14 00:00;93;13;9;22
2016;December;51;2016-12-14 00:00;94;17;3;20
2016;December;51;2016-12-14 00:00;95;7;5;12
2016;December;51;2016-12-14 00:00;96;4;4;8
2016;December;51;2016-12-14 00:00;97;0;1;1
2016;December;51;2016-12-14 00:00;98;2;2;4
2016;December;51;2016-12-14 00:00;99;1;2;3
2016;December;51;2016-12-14 00:00;104;1;0;1
2016;December;52;2016-12-22 00:00;0;151;177;328
2016;December;52;2016-12-22 00:00;1;169;187;356
2016;December;52;2016-12-22 00:00;2;168;196;364
2016;December;52;2016-12-22 00:00;3;189;210;399
2016;December;52;2016-12-22 00:00;4;190;190;380
2016;December;52;2016-12-22 00:00;5;203;228;431
2016;December;52;2016-12-22 00:00;6;206;223;429
2016;December;52;2016-12-22 00:00;7;196;210;406
2016;December;52;2016-12-22 00:00;8;190;189;379
2016;December;52;2016-12-22 00:00;9;180;198;378
2016;December;52;2016-12-22 00:00;10;220;199;419
2016;December;52;2016-12-22 00:00;11;186;202;388
2016;December;52;2016-12-22 00:00;12;183;195;378
2016;December;52;2016-12-22 00:00;13;177;184;361
2016;December;52;2016-12-22 00:00;14;176;217;393
2016;December;52;2016-12-22 00:00;15;144;178;322
2016;December;52;2016-12-22 00:00;16;181;201;382
2016;December;52;2016-12-22 00:00;17;180;191;371
2016;December;52;2016-12-22 00:00;18;158;171;329
2016;December;52;2016-12-22 00:00;19;161;197;358
2016;December;52;2016-12-22 00:00;20;171;173;344
2016;December;52;2016-12-22 00:00;21;148;183;331
2016;December;52;2016-12-22 00:00;22;164;185;349
2016;December;52;2016-12-22 00:00;23;187;189;376
2016;December;52;2016-12-22 00:00;24;173;198;371
2016;December;52;2016-12-22 00:00;25;162;225;387
2016;December;52;2016-12-22 00:00;26;179;190;369
2016;December;52;2016-12-22 00:00;27;148;177;325
2016;December;52;2016-12-22 00:00;28;166;179;345
2016;December;52;2016-12-22 00:00;29;169;186;355
2016;December;52;2016-12-22 00:00;30;153;167;320
2016;December;52;2016-12-22 00:00;31;168;175;343
2016;December;52;2016-12-22 00:00;32;176;167;343
2016;December;52;2016-12-22 00:00;33;202;171;373
2016;December;52;2016-12-22 00:00;34;196;186;382
2016;December;52;2016-12-22 00:00;35;155;170;325
2016;December;52;2016-12-22 00:00;36;221;186;407
2016;December;52;2016-12-22 00:00;37;202;159;361
2016;December;52;2016-12-22 00:00;38;179;201;380
2016;December;52;2016-12-22 00:00;39;180;197;377
2016;December;52;2016-12-22 00:00;40;214;214;428
2016;December;52;2016-12-22 00:00;41;219;239;458
2016;December;52;2016-12-22 00:00;42;225;270;495
2016;December;52;2016-12-22 00:00;43;203;217;420
2016;December;52;2016-12-22 00:00;44;224;245;469
2016;December;52;2016-12-22 00:00;45;215;217;432
2016;December;52;2016-12-22 00:00;46;212;218;430
2016;December;52;2016-12-22 00:00;47;211;200;411
2016;December;52;2016-12-22 00:00;48;218;226;444
2016;December;52;2016-12-22 00:00;49;244;233;477
2016;December;52;2016-12-22 00:00;50;187;224;411
2016;December;52;2016-12-22 00:00;51;197;215;412
2016;December;52;2016-12-22 00:00;52;191;222;413
2016;December;52;2016-12-22 00:00;53;181;217;398
2016;December;52;2016-12-22 00:00;54;187;188;375
2016;December;52;2016-12-22 00:00;55;155;166;321
2016;December;52;2016-12-22 00:00;56;155;151;306
2016;December;52;2016-12-22 00:00;57;158;170;328
2016;December;52;2016-12-22 00:00;58;154;161;315
2016;December;52;2016-12-22 00:00;59;148;162;310
2016;December;52;2016-12-22 00:00;60;146;154;300
2016;December;52;2016-12-22 00:00;61;137;130;267
2016;December;52;2016-12-22 00:00;62;136;141;277
2016;December;52;2016-12-22 00:00;63;150;144;294
2016;December;52;2016-12-22 00:00;64;144;161;305
2016;December;52;2016-12-22 00:00;65;146;141;287
2016;December;52;2016-12-22 00:00;66;145;159;304
2016;December;52;2016-12-22 00:00;67;156;167;323
2016;December;52;2016-12-22 00:00;68;175;165;340
2016;December;52;2016-12-22 00:00;69;167;165;332
2016;December;52;2016-12-22 00:00;70;186;153;339
2016;December;52;2016-12-22 00:00;71;189;179;368
2016;December;52;2016-12-22 00:00;72;156;164;320
2016;December;52;2016-12-22 00:00;73;158;171;329
2016;December;52;2016-12-22 00:00;74;144;139;283
2016;December;52;2016-12-22 00:00;75;115;107;222
2016;December;52;2016-12-22 00:00;76;86;127;213
2016;December;52;2016-12-22 00:00;77;91;98;189
2016;December;52;2016-12-22 00:00;78;99;81;180
2016;December;52;2016-12-22 00:00;79;83;84;167
2016;December;52;2016-12-22 00:00;80;93;75;168
2016;December;52;2016-12-22 00:00;81;67;68;135
2016;December;52;2016-12-22 00:00;82;75;51;126
2016;December;52;2016-12-22 00:00;83;61;50;111
2016;December;52;2016-12-22 00:00;84;35;42;77
2016;December;52;2016-12-22 00:00;85;51;33;84
2016;December;52;2016-12-22 00:00;86;49;31;80
2016;December;52;2016-12-22 00:00;87;38;26;64
2016;December;52;2016-12-22 00:00;88;34;22;56
2016;December;52;2016-12-22 00:00;89;34;14;48
2016;December;52;2016-12-22 00:00;90;27;15;42
2016;December;52;2016-12-22 00:00;91;22;10;32
2016;December;52;2016-12-22 00:00;92;14;10;24
2016;December;52;2016-12-22 00:00;93;13;9;22
2016;December;52;2016-12-22 00:00;94;16;3;19
2016;December;52;2016-12-22 00:00;95;7;5;12
2016;December;52;2016-12-22 00:00;96;4;4;8
2016;December;52;2016-12-22 00:00;97;0;1;1
2016;December;52;2016-12-22 00:00;98;2;2;4
2016;December;52;2016-12-22 00:00;99;1;2;3
2016;December;52;2016-12-22 00:00;104;1;0;1
2016;December;53;2016-12-28 00:00;0;154;180;334
2016;December;53;2016-12-28 00:00;1;169;187;356
2016;December;53;2016-12-28 00:00;2;167;196;363
2016;December;53;2016-12-28 00:00;3;190;210;400
2016;December;53;2016-12-28 00:00;4;189;190;379
2016;December;53;2016-12-28 00:00;5;203;228;431
2016;December;53;2016-12-28 00:00;6;206;223;429
2016;December;53;2016-12-28 00:00;7;196;211;407
2016;December;53;2016-12-28 00:00;8;190;190;380
2016;December;53;2016-12-28 00:00;9;179;198;377
2016;December;53;2016-12-28 00:00;10;220;199;419
2016;December;53;2016-12-28 00:00;11;186;202;388
2016;December;53;2016-12-28 00:00;12;183;195;378
2016;December;53;2016-12-28 00:00;13;177;184;361
2016;December;53;2016-12-28 00:00;14;176;217;393
2016;December;53;2016-12-28 00:00;15;144;178;322
2016;December;53;2016-12-28 00:00;16;181;202;383
2016;December;53;2016-12-28 00:00;17;180;191;371
2016;December;53;2016-12-28 00:00;18;158;171;329
2016;December;53;2016-12-28 00:00;19;161;197;358
2016;December;53;2016-12-28 00:00;20;169;173;342
2016;December;53;2016-12-28 00:00;21;148;183;331
2016;December;53;2016-12-28 00:00;22;164;185;349
2016;December;53;2016-12-28 00:00;23;187;189;376
2016;December;53;2016-12-28 00:00;24;174;198;372
2016;December;53;2016-12-28 00:00;25;162;224;386
2016;December;53;2016-12-28 00:00;26;180;190;370
2016;December;53;2016-12-28 00:00;27;148;178;326
2016;December;53;2016-12-28 00:00;28;165;179;344
2016;December;53;2016-12-28 00:00;29;169;187;356
2016;December;53;2016-12-28 00:00;30;154;167;321
2016;December;53;2016-12-28 00:00;31;169;175;344
2016;December;53;2016-12-28 00:00;32;176;167;343
2016;December;53;2016-12-28 00:00;33;202;170;372
2016;December;53;2016-12-28 00:00;34;196;186;382
2016;December;53;2016-12-28 00:00;35;155;170;325
2016;December;53;2016-12-28 00:00;36;220;186;406
2016;December;53;2016-12-28 00:00;37;203;159;362
2016;December;53;2016-12-28 00:00;38;179;201;380
2016;December;53;2016-12-28 00:00;39;182;198;380
2016;December;53;2016-12-28 00:00;40;214;214;428
2016;December;53;2016-12-28 00:00;41;219;239;458
2016;December;53;2016-12-28 00:00;42;225;270;495
2016;December;53;2016-12-28 00:00;43;203;215;418
2016;December;53;2016-12-28 00:00;44;225;245;470
2016;December;53;2016-12-28 00:00;45;214;216;430
2016;December;53;2016-12-28 00:00;46;212;218;430
2016;December;53;2016-12-28 00:00;47;211;200;411
2016;December;53;2016-12-28 00:00;48;218;227;445
2016;December;53;2016-12-28 00:00;49;244;233;477
2016;December;53;2016-12-28 00:00;50;187;224;411
2016;December;53;2016-12-28 00:00;51;198;215;413
2016;December;53;2016-12-28 00:00;52;191;222;413
2016;December;53;2016-12-28 00:00;53;181;217;398
2016;December;53;2016-12-28 00:00;54;187;190;377
2016;December;53;2016-12-28 00:00;55;155;166;321
2016;December;53;2016-12-28 00:00;56;155;151;306
2016;December;53;2016-12-28 00:00;57;160;169;329
2016;December;53;2016-12-28 00:00;58;154;161;315
2016;December;53;2016-12-28 00:00;59;148;162;310
2016;December;53;2016-12-28 00:00;60;146;154;300
2016;December;53;2016-12-28 00:00;61;137;130;267
2016;December;53;2016-12-28 00:00;62;136;141;277
2016;December;53;2016-12-28 00:00;63;150;144;294
2016;December;53;2016-12-28 00:00;64;144;161;305
2016;December;53;2016-12-28 00:00;65;146;141;287
2016;December;53;2016-12-28 00:00;66;145;159;304
2016;December;53;2016-12-28 00:00;67;156;167;323
2016;December;53;2016-12-28 00:00;68;175;165;340
2016;December;53;2016-12-28 00:00;69;166;165;331
2016;December;53;2016-12-28 00:00;70;186;153;339
2016;December;53;2016-12-28 00:00;71;189;179;368
2016;December;53;2016-12-28 00:00;72;156;164;320
2016;December;53;2016-12-28 00:00;73;158;171;329
2016;December;53;2016-12-28 00:00;74;144;139;283
2016;December;53;2016-12-28 00:00;75;115;107;222
2016;December;53;2016-12-28 00:00;76;86;127;213
2016;December;53;2016-12-28 00:00;77;91;97;188
2016;December;53;2016-12-28 00:00;78;99;81;180
2016;December;53;2016-12-28 00:00;79;83;83;166
2016;December;53;2016-12-28 00:00;80;93;75;168
2016;December;53;2016-12-28 00:00;81;67;67;134
2016;December;53;2016-12-28 00:00;82;75;51;126
2016;December;53;2016-12-28 00:00;83;61;50;111
2016;December;53;2016-12-28 00:00;84;35;42;77
2016;December;53;2016-12-28 00:00;85;51;33;84
2016;December;53;2016-12-28 00:00;86;49;31;80
2016;December;53;2016-12-28 00:00;87;38;26;64
2016;December;53;2016-12-28 00:00;88;34;22;56
2016;December;53;2016-12-28 00:00;89;34;13;47
2016;December;53;2016-12-28 00:00;90;27;15;42
2016;December;53;2016-12-28 00:00;91;22;10;32
2016;December;53;2016-12-28 00:00;92;14;10;24
2016;December;53;2016-12-28 00:00;93;13;9;22
2016;December;53;2016-12-28 00:00;94;16;3;19
2016;December;53;2016-12-28 00:00;95;7;5;12
2016;December;53;2016-12-28 00:00;96;4;4;8
2016;December;53;2016-12-28 00:00;97;0;1;1
2016;December;53;2016-12-28 00:00;98;2;2;4
2016;December;53;2016-12-28 00:00;99;1;2;3
2016;December;53;2016-12-28 00:00;104;1;0;1
2017;January;1;2017-01-04 00:00;1;157;182;339
2017;January;1;2017-01-04 00:00;2;171;186;357
2017;January;1;2017-01-04 00:00;3;167;196;363
2017;January;1;2017-01-04 00:00;4;190;210;400
2017;January;1;2017-01-04 00:00;5;189;191;380
2017;January;1;2017-01-04 00:00;6;203;228;431
2017;January;1;2017-01-04 00:00;7;206;223;429
2017;January;1;2017-01-04 00:00;8;196;210;406
2017;January;1;2017-01-04 00:00;9;190;190;380
2017;January;1;2017-01-04 00:00;10;180;198;378
2017;January;1;2017-01-04 00:00;11;221;199;420
2017;January;1;2017-01-04 00:00;12;186;202;388
2017;January;1;2017-01-04 00:00;13;183;196;379
2017;January;1;2017-01-04 00:00;14;177;184;361
2017;January;1;2017-01-04 00:00;15;176;217;393
2017;January;1;2017-01-04 00:00;16;144;179;323
2017;January;1;2017-01-04 00:00;17;181;203;384
2017;January;1;2017-01-04 00:00;18;180;191;371
2017;January;1;2017-01-04 00:00;19;158;170;328
2017;January;1;2017-01-04 00:00;20;162;197;359
2017;January;1;2017-01-04 00:00;21;169;174;343
2017;January;1;2017-01-04 00:00;22;148;182;330
2017;January;1;2017-01-04 00:00;23;164;184;348
2017;January;1;2017-01-04 00:00;24;185;188;373
2017;January;1;2017-01-04 00:00;25;174;199;373
2017;January;1;2017-01-04 00:00;26;161;225;386
2017;January;1;2017-01-04 00:00;27;180;192;372
2017;January;1;2017-01-04 00:00;28;147;176;323
2017;January;1;2017-01-04 00:00;29;167;178;345
2017;January;1;2017-01-04 00:00;30;168;187;355
2017;January;1;2017-01-04 00:00;31;155;168;323
2017;January;1;2017-01-04 00:00;32;169;175;344
2017;January;1;2017-01-04 00:00;33;177;167;344
2017;January;1;2017-01-04 00:00;34;202;170;372
2017;January;1;2017-01-04 00:00;35;196;186;382
2017;January;1;2017-01-04 00:00;36;155;171;326
2017;January;1;2017-01-04 00:00;37;220;186;406
2017;January;1;2017-01-04 00:00;38;203;159;362
2017;January;1;2017-01-04 00:00;39;179;201;380
2017;January;1;2017-01-04 00:00;40;182;197;379
2017;January;1;2017-01-04 00:00;41;214;214;428
2017;January;1;2017-01-04 00:00;42;219;240;459
2017;January;1;2017-01-04 00:00;43;225;270;495
2017;January;1;2017-01-04 00:00;44;203;216;419
2017;January;1;2017-01-04 00:00;45;225;246;471
2017;January;1;2017-01-04 00:00;46;212;216;428
2017;January;1;2017-01-04 00:00;47;213;217;430
2017;January;1;2017-01-04 00:00;48;211;201;412
2017;January;1;2017-01-04 00:00;49;217;226;443
2017;January;1;2017-01-04 00:00;50;243;233;476
2017;January;1;2017-01-04 00:00;51;187;224;411
2017;January;1;2017-01-04 00:00;52;198;214;412
2017;January;1;2017-01-04 00:00;53;191;221;412
2017;January;1;2017-01-04 00:00;54;181;217;398
2017;January;1;2017-01-04 00:00;55;186;190;376
2017;January;1;2017-01-04 00:00;56;153;166;319
2017;January;1;2017-01-04 00:00;57;155;151;306
2017;January;1;2017-01-04 00:00;58;160;169;329
2017;January;1;2017-01-04 00:00;59;154;160;314
2017;January;1;2017-01-04 00:00;60;148;162;310
2017;January;1;2017-01-04 00:00;61;145;154;299
2017;January;1;2017-01-04 00:00;62;137;130;267
2017;January;1;2017-01-04 00:00;63;136;140;276
2017;January;1;2017-01-04 00:00;64;149;144;293
2017;January;1;2017-01-04 00:00;65;144;161;305
2017;January;1;2017-01-04 00:00;66;145;140;285
2017;January;1;2017-01-04 00:00;67;145;158;303
2017;January;1;2017-01-04 00:00;68;155;167;322
2017;January;1;2017-01-04 00:00;69;175;165;340
2017;January;1;2017-01-04 00:00;70;166;165;331
2017;January;1;2017-01-04 00:00;71;186;153;339
2017;January;1;2017-01-04 00:00;72;189;179;368
2017;January;1;2017-01-04 00:00;73;156;164;320
2017;January;1;2017-01-04 00:00;74;157;171;328
2017;January;1;2017-01-04 00:00;75;144;139;283
2017;January;1;2017-01-04 00:00;76;115;107;222
2017;January;1;2017-01-04 00:00;77;86;127;213
2017;January;1;2017-01-04 00:00;78;91;97;188
2017;January;1;2017-01-04 00:00;79;98;81;179
2017;January;1;2017-01-04 00:00;80;83;83;166
2017;January;1;2017-01-04 00:00;81;93;75;168
2017;January;1;2017-01-04 00:00;82;66;67;133
2017;January;1;2017-01-04 00:00;83;75;51;126
2017;January;1;2017-01-04 00:00;84;61;50;111
2017;January;1;2017-01-04 00:00;85;35;42;77
2017;January;1;2017-01-04 00:00;86;51;33;84
2017;January;1;2017-01-04 00:00;87;49;31;80
2017;January;1;2017-01-04 00:00;88;38;26;64
2017;January;1;2017-01-04 00:00;89;34;22;56
2017;January;1;2017-01-04 00:00;90;34;13;47
2017;January;1;2017-01-04 00:00;91;26;15;41
2017;January;1;2017-01-04 00:00;92;22;10;32
2017;January;1;2017-01-04 00:00;93;14;10;24
2017;January;1;2017-01-04 00:00;94;13;9;22
2017;January;1;2017-01-04 00:00;95;16;3;19
2017;January;1;2017-01-04 00:00;96;7;5;12
2017;January;1;2017-01-04 00:00;97;4;4;8
2017;January;1;2017-01-04 00:00;98;0;1;1
2017;January;1;2017-01-04 00:00;99;2;2;4
2017;January;1;2017-01-04 00:00;100;1;2;3
2017;January;1;2017-01-04 00:00;105;1;0;1
2017;January;2;2017-01-11 00:00;0;2;7;9
2017;January;2;2017-01-11 00:00;1;159;182;341
2017;January;2;2017-01-11 00:00;2;171;186;357
2017;January;2;2017-01-11 00:00;3;168;199;367
2017;January;2;2017-01-11 00:00;4;190;212;402
2017;January;2;2017-01-11 00:00;5;189;191;380
2017;January;2;2017-01-11 00:00;6;204;229;433
2017;January;2;2017-01-11 00:00;7;206;223;429
2017;January;2;2017-01-11 00:00;8;197;210;407
2017;January;2;2017-01-11 00:00;9;190;190;380
2017;January;2;2017-01-11 00:00;10;180;198;378
2017;January;2;2017-01-11 00:00;11;221;199;420
2017;January;2;2017-01-11 00:00;12;186;203;389
2017;January;2;2017-01-11 00:00;13;183;196;379
2017;January;2;2017-01-11 00:00;14;177;184;361
2017;January;2;2017-01-11 00:00;15;176;217;393
2017;January;2;2017-01-11 00:00;16;144;179;323
2017;January;2;2017-01-11 00:00;17;182;204;386
2017;January;2;2017-01-11 00:00;18;180;191;371
2017;January;2;2017-01-11 00:00;19;158;171;329
2017;January;2;2017-01-11 00:00;20;162;196;358
2017;January;2;2017-01-11 00:00;21;170;174;344
2017;January;2;2017-01-11 00:00;22;148;182;330
2017;January;2;2017-01-11 00:00;23;164;184;348
2017;January;2;2017-01-11 00:00;24;184;188;372
2017;January;2;2017-01-11 00:00;25;173;200;373
2017;January;2;2017-01-11 00:00;26;161;225;386
2017;January;2;2017-01-11 00:00;27;180;193;373
2017;January;2;2017-01-11 00:00;28;148;176;324
2017;January;2;2017-01-11 00:00;29;167;179;346
2017;January;2;2017-01-11 00:00;30;168;186;354
2017;January;2;2017-01-11 00:00;31;156;168;324
2017;January;2;2017-01-11 00:00;32;169;176;345
2017;January;2;2017-01-11 00:00;33;178;169;347
2017;January;2;2017-01-11 00:00;34;203;173;376
2017;January;2;2017-01-11 00:00;35;196;187;383
2017;January;2;2017-01-11 00:00;36;156;171;327
2017;January;2;2017-01-11 00:00;37;220;185;405
2017;January;2;2017-01-11 00:00;38;203;158;361
2017;January;2;2017-01-11 00:00;39;178;201;379
2017;January;2;2017-01-11 00:00;40;182;197;379
2017;January;2;2017-01-11 00:00;41;214;214;428
2017;January;2;2017-01-11 00:00;42;219;241;460
2017;January;2;2017-01-11 00:00;43;226;270;496
2017;January;2;2017-01-11 00:00;44;203;216;419
2017;January;2;2017-01-11 00:00;45;225;246;471
2017;January;2;2017-01-11 00:00;46;213;215;428
2017;January;2;2017-01-11 00:00;47;213;217;430
2017;January;2;2017-01-11 00:00;48;211;201;412
2017;January;2;2017-01-11 00:00;49;217;226;443
2017;January;2;2017-01-11 00:00;50;244;234;478
2017;January;2;2017-01-11 00:00;51;187;225;412
2017;January;2;2017-01-11 00:00;52;198;215;413
2017;January;2;2017-01-11 00:00;53;191;221;412
2017;January;2;2017-01-11 00:00;54;181;217;398
2017;January;2;2017-01-11 00:00;55;187;190;377
2017;January;2;2017-01-11 00:00;56;153;166;319
2017;January;2;2017-01-11 00:00;57;155;151;306
2017;January;2;2017-01-11 00:00;58;160;169;329
2017;January;2;2017-01-11 00:00;59;154;160;314
2017;January;2;2017-01-11 00:00;60;147;162;309
2017;January;2;2017-01-11 00:00;61;145;154;299
2017;January;2;2017-01-11 00:00;62;137;130;267
2017;January;2;2017-01-11 00:00;63;136;141;277
2017;January;2;2017-01-11 00:00;64;149;144;293
2017;January;2;2017-01-11 00:00;65;144;161;305
2017;January;2;2017-01-11 00:00;66;145;139;284
2017;January;2;2017-01-11 00:00;67;145;158;303
2017;January;2;2017-01-11 00:00;68;155;167;322
2017;January;2;2017-01-11 00:00;69;175;165;340
2017;January;2;2017-01-11 00:00;70;166;165;331
2017;January;2;2017-01-11 00:00;71;186;153;339
2017;January;2;2017-01-11 00:00;72;189;179;368
2017;January;2;2017-01-11 00:00;73;156;164;320
2017;January;2;2017-01-11 00:00;74;157;171;328
2017;January;2;2017-01-11 00:00;75;144;138;282
2017;January;2;2017-01-11 00:00;76;115;107;222
2017;January;2;2017-01-11 00:00;77;86;127;213
2017;January;2;2017-01-11 00:00;78;91;97;188
2017;January;2;2017-01-11 00:00;79;98;80;178
2017;January;2;2017-01-11 00:00;80;83;83;166
2017;January;2;2017-01-11 00:00;81;93;75;168
2017;January;2;2017-01-11 00:00;82;66;67;133
2017;January;2;2017-01-11 00:00;83;75;51;126
2017;January;2;2017-01-11 00:00;84;61;50;111
2017;January;2;2017-01-11 00:00;85;35;42;77
2017;January;2;2017-01-11 00:00;86;50;33;83
2017;January;2;2017-01-11 00:00;87;49;31;80
2017;January;2;2017-01-11 00:00;88;38;26;64
2017;January;2;2017-01-11 00:00;89;34;22;56
2017;January;2;2017-01-11 00:00;90;34;13;47
2017;January;2;2017-01-11 00:00;91;26;15;41
2017;January;2;2017-01-11 00:00;92;22;10;32
2017;January;2;2017-01-11 00:00;93;14;10;24
2017;January;2;2017-01-11 00:00;94;12;9;21
2017;January;2;2017-01-11 00:00;95;16;3;19
2017;January;2;2017-01-11 00:00;96;7;5;12
2017;January;2;2017-01-11 00:00;97;4;4;8
2017;January;2;2017-01-11 00:00;98;0;1;1
2017;January;2;2017-01-11 00:00;99;2;2;4
2017;January;2;2017-01-11 00:00;100;1;2;3
2017;January;2;2017-01-11 00:00;105;1;0;1
2017;January;3;2017-01-18 00:00;0;7;10;17
2017;January;3;2017-01-18 00:00;1;160;182;342
2017;January;3;2017-01-18 00:00;2;171;186;357
2017;January;3;2017-01-18 00:00;3;170;200;370
2017;January;3;2017-01-18 00:00;4;190;212;402
2017;January;3;2017-01-18 00:00;5;189;192;381
2017;January;3;2017-01-18 00:00;6;204;227;431
2017;January;3;2017-01-18 00:00;7;206;224;430
2017;January;3;2017-01-18 00:00;8;198;210;408
2017;January;3;2017-01-18 00:00;9;189;190;379
2017;January;3;2017-01-18 00:00;10;180;197;377
2017;January;3;2017-01-18 00:00;11;221;198;419
2017;January;3;2017-01-18 00:00;12;186;202;388
2017;January;3;2017-01-18 00:00;13;183;196;379
2017;January;3;2017-01-18 00:00;14;178;184;362
2017;January;3;2017-01-18 00:00;15;176;217;393
2017;January;3;2017-01-18 00:00;16;144;179;323
2017;January;3;2017-01-18 00:00;17;182;204;386
2017;January;3;2017-01-18 00:00;18;181;191;372
2017;January;3;2017-01-18 00:00;19;158;173;331
2017;January;3;2017-01-18 00:00;20;162;195;357
2017;January;3;2017-01-18 00:00;21;169;174;343
2017;January;3;2017-01-18 00:00;22;146;182;328
2017;January;3;2017-01-18 00:00;23;163;183;346
2017;January;3;2017-01-18 00:00;24;184;188;372
2017;January;3;2017-01-18 00:00;25;172;200;372
2017;January;3;2017-01-18 00:00;26;163;225;388
2017;January;3;2017-01-18 00:00;27;181;194;375
2017;January;3;2017-01-18 00:00;28;148;176;324
2017;January;3;2017-01-18 00:00;29;167;180;347
2017;January;3;2017-01-18 00:00;30;168;185;353
2017;January;3;2017-01-18 00:00;31;156;168;324
2017;January;3;2017-01-18 00:00;32;170;176;346
2017;January;3;2017-01-18 00:00;33;178;170;348
2017;January;3;2017-01-18 00:00;34;203;173;376
2017;January;3;2017-01-18 00:00;35;196;187;383
2017;January;3;2017-01-18 00:00;36;156;172;328
2017;January;3;2017-01-18 00:00;37;219;185;404
2017;January;3;2017-01-18 00:00;38;203;158;361
2017;January;3;2017-01-18 00:00;39;178;201;379
2017;January;3;2017-01-18 00:00;40;182;197;379
2017;January;3;2017-01-18 00:00;41;214;214;428
2017;January;3;2017-01-18 00:00;42;219;241;460
2017;January;3;2017-01-18 00:00;43;227;270;497
2017;January;3;2017-01-18 00:00;44;203;217;420
2017;January;3;2017-01-18 00:00;45;225;245;470
2017;January;3;2017-01-18 00:00;46;213;215;428
2017;January;3;2017-01-18 00:00;47;213;218;431
2017;January;3;2017-01-18 00:00;48;210;200;410
2017;January;3;2017-01-18 00:00;49;217;226;443
2017;January;3;2017-01-18 00:00;50;244;234;478
2017;January;3;2017-01-18 00:00;51;187;225;412
2017;January;3;2017-01-18 00:00;52;198;215;413
2017;January;3;2017-01-18 00:00;53;191;221;412
2017;January;3;2017-01-18 00:00;54;182;216;398
2017;January;3;2017-01-18 00:00;55;187;190;377
2017;January;3;2017-01-18 00:00;56;154;166;320
2017;January;3;2017-01-18 00:00;57;155;151;306
2017;January;3;2017-01-18 00:00;58;160;169;329
2017;January;3;2017-01-18 00:00;59;154;160;314
2017;January;3;2017-01-18 00:00;60;147;162;309
2017;January;3;2017-01-18 00:00;61;145;153;298
2017;January;3;2017-01-18 00:00;62;137;130;267
2017;January;3;2017-01-18 00:00;63;136;141;277
2017;January;3;2017-01-18 00:00;64;149;144;293
2017;January;3;2017-01-18 00:00;65;144;162;306
2017;January;3;2017-01-18 00:00;66;145;139;284
2017;January;3;2017-01-18 00:00;67;145;158;303
2017;January;3;2017-01-18 00:00;68;155;167;322
2017;January;3;2017-01-18 00:00;69;175;165;340
2017;January;3;2017-01-18 00:00;70;166;165;331
2017;January;3;2017-01-18 00:00;71;186;153;339
2017;January;3;2017-01-18 00:00;72;189;179;368
2017;January;3;2017-01-18 00:00;73;156;164;320
2017;January;3;2017-01-18 00:00;74;157;171;328
2017;January;3;2017-01-18 00:00;75;144;138;282
2017;January;3;2017-01-18 00:00;76;115;107;222
2017;January;3;2017-01-18 00:00;77;86;127;213
2017;January;3;2017-01-18 00:00;78;91;97;188
2017;January;3;2017-01-18 00:00;79;98;80;178
2017;January;3;2017-01-18 00:00;80;83;83;166
2017;January;3;2017-01-18 00:00;81;93;75;168
2017;January;3;2017-01-18 00:00;82;66;67;133
2017;January;3;2017-01-18 00:00;83;75;50;125
2017;January;3;2017-01-18 00:00;84;61;50;111
2017;January;3;2017-01-18 00:00;85;34;42;76
2017;January;3;2017-01-18 00:00;86;50;33;83
2017;January;3;2017-01-18 00:00;87;49;31;80
2017;January;3;2017-01-18 00:00;88;38;26;64
2017;January;3;2017-01-18 00:00;89;32;22;54
2017;January;3;2017-01-18 00:00;90;34;13;47
2017;January;3;2017-01-18 00:00;91;26;15;41
2017;January;3;2017-01-18 00:00;92;22;10;32
2017;January;3;2017-01-18 00:00;93;14;10;24
2017;January;3;2017-01-18 00:00;94;12;9;21
2017;January;3;2017-01-18 00:00;95;16;3;19
2017;January;3;2017-01-18 00:00;96;7;5;12
2017;January;3;2017-01-18 00:00;97;4;4;8
2017;January;3;2017-01-18 00:00;98;0;1;1
2017;January;3;2017-01-18 00:00;99;2;2;4
2017;January;3;2017-01-18 00:00;100;1;2;3
2017;January;3;2017-01-18 00:00;105;1;0;1
2017;January;4;2017-01-25 00:00;0;10;12;22
2017;January;4;2017-01-25 00:00;1;161;182;343
2017;January;4;2017-01-25 00:00;2;171;190;361
2017;January;4;2017-01-25 00:00;3;172;202;374
2017;January;4;2017-01-25 00:00;4;191;213;404
2017;January;4;2017-01-25 00:00;5;189;192;381
2017;January;4;2017-01-25 00:00;6;205;228;433
2017;January;4;2017-01-25 00:00;7;209;225;434
2017;January;4;2017-01-25 00:00;8;198;211;409
2017;January;4;2017-01-25 00:00;9;189;191;380
2017;January;4;2017-01-25 00:00;10;180;197;377
2017;January;4;2017-01-25 00:00;11;221;198;419
2017;January;4;2017-01-25 00:00;12;186;203;389
2017;January;4;2017-01-25 00:00;13;183;196;379
2017;January;4;2017-01-25 00:00;14;178;184;362
2017;January;4;2017-01-25 00:00;15;176;216;392
2017;January;4;2017-01-25 00:00;16;144;179;323
2017;January;4;2017-01-25 00:00;17;182;205;387
2017;January;4;2017-01-25 00:00;18;181;191;372
2017;January;4;2017-01-25 00:00;19;159;173;332
2017;January;4;2017-01-25 00:00;20;162;195;357
2017;January;4;2017-01-25 00:00;21;168;173;341
2017;January;4;2017-01-25 00:00;22;146;182;328
2017;January;4;2017-01-25 00:00;23;162;181;343
2017;January;4;2017-01-25 00:00;24;184;188;372
2017;January;4;2017-01-25 00:00;25;173;200;373
2017;January;4;2017-01-25 00:00;26;162;225;387
2017;January;4;2017-01-25 00:00;27;182;191;373
2017;January;4;2017-01-25 00:00;28;149;178;327
2017;January;4;2017-01-25 00:00;29;167;181;348
2017;January;4;2017-01-25 00:00;30;170;186;356
2017;January;4;2017-01-25 00:00;31;158;168;326
2017;January;4;2017-01-25 00:00;32;170;177;347
2017;January;4;2017-01-25 00:00;33;178;171;349
2017;January;4;2017-01-25 00:00;34;203;173;376
2017;January;4;2017-01-25 00:00;35;196;186;382
2017;January;4;2017-01-25 00:00;36;156;172;328
2017;January;4;2017-01-25 00:00;37;220;187;407
2017;January;4;2017-01-25 00:00;38;205;158;363
2017;January;4;2017-01-25 00:00;39;178;201;379
2017;January;4;2017-01-25 00:00;40;183;198;381
2017;January;4;2017-01-25 00:00;41;215;214;429
2017;January;4;2017-01-25 00:00;42;221;242;463
2017;January;4;2017-01-25 00:00;43;226;269;495
2017;January;4;2017-01-25 00:00;44;203;217;420
2017;January;4;2017-01-25 00:00;45;226;247;473
2017;January;4;2017-01-25 00:00;46;213;215;428
2017;January;4;2017-01-25 00:00;47;213;219;432
2017;January;4;2017-01-25 00:00;48;210;202;412
2017;January;4;2017-01-25 00:00;49;217;226;443
2017;January;4;2017-01-25 00:00;50;244;233;477
2017;January;4;2017-01-25 00:00;51;187;225;412
2017;January;4;2017-01-25 00:00;52;198;215;413
2017;January;4;2017-01-25 00:00;53;191;221;412
2017;January;4;2017-01-25 00:00;54;183;216;399
2017;January;4;2017-01-25 00:00;55;187;190;377
2017;January;4;2017-01-25 00:00;56;154;166;320
2017;January;4;2017-01-25 00:00;57;155;151;306
2017;January;4;2017-01-25 00:00;58;160;170;330
2017;January;4;2017-01-25 00:00;59;154;160;314
2017;January;4;2017-01-25 00:00;60;147;162;309
2017;January;4;2017-01-25 00:00;61;145;153;298
2017;January;4;2017-01-25 00:00;62;137;129;266
2017;January;4;2017-01-25 00:00;63;135;141;276
2017;January;4;2017-01-25 00:00;64;149;144;293
2017;January;4;2017-01-25 00:00;65;143;162;305
2017;January;4;2017-01-25 00:00;66;145;140;285
2017;January;4;2017-01-25 00:00;67;145;158;303
2017;January;4;2017-01-25 00:00;68;155;167;322
2017;January;4;2017-01-25 00:00;69;175;165;340
2017;January;4;2017-01-25 00:00;70;166;165;331
2017;January;4;2017-01-25 00:00;71;186;153;339
2017;January;4;2017-01-25 00:00;72;189;178;367
2017;January;4;2017-01-25 00:00;73;156;165;321
2017;January;4;2017-01-25 00:00;74;157;171;328
2017;January;4;2017-01-25 00:00;75;144;138;282
2017;January;4;2017-01-25 00:00;76;115;107;222
2017;January;4;2017-01-25 00:00;77;86;127;213
2017;January;4;2017-01-25 00:00;78;91;97;188
2017;January;4;2017-01-25 00:00;79;98;80;178
2017;January;4;2017-01-25 00:00;80;83;82;165
2017;January;4;2017-01-25 00:00;81;93;74;167
2017;January;4;2017-01-25 00:00;82;66;67;133
2017;January;4;2017-01-25 00:00;83;75;50;125
2017;January;4;2017-01-25 00:00;84;61;50;111
2017;January;4;2017-01-25 00:00;85;34;42;76
2017;January;4;2017-01-25 00:00;86;50;33;83
2017;January;4;2017-01-25 00:00;87;49;31;80
2017;January;4;2017-01-25 00:00;88;38;26;64
2017;January;4;2017-01-25 00:00;89;32;22;54
2017;January;4;2017-01-25 00:00;90;34;13;47
2017;January;4;2017-01-25 00:00;91;26;15;41
2017;January;4;2017-01-25 00:00;92;22;10;32
2017;January;4;2017-01-25 00:00;93;14;9;23
2017;January;4;2017-01-25 00:00;94;12;9;21
2017;January;4;2017-01-25 00:00;95;16;3;19
2017;January;4;2017-01-25 00:00;96;6;5;11
2017;January;4;2017-01-25 00:00;97;4;4;8
2017;January;4;2017-01-25 00:00;98;0;1;1
2017;January;4;2017-01-25 00:00;99;2;2;4
2017;January;4;2017-01-25 00:00;100;1;2;3
2017;January;4;2017-01-25 00:00;105;1;0;1
2017;February;5;2017-02-01 00:00;0;11;15;26
2017;February;5;2017-02-01 00:00;1;161;182;343
2017;February;5;2017-02-01 00:00;2;171;192;363
2017;February;5;2017-02-01 00:00;3;173;204;377
2017;February;5;2017-02-01 00:00;4;191;214;405
2017;February;5;2017-02-01 00:00;5;190;192;382
2017;February;5;2017-02-01 00:00;6;207;227;434
2017;February;5;2017-02-01 00:00;7;209;227;436
2017;February;5;2017-02-01 00:00;8;198;210;408
2017;February;5;2017-02-01 00:00;9;189;191;380
2017;February;5;2017-02-01 00:00;10;181;198;379
2017;February;5;2017-02-01 00:00;11;221;198;419
2017;February;5;2017-02-01 00:00;12;186;203;389
2017;February;5;2017-02-01 00:00;13;182;196;378
2017;February;5;2017-02-01 00:00;14;177;183;360
2017;February;5;2017-02-01 00:00;15;175;216;391
2017;February;5;2017-02-01 00:00;16;143;179;322
2017;February;5;2017-02-01 00:00;17;183;205;388
2017;February;5;2017-02-01 00:00;18;182;191;373
2017;February;5;2017-02-01 00:00;19;161;173;334
2017;February;5;2017-02-01 00:00;20;162;196;358
2017;February;5;2017-02-01 00:00;21;166;174;340
2017;February;5;2017-02-01 00:00;22;145;180;325
2017;February;5;2017-02-01 00:00;23;161;182;343
2017;February;5;2017-02-01 00:00;24;183;188;371
2017;February;5;2017-02-01 00:00;25;173;200;373
2017;February;5;2017-02-01 00:00;26;162;226;388
2017;February;5;2017-02-01 00:00;27;184;190;374
2017;February;5;2017-02-01 00:00;28;148;178;326
2017;February;5;2017-02-01 00:00;29;166;181;347
2017;February;5;2017-02-01 00:00;30;170;185;355
2017;February;5;2017-02-01 00:00;31;157;168;325
2017;February;5;2017-02-01 00:00;32;170;177;347
2017;February;5;2017-02-01 00:00;33;178;171;349
2017;February;5;2017-02-01 00:00;34;204;173;377
2017;February;5;2017-02-01 00:00;35;196;186;382
2017;February;5;2017-02-01 00:00;36;158;172;330
2017;February;5;2017-02-01 00:00;37;220;187;407
2017;February;5;2017-02-01 00:00;38;205;158;363
2017;February;5;2017-02-01 00:00;39;179;201;380
2017;February;5;2017-02-01 00:00;40;183;199;382
2017;February;5;2017-02-01 00:00;41;215;216;431
2017;February;5;2017-02-01 00:00;42;222;244;466
2017;February;5;2017-02-01 00:00;43;226;269;495
2017;February;5;2017-02-01 00:00;44;203;217;420
2017;February;5;2017-02-01 00:00;45;226;247;473
2017;February;5;2017-02-01 00:00;46;212;215;427
2017;February;5;2017-02-01 00:00;47;213;219;432
2017;February;5;2017-02-01 00:00;48;210;202;412
2017;February;5;2017-02-01 00:00;49;217;225;442
2017;February;5;2017-02-01 00:00;50;245;233;478
2017;February;5;2017-02-01 00:00;51;187;225;412
2017;February;5;2017-02-01 00:00;52;198;215;413
2017;February;5;2017-02-01 00:00;53;190;221;411
2017;February;5;2017-02-01 00:00;54;183;215;398
2017;February;5;2017-02-01 00:00;55;188;190;378
2017;February;5;2017-02-01 00:00;56;154;166;320
2017;February;5;2017-02-01 00:00;57;155;151;306
2017;February;5;2017-02-01 00:00;58;159;170;329
2017;February;5;2017-02-01 00:00;59;154;158;312
2017;February;5;2017-02-01 00:00;60;147;162;309
2017;February;5;2017-02-01 00:00;61;145;154;299
2017;February;5;2017-02-01 00:00;62;137;129;266
2017;February;5;2017-02-01 00:00;63;135;141;276
2017;February;5;2017-02-01 00:00;64;149;144;293
2017;February;5;2017-02-01 00:00;65;143;161;304
2017;February;5;2017-02-01 00:00;66;145;140;285
2017;February;5;2017-02-01 00:00;67;145;158;303
2017;February;5;2017-02-01 00:00;68;155;167;322
2017;February;5;2017-02-01 00:00;69;175;165;340
2017;February;5;2017-02-01 00:00;70;166;165;331
2017;February;5;2017-02-01 00:00;71;186;153;339
2017;February;5;2017-02-01 00:00;72;189;178;367
2017;February;5;2017-02-01 00:00;73;156;165;321
2017;February;5;2017-02-01 00:00;74;157;171;328
2017;February;5;2017-02-01 00:00;75;144;138;282
2017;February;5;2017-02-01 00:00;76;115;108;223
2017;February;5;2017-02-01 00:00;77;86;127;213
2017;February;5;2017-02-01 00:00;78;91;97;188
2017;February;5;2017-02-01 00:00;79;98;79;177
2017;February;5;2017-02-01 00:00;80;83;82;165
2017;February;5;2017-02-01 00:00;81;93;74;167
2017;February;5;2017-02-01 00:00;82;66;67;133
2017;February;5;2017-02-01 00:00;83;75;49;124
2017;February;5;2017-02-01 00:00;84;61;50;111
2017;February;5;2017-02-01 00:00;85;34;42;76
2017;February;5;2017-02-01 00:00;86;50;33;83
2017;February;5;2017-02-01 00:00;87;48;31;79
2017;February;5;2017-02-01 00:00;88;38;26;64
2017;February;5;2017-02-01 00:00;89;32;22;54
2017;February;5;2017-02-01 00:00;90;34;13;47
2017;February;5;2017-02-01 00:00;91;25;14;39
2017;February;5;2017-02-01 00:00;92;22;9;31
2017;February;5;2017-02-01 00:00;93;13;9;22
2017;February;5;2017-02-01 00:00;94;12;9;21
2017;February;5;2017-02-01 00:00;95;16;3;19
2017;February;5;2017-02-01 00:00;96;6;5;11
2017;February;5;2017-02-01 00:00;97;4;4;8
2017;February;5;2017-02-01 00:00;98;0;1;1
2017;February;5;2017-02-01 00:00;99;2;2;4
2017;February;5;2017-02-01 00:00;100;1;2;3
2017;February;5;2017-02-01 00:00;105;1;0;1
2017;February;6;2017-02-08 00:00;0;13;20;33
2017;February;6;2017-02-08 00:00;1;161;182;343
2017;February;6;2017-02-08 00:00;2;172;192;364
2017;February;6;2017-02-08 00:00;3;174;204;378
2017;February;6;2017-02-08 00:00;4;192;214;406
2017;February;6;2017-02-08 00:00;5;190;192;382
2017;February;6;2017-02-08 00:00;6;207;227;434
2017;February;6;2017-02-08 00:00;7;209;227;436
2017;February;6;2017-02-08 00:00;8;198;210;408
2017;February;6;2017-02-08 00:00;9;189;191;380
2017;February;6;2017-02-08 00:00;10;181;198;379
2017;February;6;2017-02-08 00:00;11;221;198;419
2017;February;6;2017-02-08 00:00;12;186;203;389
2017;February;6;2017-02-08 00:00;13;182;196;378
2017;February;6;2017-02-08 00:00;14;177;183;360
2017;February;6;2017-02-08 00:00;15;175;216;391
2017;February;6;2017-02-08 00:00;16;142;179;321
2017;February;6;2017-02-08 00:00;17;183;206;389
2017;February;6;2017-02-08 00:00;18;182;190;372
2017;February;6;2017-02-08 00:00;19;162;173;335
2017;February;6;2017-02-08 00:00;20;163;196;359
2017;February;6;2017-02-08 00:00;21;167;175;342
2017;February;6;2017-02-08 00:00;22;144;178;322
2017;February;6;2017-02-08 00:00;23;161;182;343
2017;February;6;2017-02-08 00:00;24;182;189;371
2017;February;6;2017-02-08 00:00;25;172;199;371
2017;February;6;2017-02-08 00:00;26;159;226;385
2017;February;6;2017-02-08 00:00;27;185;192;377
2017;February;6;2017-02-08 00:00;28;147;179;326
2017;February;6;2017-02-08 00:00;29;166;182;348
2017;February;6;2017-02-08 00:00;30;171;184;355
2017;February;6;2017-02-08 00:00;31;157;170;327
2017;February;6;2017-02-08 00:00;32;170;178;348
2017;February;6;2017-02-08 00:00;33;176;172;348
2017;February;6;2017-02-08 00:00;34;207;173;380
2017;February;6;2017-02-08 00:00;35;196;186;382
2017;February;6;2017-02-08 00:00;36;158;172;330
2017;February;6;2017-02-08 00:00;37;220;187;407
2017;February;6;2017-02-08 00:00;38;206;158;364
2017;February;6;2017-02-08 00:00;39;179;202;381
2017;February;6;2017-02-08 00:00;40;183;200;383
2017;February;6;2017-02-08 00:00;41;215;217;432
2017;February;6;2017-02-08 00:00;42;222;244;466
2017;February;6;2017-02-08 00:00;43;226;269;495
2017;February;6;2017-02-08 00:00;44;203;217;420
2017;February;6;2017-02-08 00:00;45;226;247;473
2017;February;6;2017-02-08 00:00;46;212;215;427
2017;February;6;2017-02-08 00:00;47;213;219;432
2017;February;6;2017-02-08 00:00;48;210;202;412
2017;February;6;2017-02-08 00:00;49;216;224;440
2017;February;6;2017-02-08 00:00;50;244;233;477
2017;February;6;2017-02-08 00:00;51;189;225;414
2017;February;6;2017-02-08 00:00;52;197;216;413
2017;February;6;2017-02-08 00:00;53;190;221;411
2017;February;6;2017-02-08 00:00;54;183;213;396
2017;February;6;2017-02-08 00:00;55;188;190;378
2017;February;6;2017-02-08 00:00;56;154;166;320
2017;February;6;2017-02-08 00:00;57;155;151;306
2017;February;6;2017-02-08 00:00;58;159;170;329
2017;February;6;2017-02-08 00:00;59;154;158;312
2017;February;6;2017-02-08 00:00;60;147;162;309
2017;February;6;2017-02-08 00:00;61;145;154;299
2017;February;6;2017-02-08 00:00;62;137;129;266
2017;February;6;2017-02-08 00:00;63;135;141;276
2017;February;6;2017-02-08 00:00;64;147;143;290
2017;February;6;2017-02-08 00:00;65;143;161;304
2017;February;6;2017-02-08 00:00;66;145;140;285
2017;February;6;2017-02-08 00:00;67;145;157;302
2017;February;6;2017-02-08 00:00;68;155;167;322
2017;February;6;2017-02-08 00:00;69;175;165;340
2017;February;6;2017-02-08 00:00;70;165;165;330
2017;February;6;2017-02-08 00:00;71;186;153;339
2017;February;6;2017-02-08 00:00;72;189;178;367
2017;February;6;2017-02-08 00:00;73;156;164;320
2017;February;6;2017-02-08 00:00;74;157;171;328
2017;February;6;2017-02-08 00:00;75;144;138;282
2017;February;6;2017-02-08 00:00;76;115;108;223
2017;February;6;2017-02-08 00:00;77;86;127;213
2017;February;6;2017-02-08 00:00;78;91;97;188
2017;February;6;2017-02-08 00:00;79;98;79;177
2017;February;6;2017-02-08 00:00;80;83;81;164
2017;February;6;2017-02-08 00:00;81;93;74;167
2017;February;6;2017-02-08 00:00;82;66;67;133
2017;February;6;2017-02-08 00:00;83;75;49;124
2017;February;6;2017-02-08 00:00;84;60;50;110
2017;February;6;2017-02-08 00:00;85;34;42;76
2017;February;6;2017-02-08 00:00;86;50;33;83
2017;February;6;2017-02-08 00:00;87;48;31;79
2017;February;6;2017-02-08 00:00;88;38;26;64
2017;February;6;2017-02-08 00:00;89;32;22;54
2017;February;6;2017-02-08 00:00;90;34;13;47
2017;February;6;2017-02-08 00:00;91;25;13;38
2017;February;6;2017-02-08 00:00;92;21;9;30
2017;February;6;2017-02-08 00:00;93;13;9;22
2017;February;6;2017-02-08 00:00;94;12;9;21
2017;February;6;2017-02-08 00:00;95;16;3;19
2017;February;6;2017-02-08 00:00;96;6;5;11
2017;February;6;2017-02-08 00:00;97;4;4;8
2017;February;6;2017-02-08 00:00;98;0;1;1
2017;February;6;2017-02-08 00:00;99;2;2;4
2017;February;6;2017-02-08 00:00;100;1;2;3
2017;February;6;2017-02-08 00:00;105;1;0;1
2017;February;7;2017-02-15 00:00;0;15;22;37
2017;February;7;2017-02-15 00:00;1;162;182;344
2017;February;7;2017-02-15 00:00;2;171;192;363
2017;February;7;2017-02-15 00:00;3;174;205;379
2017;February;7;2017-02-15 00:00;4;192;214;406
2017;February;7;2017-02-15 00:00;5;190;193;383
2017;February;7;2017-02-15 00:00;6;207;227;434
2017;February;7;2017-02-15 00:00;7;209;227;436
2017;February;7;2017-02-15 00:00;8;198;210;408
2017;February;7;2017-02-15 00:00;9;189;191;380
2017;February;7;2017-02-15 00:00;10;181;198;379
2017;February;7;2017-02-15 00:00;11;221;198;419
2017;February;7;2017-02-15 00:00;12;186;203;389
2017;February;7;2017-02-15 00:00;13;183;196;379
2017;February;7;2017-02-15 00:00;14;177;183;360
2017;February;7;2017-02-15 00:00;15;174;216;390
2017;February;7;2017-02-15 00:00;16;142;179;321
2017;February;7;2017-02-15 00:00;17;183;206;389
2017;February;7;2017-02-15 00:00;18;182;190;372
2017;February;7;2017-02-15 00:00;19;162;174;336
2017;February;7;2017-02-15 00:00;20;163;196;359
2017;February;7;2017-02-15 00:00;21;166;176;342
2017;February;7;2017-02-15 00:00;22;143;177;320
2017;February;7;2017-02-15 00:00;23;160;183;343
2017;February;7;2017-02-15 00:00;24;181;189;370
2017;February;7;2017-02-15 00:00;25;172;198;370
2017;February;7;2017-02-15 00:00;26;159;225;384
2017;February;7;2017-02-15 00:00;27;186;192;378
2017;February;7;2017-02-15 00:00;28;147;178;325
2017;February;7;2017-02-15 00:00;29;165;183;348
2017;February;7;2017-02-15 00:00;30;172;184;356
2017;February;7;2017-02-15 00:00;31;157;171;328
2017;February;7;2017-02-15 00:00;32;170;178;348
2017;February;7;2017-02-15 00:00;33;176;173;349
2017;February;7;2017-02-15 00:00;34;207;171;378
2017;February;7;2017-02-15 00:00;35;196;187;383
2017;February;7;2017-02-15 00:00;36;158;172;330
2017;February;7;2017-02-15 00:00;37;221;187;408
2017;February;7;2017-02-15 00:00;38;206;158;364
2017;February;7;2017-02-15 00:00;39;179;201;380
2017;February;7;2017-02-15 00:00;40;183;200;383
2017;February;7;2017-02-15 00:00;41;215;218;433
2017;February;7;2017-02-15 00:00;42;222;243;465
2017;February;7;2017-02-15 00:00;43;226;269;495
2017;February;7;2017-02-15 00:00;44;203;217;420
2017;February;7;2017-02-15 00:00;45;226;247;473
2017;February;7;2017-02-15 00:00;46;212;215;427
2017;February;7;2017-02-15 00:00;47;213;219;432
2017;February;7;2017-02-15 00:00;48;210;202;412
2017;February;7;2017-02-15 00:00;49;216;224;440
2017;February;7;2017-02-15 00:00;50;244;233;477
2017;February;7;2017-02-15 00:00;51;189;225;414
2017;February;7;2017-02-15 00:00;52;197;216;413
2017;February;7;2017-02-15 00:00;53;190;222;412
2017;February;7;2017-02-15 00:00;54;183;213;396
2017;February;7;2017-02-15 00:00;55;187;190;377
2017;February;7;2017-02-15 00:00;56;154;166;320
2017;February;7;2017-02-15 00:00;57;155;151;306
2017;February;7;2017-02-15 00:00;58;158;170;328
2017;February;7;2017-02-15 00:00;59;155;158;313
2017;February;7;2017-02-15 00:00;60;147;162;309
2017;February;7;2017-02-15 00:00;61;145;154;299
2017;February;7;2017-02-15 00:00;62;136;129;265
2017;February;7;2017-02-15 00:00;63;135;141;276
2017;February;7;2017-02-15 00:00;64;147;143;290
2017;February;7;2017-02-15 00:00;65;143;161;304
2017;February;7;2017-02-15 00:00;66;145;140;285
2017;February;7;2017-02-15 00:00;67;145;157;302
2017;February;7;2017-02-15 00:00;68;155;167;322
2017;February;7;2017-02-15 00:00;69;175;165;340
2017;February;7;2017-02-15 00:00;70;165;165;330
2017;February;7;2017-02-15 00:00;71;186;153;339
2017;February;7;2017-02-15 00:00;72;189;178;367
2017;February;7;2017-02-15 00:00;73;156;164;320
2017;February;7;2017-02-15 00:00;74;157;171;328
2017;February;7;2017-02-15 00:00;75;144;138;282
2017;February;7;2017-02-15 00:00;76;115;108;223
2017;February;7;2017-02-15 00:00;77;86;127;213
2017;February;7;2017-02-15 00:00;78;91;97;188
2017;February;7;2017-02-15 00:00;79;98;79;177
2017;February;7;2017-02-15 00:00;80;83;81;164
2017;February;7;2017-02-15 00:00;81;93;74;167
2017;February;7;2017-02-15 00:00;82;66;67;133
2017;February;7;2017-02-15 00:00;83;75;49;124
2017;February;7;2017-02-15 00:00;84;59;50;109
2017;February;7;2017-02-15 00:00;85;34;42;76
2017;February;7;2017-02-15 00:00;86;50;33;83
2017;February;7;2017-02-15 00:00;87;48;31;79
2017;February;7;2017-02-15 00:00;88;38;26;64
2017;February;7;2017-02-15 00:00;89;32;22;54
2017;February;7;2017-02-15 00:00;90;34;13;47
2017;February;7;2017-02-15 00:00;91;25;13;38
2017;February;7;2017-02-15 00:00;92;21;9;30
2017;February;7;2017-02-15 00:00;93;13;9;22
2017;February;7;2017-02-15 00:00;94;12;9;21
2017;February;7;2017-02-15 00:00;95;16;3;19
2017;February;7;2017-02-15 00:00;96;6;5;11
2017;February;7;2017-02-15 00:00;97;4;4;8
2017;February;7;2017-02-15 00:00;98;0;1;1
2017;February;7;2017-02-15 00:00;99;2;2;4
2017;February;7;2017-02-15 00:00;100;1;2;3
2017;February;7;2017-02-15 00:00;105;1;0;1
2017;February;8;2017-02-22 00:00;0;20;27;47
2017;February;8;2017-02-22 00:00;1;162;182;344
2017;February;8;2017-02-22 00:00;2;171;192;363
2017;February;8;2017-02-22 00:00;3;174;206;380
2017;February;8;2017-02-22 00:00;4;192;214;406
2017;February;8;2017-02-22 00:00;5;190;192;382
2017;February;8;2017-02-22 00:00;6;207;227;434
2017;February;8;2017-02-22 00:00;7;210;227;437
2017;February;8;2017-02-22 00:00;8;198;210;408
2017;February;8;2017-02-22 00:00;9;190;191;381
2017;February;8;2017-02-22 00:00;10;181;198;379
2017;February;8;2017-02-22 00:00;11;221;199;420
2017;February;8;2017-02-22 00:00;12;186;203;389
2017;February;8;2017-02-22 00:00;13;183;196;379
2017;February;8;2017-02-22 00:00;14;177;184;361
2017;February;8;2017-02-22 00:00;15;174;216;390
2017;February;8;2017-02-22 00:00;16;142;180;322
2017;February;8;2017-02-22 00:00;17;183;206;389
2017;February;8;2017-02-22 00:00;18;181;190;371
2017;February;8;2017-02-22 00:00;19;162;175;337
2017;February;8;2017-02-22 00:00;20;163;196;359
2017;February;8;2017-02-22 00:00;21;165;178;343
2017;February;8;2017-02-22 00:00;22;145;177;322
2017;February;8;2017-02-22 00:00;23;161;182;343
2017;February;8;2017-02-22 00:00;24;181;190;371
2017;February;8;2017-02-22 00:00;25;172;198;370
2017;February;8;2017-02-22 00:00;26;159;224;383
2017;February;8;2017-02-22 00:00;27;185;193;378
2017;February;8;2017-02-22 00:00;28;146;179;325
2017;February;8;2017-02-22 00:00;29;166;183;349
2017;February;8;2017-02-22 00:00;30;172;184;356
2017;February;8;2017-02-22 00:00;31;158;172;330
2017;February;8;2017-02-22 00:00;32;170;180;350
2017;February;8;2017-02-22 00:00;33;176;173;349
2017;February;8;2017-02-22 00:00;34;207;171;378
2017;February;8;2017-02-22 00:00;35;196;187;383
2017;February;8;2017-02-22 00:00;36;158;173;331
2017;February;8;2017-02-22 00:00;37;221;187;408
2017;February;8;2017-02-22 00:00;38;206;158;364
2017;February;8;2017-02-22 00:00;39;179;200;379
2017;February;8;2017-02-22 00:00;40;182;200;382
2017;February;8;2017-02-22 00:00;41;215;218;433
2017;February;8;2017-02-22 00:00;42;222;243;465
2017;February;8;2017-02-22 00:00;43;226;269;495
2017;February;8;2017-02-22 00:00;44;204;217;421
2017;February;8;2017-02-22 00:00;45;226;247;473
2017;February;8;2017-02-22 00:00;46;212;215;427
2017;February;8;2017-02-22 00:00;47;213;219;432
2017;February;8;2017-02-22 00:00;48;211;202;413
2017;February;8;2017-02-22 00:00;49;216;224;440
2017;February;8;2017-02-22 00:00;50;244;232;476
2017;February;8;2017-02-22 00:00;51;189;225;414
2017;February;8;2017-02-22 00:00;52;197;216;413
2017;February;8;2017-02-22 00:00;53;190;222;412
2017;February;8;2017-02-22 00:00;54;183;213;396
2017;February;8;2017-02-22 00:00;55;187;190;377
2017;February;8;2017-02-22 00:00;56;154;166;320
2017;February;8;2017-02-22 00:00;57;155;151;306
2017;February;8;2017-02-22 00:00;58;159;170;329
2017;February;8;2017-02-22 00:00;59;155;157;312
2017;February;8;2017-02-22 00:00;60;147;162;309
2017;February;8;2017-02-22 00:00;61;145;154;299
2017;February;8;2017-02-22 00:00;62;136;129;265
2017;February;8;2017-02-22 00:00;63;135;141;276
2017;February;8;2017-02-22 00:00;64;147;143;290
2017;February;8;2017-02-22 00:00;65;143;161;304
2017;February;8;2017-02-22 00:00;66;145;140;285
2017;February;8;2017-02-22 00:00;67;145;157;302
2017;February;8;2017-02-22 00:00;68;155;167;322
2017;February;8;2017-02-22 00:00;69;175;165;340
2017;February;8;2017-02-22 00:00;70;165;165;330
2017;February;8;2017-02-22 00:00;71;186;153;339
2017;February;8;2017-02-22 00:00;72;189;178;367
2017;February;8;2017-02-22 00:00;73;156;164;320
2017;February;8;2017-02-22 00:00;74;157;171;328
2017;February;8;2017-02-22 00:00;75;144;138;282
2017;February;8;2017-02-22 00:00;76;115;108;223
2017;February;8;2017-02-22 00:00;77;86;127;213
2017;February;8;2017-02-22 00:00;78;91;97;188
2017;February;8;2017-02-22 00:00;79;98;79;177
2017;February;8;2017-02-22 00:00;80;82;81;163
2017;February;8;2017-02-22 00:00;81;92;74;166
2017;February;8;2017-02-22 00:00;82;66;66;132
2017;February;8;2017-02-22 00:00;83;75;49;124
2017;February;8;2017-02-22 00:00;84;59;50;109
2017;February;8;2017-02-22 00:00;85;34;42;76
2017;February;8;2017-02-22 00:00;86;50;33;83
2017;February;8;2017-02-22 00:00;87;48;31;79
2017;February;8;2017-02-22 00:00;88;38;26;64
2017;February;8;2017-02-22 00:00;89;32;21;53
2017;February;8;2017-02-22 00:00;90;34;13;47
2017;February;8;2017-02-22 00:00;91;25;12;37
2017;February;8;2017-02-22 00:00;92;21;9;30
2017;February;8;2017-02-22 00:00;93;13;9;22
2017;February;8;2017-02-22 00:00;94;12;9;21
2017;February;8;2017-02-22 00:00;95;16;3;19
2017;February;8;2017-02-22 00:00;96;6;5;11
2017;February;8;2017-02-22 00:00;97;4;4;8
2017;February;8;2017-02-22 00:00;98;0;1;1
2017;February;8;2017-02-22 00:00;99;2;2;4
2017;February;8;2017-02-22 00:00;100;1;1;2
2017;February;8;2017-02-22 00:00;105;1;0;1
2017;March;9;2017-03-01 00:00;0;20;31;51
2017;March;9;2017-03-01 00:00;1;161;183;344
2017;March;9;2017-03-01 00:00;2;171;193;364
2017;March;9;2017-03-01 00:00;3;175;206;381
2017;March;9;2017-03-01 00:00;4;192;214;406
2017;March;9;2017-03-01 00:00;5;190;193;383
2017;March;9;2017-03-01 00:00;6;207;228;435
2017;March;9;2017-03-01 00:00;7;210;228;438
2017;March;9;2017-03-01 00:00;8;197;211;408
2017;March;9;2017-03-01 00:00;9;190;191;381
2017;March;9;2017-03-01 00:00;10;180;198;378
2017;March;9;2017-03-01 00:00;11;221;199;420
2017;March;9;2017-03-01 00:00;12;186;203;389
2017;March;9;2017-03-01 00:00;13;182;196;378
2017;March;9;2017-03-01 00:00;14;177;184;361
2017;March;9;2017-03-01 00:00;15;174;216;390
2017;March;9;2017-03-01 00:00;16;141;180;321
2017;March;9;2017-03-01 00:00;17;182;206;388
2017;March;9;2017-03-01 00:00;18;181;190;371
2017;March;9;2017-03-01 00:00;19;163;175;338
2017;March;9;2017-03-01 00:00;20;163;196;359
2017;March;9;2017-03-01 00:00;21;165;178;343
2017;March;9;2017-03-01 00:00;22;145;177;322
2017;March;9;2017-03-01 00:00;23;159;181;340
2017;March;9;2017-03-01 00:00;24;180;190;370
2017;March;9;2017-03-01 00:00;25;170;198;368
2017;March;9;2017-03-01 00:00;26;159;224;383
2017;March;9;2017-03-01 00:00;27;186;191;377
2017;March;9;2017-03-01 00:00;28;145;178;323
2017;March;9;2017-03-01 00:00;29;166;182;348
2017;March;9;2017-03-01 00:00;30;174;185;359
2017;March;9;2017-03-01 00:00;31;157;173;330
2017;March;9;2017-03-01 00:00;32;171;182;353
2017;March;9;2017-03-01 00:00;33;176;173;349
2017;March;9;2017-03-01 00:00;34;207;172;379
2017;March;9;2017-03-01 00:00;35;196;187;383
2017;March;9;2017-03-01 00:00;36;158;173;331
2017;March;9;2017-03-01 00:00;37;221;186;407
2017;March;9;2017-03-01 00:00;38;207;161;368
2017;March;9;2017-03-01 00:00;39;179;200;379
2017;March;9;2017-03-01 00:00;40;182;199;381
2017;March;9;2017-03-01 00:00;41;215;218;433
2017;March;9;2017-03-01 00:00;42;222;243;465
2017;March;9;2017-03-01 00:00;43;226;269;495
2017;March;9;2017-03-01 00:00;44;204;217;421
2017;March;9;2017-03-01 00:00;45;226;247;473
2017;March;9;2017-03-01 00:00;46;212;214;426
2017;March;9;2017-03-01 00:00;47;213;219;432
2017;March;9;2017-03-01 00:00;48;211;201;412
2017;March;9;2017-03-01 00:00;49;216;224;440
2017;March;9;2017-03-01 00:00;50;244;232;476
2017;March;9;2017-03-01 00:00;51;189;225;414
2017;March;9;2017-03-01 00:00;52;197;216;413
2017;March;9;2017-03-01 00:00;53;190;222;412
2017;March;9;2017-03-01 00:00;54;184;213;397
2017;March;9;2017-03-01 00:00;55;187;190;377
2017;March;9;2017-03-01 00:00;56;154;166;320
2017;March;9;2017-03-01 00:00;57;155;151;306
2017;March;9;2017-03-01 00:00;58;159;170;329
2017;March;9;2017-03-01 00:00;59;155;158;313
2017;March;9;2017-03-01 00:00;60;147;162;309
2017;March;9;2017-03-01 00:00;61;145;154;299
2017;March;9;2017-03-01 00:00;62;136;129;265
2017;March;9;2017-03-01 00:00;63;135;141;276
2017;March;9;2017-03-01 00:00;64;147;143;290
2017;March;9;2017-03-01 00:00;65;143;161;304
2017;March;9;2017-03-01 00:00;66;145;140;285
2017;March;9;2017-03-01 00:00;67;145;157;302
2017;March;9;2017-03-01 00:00;68;155;166;321
2017;March;9;2017-03-01 00:00;69;175;166;341
2017;March;9;2017-03-01 00:00;70;165;165;330
2017;March;9;2017-03-01 00:00;71;186;153;339
2017;March;9;2017-03-01 00:00;72;189;178;367
2017;March;9;2017-03-01 00:00;73;156;164;320
2017;March;9;2017-03-01 00:00;74;156;171;327
2017;March;9;2017-03-01 00:00;75;144;138;282
2017;March;9;2017-03-01 00:00;76;115;108;223
2017;March;9;2017-03-01 00:00;77;86;127;213
2017;March;9;2017-03-01 00:00;78;91;97;188
2017;March;9;2017-03-01 00:00;79;98;80;178
2017;March;9;2017-03-01 00:00;80;82;80;162
2017;March;9;2017-03-01 00:00;81;92;73;165
2017;March;9;2017-03-01 00:00;82;66;66;132
2017;March;9;2017-03-01 00:00;83;75;49;124
2017;March;9;2017-03-01 00:00;84;59;50;109
2017;March;9;2017-03-01 00:00;85;34;41;75
2017;March;9;2017-03-01 00:00;86;50;33;83
2017;March;9;2017-03-01 00:00;87;48;31;79
2017;March;9;2017-03-01 00:00;88;38;25;63
2017;March;9;2017-03-01 00:00;89;32;21;53
2017;March;9;2017-03-01 00:00;90;34;13;47
2017;March;9;2017-03-01 00:00;91;25;12;37
2017;March;9;2017-03-01 00:00;92;21;9;30
2017;March;9;2017-03-01 00:00;93;13;9;22
2017;March;9;2017-03-01 00:00;94;12;9;21
2017;March;9;2017-03-01 00:00;95;16;3;19
2017;March;9;2017-03-01 00:00;96;6;5;11
2017;March;9;2017-03-01 00:00;97;4;4;8
2017;March;9;2017-03-01 00:00;98;0;1;1
2017;March;9;2017-03-01 00:00;99;2;2;4
2017;March;9;2017-03-01 00:00;100;1;1;2
2017;March;9;2017-03-01 00:00;105;1;0;1
2017;March;10;2017-03-08 00:00;0;27;34;61
2017;March;10;2017-03-08 00:00;1;161;184;345
2017;March;10;2017-03-08 00:00;2;171;194;365
2017;March;10;2017-03-08 00:00;3;174;206;380
2017;March;10;2017-03-08 00:00;4;192;215;407
2017;March;10;2017-03-08 00:00;5;190;193;383
2017;March;10;2017-03-08 00:00;6;207;228;435
2017;March;10;2017-03-08 00:00;7;210;229;439
2017;March;10;2017-03-08 00:00;8;198;211;409
2017;March;10;2017-03-08 00:00;9;190;191;381
2017;March;10;2017-03-08 00:00;10;180;198;378
2017;March;10;2017-03-08 00:00;11;223;199;422
2017;March;10;2017-03-08 00:00;12;186;203;389
2017;March;10;2017-03-08 00:00;13;183;196;379
2017;March;10;2017-03-08 00:00;14;178;185;363
2017;March;10;2017-03-08 00:00;15;174;217;391
2017;March;10;2017-03-08 00:00;16;142;181;323
2017;March;10;2017-03-08 00:00;17;183;205;388
2017;March;10;2017-03-08 00:00;18;181;190;371
2017;March;10;2017-03-08 00:00;19;162;175;337
2017;March;10;2017-03-08 00:00;20;164;196;360
2017;March;10;2017-03-08 00:00;21;163;176;339
2017;March;10;2017-03-08 00:00;22;144;177;321
2017;March;10;2017-03-08 00:00;23;157;178;335
2017;March;10;2017-03-08 00:00;24;179;191;370
2017;March;10;2017-03-08 00:00;25;170;197;367
2017;March;10;2017-03-08 00:00;26;161;224;385
2017;March;10;2017-03-08 00:00;27;188;193;381
2017;March;10;2017-03-08 00:00;28;146;179;325
2017;March;10;2017-03-08 00:00;29;166;182;348
2017;March;10;2017-03-08 00:00;30;172;184;356
2017;March;10;2017-03-08 00:00;31;154;174;328
2017;March;10;2017-03-08 00:00;32;173;182;355
2017;March;10;2017-03-08 00:00;33;176;173;349
2017;March;10;2017-03-08 00:00;34;207;172;379
2017;March;10;2017-03-08 00:00;35;197;187;384
2017;March;10;2017-03-08 00:00;36;158;173;331
2017;March;10;2017-03-08 00:00;37;221;186;407
2017;March;10;2017-03-08 00:00;38;206;161;367
2017;March;10;2017-03-08 00:00;39;179;200;379
2017;March;10;2017-03-08 00:00;40;182;199;381
2017;March;10;2017-03-08 00:00;41;215;218;433
2017;March;10;2017-03-08 00:00;42;222;243;465
2017;March;10;2017-03-08 00:00;43;225;269;494
2017;March;10;2017-03-08 00:00;44;205;218;423
2017;March;10;2017-03-08 00:00;45;226;247;473
2017;March;10;2017-03-08 00:00;46;211;214;425
2017;March;10;2017-03-08 00:00;47;213;220;433
2017;March;10;2017-03-08 00:00;48;211;201;412
2017;March;10;2017-03-08 00:00;49;216;224;440
2017;March;10;2017-03-08 00:00;50;244;232;476
2017;March;10;2017-03-08 00:00;51;189;225;414
2017;March;10;2017-03-08 00:00;52;197;216;413
2017;March;10;2017-03-08 00:00;53;190;221;411
2017;March;10;2017-03-08 00:00;54;184;213;397
2017;March;10;2017-03-08 00:00;55;187;190;377
2017;March;10;2017-03-08 00:00;56;154;166;320
2017;March;10;2017-03-08 00:00;57;155;151;306
2017;March;10;2017-03-08 00:00;58;159;170;329
2017;March;10;2017-03-08 00:00;59;155;158;313
2017;March;10;2017-03-08 00:00;60;147;163;310
2017;March;10;2017-03-08 00:00;61;145;154;299
2017;March;10;2017-03-08 00:00;62;136;130;266
2017;March;10;2017-03-08 00:00;63;135;141;276
2017;March;10;2017-03-08 00:00;64;147;142;289
2017;March;10;2017-03-08 00:00;65;142;161;303
2017;March;10;2017-03-08 00:00;66;145;140;285
2017;March;10;2017-03-08 00:00;67;145;156;301
2017;March;10;2017-03-08 00:00;68;155;166;321
2017;March;10;2017-03-08 00:00;69;175;166;341
2017;March;10;2017-03-08 00:00;70;165;165;330
2017;March;10;2017-03-08 00:00;71;186;153;339
2017;March;10;2017-03-08 00:00;72;189;178;367
2017;March;10;2017-03-08 00:00;73;156;163;319
2017;March;10;2017-03-08 00:00;74;156;171;327
2017;March;10;2017-03-08 00:00;75;144;138;282
2017;March;10;2017-03-08 00:00;76;115;108;223
2017;March;10;2017-03-08 00:00;77;86;127;213
2017;March;10;2017-03-08 00:00;78;91;97;188
2017;March;10;2017-03-08 00:00;79;98;80;178
2017;March;10;2017-03-08 00:00;80;82;80;162
2017;March;10;2017-03-08 00:00;81;92;73;165
2017;March;10;2017-03-08 00:00;82;66;66;132
2017;March;10;2017-03-08 00:00;83;75;48;123
2017;March;10;2017-03-08 00:00;84;59;50;109
2017;March;10;2017-03-08 00:00;85;34;41;75
2017;March;10;2017-03-08 00:00;86;50;33;83
2017;March;10;2017-03-08 00:00;87;48;31;79
2017;March;10;2017-03-08 00:00;88;38;25;63
2017;March;10;2017-03-08 00:00;89;32;21;53
2017;March;10;2017-03-08 00:00;90;33;13;46
2017;March;10;2017-03-08 00:00;91;25;11;36
2017;March;10;2017-03-08 00:00;92;21;9;30
2017;March;10;2017-03-08 00:00;93;13;9;22
2017;March;10;2017-03-08 00:00;94;12;9;21
2017;March;10;2017-03-08 00:00;95;16;3;19
2017;March;10;2017-03-08 00:00;96;6;5;11
2017;March;10;2017-03-08 00:00;97;4;4;8
2017;March;10;2017-03-08 00:00;98;0;1;1
2017;March;10;2017-03-08 00:00;99;2;2;4
2017;March;10;2017-03-08 00:00;100;1;1;2
2017;March;10;2017-03-08 00:00;105;1;0;1
2017;March;11;2017-03-15 00:00;0;30;39;69
2017;March;11;2017-03-15 00:00;1;161;184;345
2017;March;11;2017-03-15 00:00;2;172;194;366
2017;March;11;2017-03-15 00:00;3;174;206;380
2017;March;11;2017-03-15 00:00;4;193;215;408
2017;March;11;2017-03-15 00:00;5;191;194;385
2017;March;11;2017-03-15 00:00;6;207;228;435
2017;March;11;2017-03-15 00:00;7;210;229;439
2017;March;11;2017-03-15 00:00;8;198;211;409
2017;March;11;2017-03-15 00:00;9;190;191;381
2017;March;11;2017-03-15 00:00;10;180;198;378
2017;March;11;2017-03-15 00:00;11;223;199;422
2017;March;11;2017-03-15 00:00;12;186;203;389
2017;March;11;2017-03-15 00:00;13;183;196;379
2017;March;11;2017-03-15 00:00;14;178;185;363
2017;March;11;2017-03-15 00:00;15;174;217;391
2017;March;11;2017-03-15 00:00;16;143;181;324
2017;March;11;2017-03-15 00:00;17;183;205;388
2017;March;11;2017-03-15 00:00;18;180;190;370
2017;March;11;2017-03-15 00:00;19;162;175;337
2017;March;11;2017-03-15 00:00;20;164;196;360
2017;March;11;2017-03-15 00:00;21;162;176;338
2017;March;11;2017-03-15 00:00;22;143;179;322
2017;March;11;2017-03-15 00:00;23;155;178;333
2017;March;11;2017-03-15 00:00;24;179;191;370
2017;March;11;2017-03-15 00:00;25;170;197;367
2017;March;11;2017-03-15 00:00;26;161;225;386
2017;March;11;2017-03-15 00:00;27;192;192;384
2017;March;11;2017-03-15 00:00;28;146;179;325
2017;March;11;2017-03-15 00:00;29;165;182;347
2017;March;11;2017-03-15 00:00;30;170;184;354
2017;March;11;2017-03-15 00:00;31;153;174;327
2017;March;11;2017-03-15 00:00;32;173;182;355
2017;March;11;2017-03-15 00:00;33;177;172;349
2017;March;11;2017-03-15 00:00;34;207;171;378
2017;March;11;2017-03-15 00:00;35;196;186;382
2017;March;11;2017-03-15 00:00;36;158;173;331
2017;March;11;2017-03-15 00:00;37;222;186;408
2017;March;11;2017-03-15 00:00;38;206;161;367
2017;March;11;2017-03-15 00:00;39;179;200;379
2017;March;11;2017-03-15 00:00;40;182;200;382
2017;March;11;2017-03-15 00:00;41;215;217;432
2017;March;11;2017-03-15 00:00;42;222;244;466
2017;March;11;2017-03-15 00:00;43;225;268;493
2017;March;11;2017-03-15 00:00;44;204;218;422
2017;March;11;2017-03-15 00:00;45;226;247;473
2017;March;11;2017-03-15 00:00;46;211;214;425
2017;March;11;2017-03-15 00:00;47;213;220;433
2017;March;11;2017-03-15 00:00;48;211;201;412
2017;March;11;2017-03-15 00:00;49;216;224;440
2017;March;11;2017-03-15 00:00;50;244;232;476
2017;March;11;2017-03-15 00:00;51;189;225;414
2017;March;11;2017-03-15 00:00;52;197;216;413
2017;March;11;2017-03-15 00:00;53;190;221;411
2017;March;11;2017-03-15 00:00;54;183;213;396
2017;March;11;2017-03-15 00:00;55;187;190;377
2017;March;11;2017-03-15 00:00;56;154;166;320
2017;March;11;2017-03-15 00:00;57;155;151;306
2017;March;11;2017-03-15 00:00;58;159;169;328
2017;March;11;2017-03-15 00:00;59;156;158;314
2017;March;11;2017-03-15 00:00;60;147;163;310
2017;March;11;2017-03-15 00:00;61;145;154;299
2017;March;11;2017-03-15 00:00;62;136;129;265
2017;March;11;2017-03-15 00:00;63;135;141;276
2017;March;11;2017-03-15 00:00;64;147;142;289
2017;March;11;2017-03-15 00:00;65;142;161;303
2017;March;11;2017-03-15 00:00;66;145;140;285
2017;March;11;2017-03-15 00:00;67;145;156;301
2017;March;11;2017-03-15 00:00;68;155;166;321
2017;March;11;2017-03-15 00:00;69;175;166;341
2017;March;11;2017-03-15 00:00;70;165;164;329
2017;March;11;2017-03-15 00:00;71;185;153;338
2017;March;11;2017-03-15 00:00;72;189;178;367
2017;March;11;2017-03-15 00:00;73;156;163;319
2017;March;11;2017-03-15 00:00;74;156;171;327
2017;March;11;2017-03-15 00:00;75;144;138;282
2017;March;11;2017-03-15 00:00;76;115;108;223
2017;March;11;2017-03-15 00:00;77;86;127;213
2017;March;11;2017-03-15 00:00;78;90;97;187
2017;March;11;2017-03-15 00:00;79;98;80;178
2017;March;11;2017-03-15 00:00;80;82;80;162
2017;March;11;2017-03-15 00:00;81;92;72;164
2017;March;11;2017-03-15 00:00;82;66;66;132
2017;March;11;2017-03-15 00:00;83;75;48;123
2017;March;11;2017-03-15 00:00;84;59;50;109
2017;March;11;2017-03-15 00:00;85;34;40;74
2017;March;11;2017-03-15 00:00;86;50;33;83
2017;March;11;2017-03-15 00:00;87;48;31;79
2017;March;11;2017-03-15 00:00;88;38;25;63
2017;March;11;2017-03-15 00:00;89;32;21;53
2017;March;11;2017-03-15 00:00;90;33;13;46
2017;March;11;2017-03-15 00:00;91;25;11;36
2017;March;11;2017-03-15 00:00;92;22;9;31
2017;March;11;2017-03-15 00:00;93;13;9;22
2017;March;11;2017-03-15 00:00;94;12;9;21
2017;March;11;2017-03-15 00:00;95;16;3;19
2017;March;11;2017-03-15 00:00;96;6;5;11
2017;March;11;2017-03-15 00:00;97;4;4;8
2017;March;11;2017-03-15 00:00;98;0;1;1
2017;March;11;2017-03-15 00:00;99;2;2;4
2017;March;11;2017-03-15 00:00;100;1;1;2
2017;March;11;2017-03-15 00:00;105;1;0;1
2017;March;12;2017-03-22 00:00;0;34;39;73
2017;March;12;2017-03-22 00:00;1;161;184;345
2017;March;12;2017-03-22 00:00;2;172;194;366
2017;March;12;2017-03-22 00:00;3;175;206;381
2017;March;12;2017-03-22 00:00;4;194;215;409
2017;March;12;2017-03-22 00:00;5;192;194;386
2017;March;12;2017-03-22 00:00;6;207;228;435
2017;March;12;2017-03-22 00:00;7;210;229;439
2017;March;12;2017-03-22 00:00;8;198;211;409
2017;March;12;2017-03-22 00:00;9;190;192;382
2017;March;12;2017-03-22 00:00;10;180;199;379
2017;March;12;2017-03-22 00:00;11;223;199;422
2017;March;12;2017-03-22 00:00;12;186;203;389
2017;March;12;2017-03-22 00:00;13;183;196;379
2017;March;12;2017-03-22 00:00;14;177;185;362
2017;March;12;2017-03-22 00:00;15;174;217;391
2017;March;12;2017-03-22 00:00;16;143;184;327
2017;March;12;2017-03-22 00:00;17;182;205;387
2017;March;12;2017-03-22 00:00;18;182;190;372
2017;March;12;2017-03-22 00:00;19;162;175;337
2017;March;12;2017-03-22 00:00;20;163;195;358
2017;March;12;2017-03-22 00:00;21;162;175;337
2017;March;12;2017-03-22 00:00;22;145;179;324
2017;March;12;2017-03-22 00:00;23;155;178;333
2017;March;12;2017-03-22 00:00;24;177;192;369
2017;March;12;2017-03-22 00:00;25;169;196;365
2017;March;12;2017-03-22 00:00;26;162;226;388
2017;March;12;2017-03-22 00:00;27;190;194;384
2017;March;12;2017-03-22 00:00;28;146;178;324
2017;March;12;2017-03-22 00:00;29;167;183;350
2017;March;12;2017-03-22 00:00;30;171;184;355
2017;March;12;2017-03-22 00:00;31;153;176;329
2017;March;12;2017-03-22 00:00;32;173;182;355
2017;March;12;2017-03-22 00:00;33;176;173;349
2017;March;12;2017-03-22 00:00;34;207;171;378
2017;March;12;2017-03-22 00:00;35;196;185;381
2017;March;12;2017-03-22 00:00;36;158;173;331
2017;March;12;2017-03-22 00:00;37;223;186;409
2017;March;12;2017-03-22 00:00;38;206;162;368
2017;March;12;2017-03-22 00:00;39;179;200;379
2017;March;12;2017-03-22 00:00;40;182;201;383
2017;March;12;2017-03-22 00:00;41;215;217;432
2017;March;12;2017-03-22 00:00;42;222;244;466
2017;March;12;2017-03-22 00:00;43;225;269;494
2017;March;12;2017-03-22 00:00;44;204;218;422
2017;March;12;2017-03-22 00:00;45;226;247;473
2017;March;12;2017-03-22 00:00;46;211;215;426
2017;March;12;2017-03-22 00:00;47;213;220;433
2017;March;12;2017-03-22 00:00;48;211;202;413
2017;March;12;2017-03-22 00:00;49;216;224;440
2017;March;12;2017-03-22 00:00;50;244;232;476
2017;March;12;2017-03-22 00:00;51;189;225;414
2017;March;12;2017-03-22 00:00;52;197;216;413
2017;March;12;2017-03-22 00:00;53;190;221;411
2017;March;12;2017-03-22 00:00;54;183;213;396
2017;March;12;2017-03-22 00:00;55;187;190;377
2017;March;12;2017-03-22 00:00;56;154;166;320
2017;March;12;2017-03-22 00:00;57;155;151;306
2017;March;12;2017-03-22 00:00;58;159;170;329
2017;March;12;2017-03-22 00:00;59;156;159;315
2017;March;12;2017-03-22 00:00;60;148;163;311
2017;March;12;2017-03-22 00:00;61;145;154;299
2017;March;12;2017-03-22 00:00;62;136;129;265
2017;March;12;2017-03-22 00:00;63;135;141;276
2017;March;12;2017-03-22 00:00;64;147;142;289
2017;March;12;2017-03-22 00:00;65;141;161;302
2017;March;12;2017-03-22 00:00;66;145;140;285
2017;March;12;2017-03-22 00:00;67;145;156;301
2017;March;12;2017-03-22 00:00;68;155;166;321
2017;March;12;2017-03-22 00:00;69;174;166;340
2017;March;12;2017-03-22 00:00;70;165;164;329
2017;March;12;2017-03-22 00:00;71;185;154;339
2017;March;12;2017-03-22 00:00;72;189;178;367
2017;March;12;2017-03-22 00:00;73;156;163;319
2017;March;12;2017-03-22 00:00;74;156;171;327
2017;March;12;2017-03-22 00:00;75;144;138;282
2017;March;12;2017-03-22 00:00;76;115;108;223
2017;March;12;2017-03-22 00:00;77;86;127;213
2017;March;12;2017-03-22 00:00;78;90;96;186
2017;March;12;2017-03-22 00:00;79;98;80;178
2017;March;12;2017-03-22 00:00;80;82;80;162
2017;March;12;2017-03-22 00:00;81;92;72;164
2017;March;12;2017-03-22 00:00;82;66;66;132
2017;March;12;2017-03-22 00:00;83;75;48;123
2017;March;12;2017-03-22 00:00;84;59;50;109
2017;March;12;2017-03-22 00:00;85;34;40;74
2017;March;12;2017-03-22 00:00;86;50;33;83
2017;March;12;2017-03-22 00:00;87;48;31;79
2017;March;12;2017-03-22 00:00;88;37;25;62
2017;March;12;2017-03-22 00:00;89;32;21;53
2017;March;12;2017-03-22 00:00;90;32;13;45
2017;March;12;2017-03-22 00:00;91;25;11;36
2017;March;12;2017-03-22 00:00;92;22;9;31
2017;March;12;2017-03-22 00:00;93;13;9;22
2017;March;12;2017-03-22 00:00;94;12;9;21
2017;March;12;2017-03-22 00:00;95;16;3;19
2017;March;12;2017-03-22 00:00;96;6;5;11
2017;March;12;2017-03-22 00:00;97;4;4;8
2017;March;12;2017-03-22 00:00;98;0;1;1
2017;March;12;2017-03-22 00:00;99;2;2;4
2017;March;12;2017-03-22 00:00;100;1;1;2
2017;March;12;2017-03-22 00:00;105;1;0;1
2017;March;13;2017-03-29 00:00;0;37;42;79
2017;March;13;2017-03-29 00:00;1;161;185;346
2017;March;13;2017-03-29 00:00;2;171;193;364
2017;March;13;2017-03-29 00:00;3;175;206;381
2017;March;13;2017-03-29 00:00;4;194;215;409
2017;March;13;2017-03-29 00:00;5;192;194;386
2017;March;13;2017-03-29 00:00;6;208;229;437
2017;March;13;2017-03-29 00:00;7;210;229;439
2017;March;13;2017-03-29 00:00;8;198;211;409
2017;March;13;2017-03-29 00:00;9;191;192;383
2017;March;13;2017-03-29 00:00;10;182;199;381
2017;March;13;2017-03-29 00:00;11;223;199;422
2017;March;13;2017-03-29 00:00;12;187;204;391
2017;March;13;2017-03-29 00:00;13;183;197;380
2017;March;13;2017-03-29 00:00;14;177;185;362
2017;March;13;2017-03-29 00:00;15;174;217;391
2017;March;13;2017-03-29 00:00;16;143;184;327
2017;March;13;2017-03-29 00:00;17;182;205;387
2017;March;13;2017-03-29 00:00;18;183;189;372
2017;March;13;2017-03-29 00:00;19;161;176;337
2017;March;13;2017-03-29 00:00;20;163;195;358
2017;March;13;2017-03-29 00:00;21;162;175;337
2017;March;13;2017-03-29 00:00;22;145;178;323
2017;March;13;2017-03-29 00:00;23;154;177;331
2017;March;13;2017-03-29 00:00;24;177;192;369
2017;March;13;2017-03-29 00:00;25;169;196;365
2017;March;13;2017-03-29 00:00;26;161;226;387
2017;March;13;2017-03-29 00:00;27;191;194;385
2017;March;13;2017-03-29 00:00;28;146;177;323
2017;March;13;2017-03-29 00:00;29;167;184;351
2017;March;13;2017-03-29 00:00;30;170;183;353
2017;March;13;2017-03-29 00:00;31;153;176;329
2017;March;13;2017-03-29 00:00;32;173;183;356
2017;March;13;2017-03-29 00:00;33;176;173;349
2017;March;13;2017-03-29 00:00;34;207;170;377
2017;March;13;2017-03-29 00:00;35;197;185;382
2017;March;13;2017-03-29 00:00;36;159;173;332
2017;March;13;2017-03-29 00:00;37;224;186;410
2017;March;13;2017-03-29 00:00;38;207;162;369
2017;March;13;2017-03-29 00:00;39;179;200;379
2017;March;13;2017-03-29 00:00;40;182;200;382
2017;March;13;2017-03-29 00:00;41;215;217;432
2017;March;13;2017-03-29 00:00;42;222;244;466
2017;March;13;2017-03-29 00:00;43;226;270;496
2017;March;13;2017-03-29 00:00;44;204;217;421
2017;March;13;2017-03-29 00:00;45;226;247;473
2017;March;13;2017-03-29 00:00;46;211;216;427
2017;March;13;2017-03-29 00:00;47;213;221;434
2017;March;13;2017-03-29 00:00;48;211;202;413
2017;March;13;2017-03-29 00:00;49;216;224;440
2017;March;13;2017-03-29 00:00;50;244;231;475
2017;March;13;2017-03-29 00:00;51;189;225;414
2017;March;13;2017-03-29 00:00;52;197;216;413
2017;March;13;2017-03-29 00:00;53;190;221;411
2017;March;13;2017-03-29 00:00;54;183;213;396
2017;March;13;2017-03-29 00:00;55;187;190;377
2017;March;13;2017-03-29 00:00;56;154;166;320
2017;March;13;2017-03-29 00:00;57;155;151;306
2017;March;13;2017-03-29 00:00;58;158;170;328
2017;March;13;2017-03-29 00:00;59;156;159;315
2017;March;13;2017-03-29 00:00;60;148;163;311
2017;March;13;2017-03-29 00:00;61;145;154;299
2017;March;13;2017-03-29 00:00;62;136;129;265
2017;March;13;2017-03-29 00:00;63;135;141;276
2017;March;13;2017-03-29 00:00;64;147;142;289
2017;March;13;2017-03-29 00:00;65;141;161;302
2017;March;13;2017-03-29 00:00;66;145;140;285
2017;March;13;2017-03-29 00:00;67;145;156;301
2017;March;13;2017-03-29 00:00;68;155;165;320
2017;March;13;2017-03-29 00:00;69;174;166;340
2017;March;13;2017-03-29 00:00;70;164;163;327
2017;March;13;2017-03-29 00:00;71;185;154;339
2017;March;13;2017-03-29 00:00;72;188;178;366
2017;March;13;2017-03-29 00:00;73;156;163;319
2017;March;13;2017-03-29 00:00;74;156;171;327
2017;March;13;2017-03-29 00:00;75;143;138;281
2017;March;13;2017-03-29 00:00;76;115;108;223
2017;March;13;2017-03-29 00:00;77;86;127;213
2017;March;13;2017-03-29 00:00;78;89;96;185
2017;March;13;2017-03-29 00:00;79;98;80;178
2017;March;13;2017-03-29 00:00;80;82;80;162
2017;March;13;2017-03-29 00:00;81;92;71;163
2017;March;13;2017-03-29 00:00;82;66;66;132
2017;March;13;2017-03-29 00:00;83;75;48;123
2017;March;13;2017-03-29 00:00;84;59;50;109
2017;March;13;2017-03-29 00:00;85;34;40;74
2017;March;13;2017-03-29 00:00;86;50;33;83
2017;March;13;2017-03-29 00:00;87;48;31;79
2017;March;13;2017-03-29 00:00;88;37;25;62
2017;March;13;2017-03-29 00:00;89;32;21;53
2017;March;13;2017-03-29 00:00;90;32;13;45
2017;March;13;2017-03-29 00:00;91;25;11;36
2017;March;13;2017-03-29 00:00;92;22;9;31
2017;March;13;2017-03-29 00:00;93;12;9;21
2017;March;13;2017-03-29 00:00;94;12;9;21
2017;March;13;2017-03-29 00:00;95;15;3;18
2017;March;13;2017-03-29 00:00;96;6;5;11
2017;March;13;2017-03-29 00:00;97;4;4;8
2017;March;13;2017-03-29 00:00;98;0;1;1
2017;March;13;2017-03-29 00:00;99;2;2;4
2017;March;13;2017-03-29 00:00;100;1;1;2
2017;March;13;2017-03-29 00:00;105;1;0;1
2017;April;14;2017-04-05 00:00;0;41;45;86
2017;April;14;2017-04-05 00:00;1;161;184;345
2017;April;14;2017-04-05 00:00;2;172;194;366
2017;April;14;2017-04-05 00:00;3;176;207;383
2017;April;14;2017-04-05 00:00;4;195;215;410
2017;April;14;2017-04-05 00:00;5;193;194;387
2017;April;14;2017-04-05 00:00;6;208;229;437
2017;April;14;2017-04-05 00:00;7;210;228;438
2017;April;14;2017-04-05 00:00;8;198;210;408
2017;April;14;2017-04-05 00:00;9;191;192;383
2017;April;14;2017-04-05 00:00;10;182;199;381
2017;April;14;2017-04-05 00:00;11;223;199;422
2017;April;14;2017-04-05 00:00;12;187;204;391
2017;April;14;2017-04-05 00:00;13;185;197;382
2017;April;14;2017-04-05 00:00;14;177;186;363
2017;April;14;2017-04-05 00:00;15;174;217;391
2017;April;14;2017-04-05 00:00;16;143;184;327
2017;April;14;2017-04-05 00:00;17;182;204;386
2017;April;14;2017-04-05 00:00;18;183;189;372
2017;April;14;2017-04-05 00:00;19;161;176;337
2017;April;14;2017-04-05 00:00;20;164;194;358
2017;April;14;2017-04-05 00:00;21;161;175;336
2017;April;14;2017-04-05 00:00;22;146;179;325
2017;April;14;2017-04-05 00:00;23;157;177;334
2017;April;14;2017-04-05 00:00;24;178;194;372
2017;April;14;2017-04-05 00:00;25;171;195;366
2017;April;14;2017-04-05 00:00;26;162;224;386
2017;April;14;2017-04-05 00:00;27;191;195;386
2017;April;14;2017-04-05 00:00;28;147;176;323
2017;April;14;2017-04-05 00:00;29;166;187;353
2017;April;14;2017-04-05 00:00;30;169;185;354
2017;April;14;2017-04-05 00:00;31;153;176;329
2017;April;14;2017-04-05 00:00;32;174;184;358
2017;April;14;2017-04-05 00:00;33;176;173;349
2017;April;14;2017-04-05 00:00;34;208;168;376
2017;April;14;2017-04-05 00:00;35;197;185;382
2017;April;14;2017-04-05 00:00;36;160;176;336
2017;April;14;2017-04-05 00:00;37;223;187;410
2017;April;14;2017-04-05 00:00;38;205;162;367
2017;April;14;2017-04-05 00:00;39;182;201;383
2017;April;14;2017-04-05 00:00;40;182;200;382
2017;April;14;2017-04-05 00:00;41;215;216;431
2017;April;14;2017-04-05 00:00;42;222;243;465
2017;April;14;2017-04-05 00:00;43;226;271;497
2017;April;14;2017-04-05 00:00;44;204;217;421
2017;April;14;2017-04-05 00:00;45;224;247;471
2017;April;14;2017-04-05 00:00;46;211;216;427
2017;April;14;2017-04-05 00:00;47;213;221;434
2017;April;14;2017-04-05 00:00;48;211;202;413
2017;April;14;2017-04-05 00:00;49;216;224;440
2017;April;14;2017-04-05 00:00;50;242;232;474
2017;April;14;2017-04-05 00:00;51;189;225;414
2017;April;14;2017-04-05 00:00;52;197;216;413
2017;April;14;2017-04-05 00:00;53;191;221;412
2017;April;14;2017-04-05 00:00;54;185;213;398
2017;April;14;2017-04-05 00:00;55;186;188;374
2017;April;14;2017-04-05 00:00;56;154;166;320
2017;April;14;2017-04-05 00:00;57;156;152;308
2017;April;14;2017-04-05 00:00;58;157;169;326
2017;April;14;2017-04-05 00:00;59;156;158;314
2017;April;14;2017-04-05 00:00;60;148;161;309
2017;April;14;2017-04-05 00:00;61;145;154;299
2017;April;14;2017-04-05 00:00;62;136;129;265
2017;April;14;2017-04-05 00:00;63;135;140;275
2017;April;14;2017-04-05 00:00;64;146;141;287
2017;April;14;2017-04-05 00:00;65;140;161;301
2017;April;14;2017-04-05 00:00;66;145;140;285
2017;April;14;2017-04-05 00:00;67;145;156;301
2017;April;14;2017-04-05 00:00;68;154;165;319
2017;April;14;2017-04-05 00:00;69;174;167;341
2017;April;14;2017-04-05 00:00;70;164;162;326
2017;April;14;2017-04-05 00:00;71;185;154;339
2017;April;14;2017-04-05 00:00;72;188;177;365
2017;April;14;2017-04-05 00:00;73;156;163;319
2017;April;14;2017-04-05 00:00;74;156;171;327
2017;April;14;2017-04-05 00:00;75;143;138;281
2017;April;14;2017-04-05 00:00;76;115;108;223
2017;April;14;2017-04-05 00:00;77;86;127;213
2017;April;14;2017-04-05 00:00;78;89;96;185
2017;April;14;2017-04-05 00:00;79;98;80;178
2017;April;14;2017-04-05 00:00;80;81;80;161
2017;April;14;2017-04-05 00:00;81;91;70;161
2017;April;14;2017-04-05 00:00;82;66;66;132
2017;April;14;2017-04-05 00:00;83;75;48;123
2017;April;14;2017-04-05 00:00;84;59;50;109
2017;April;14;2017-04-05 00:00;85;34;40;74
2017;April;14;2017-04-05 00:00;86;50;33;83
2017;April;14;2017-04-05 00:00;87;48;31;79
2017;April;14;2017-04-05 00:00;88;37;25;62
2017;April;14;2017-04-05 00:00;89;32;21;53
2017;April;14;2017-04-05 00:00;90;32;13;45
2017;April;14;2017-04-05 00:00;91;25;11;36
2017;April;14;2017-04-05 00:00;92;21;9;30
2017;April;14;2017-04-05 00:00;93;12;9;21
2017;April;14;2017-04-05 00:00;94;12;9;21
2017;April;14;2017-04-05 00:00;95;15;3;18
2017;April;14;2017-04-05 00:00;96;6;5;11
2017;April;14;2017-04-05 00:00;97;4;3;7
2017;April;14;2017-04-05 00:00;98;0;1;1
2017;April;14;2017-04-05 00:00;99;2;2;4
2017;April;14;2017-04-05 00:00;100;1;1;2
2017;April;14;2017-04-05 00:00;105;1;0;1
2017;April;15;2017-04-12 00:00;0;47;51;98
2017;April;15;2017-04-12 00:00;1;161;186;347
2017;April;15;2017-04-12 00:00;2;174;195;369
2017;April;15;2017-04-12 00:00;3;177;208;385
2017;April;15;2017-04-12 00:00;4;196;215;411
2017;April;15;2017-04-12 00:00;5;193;194;387
2017;April;15;2017-04-12 00:00;6;209;230;439
2017;April;15;2017-04-12 00:00;7;210;228;438
2017;April;15;2017-04-12 00:00;8;199;210;409
2017;April;15;2017-04-12 00:00;9;191;192;383
2017;April;15;2017-04-12 00:00;10;182;200;382
2017;April;15;2017-04-12 00:00;11;223;199;422
2017;April;15;2017-04-12 00:00;12;187;204;391
2017;April;15;2017-04-12 00:00;13;185;198;383
2017;April;15;2017-04-12 00:00;14;177;186;363
2017;April;15;2017-04-12 00:00;15;174;218;392
2017;April;15;2017-04-12 00:00;16;143;183;326
2017;April;15;2017-04-12 00:00;17;182;204;386
2017;April;15;2017-04-12 00:00;18;184;189;373
2017;April;15;2017-04-12 00:00;19;161;176;337
2017;April;15;2017-04-12 00:00;20;164;193;357
2017;April;15;2017-04-12 00:00;21;162;174;336
2017;April;15;2017-04-12 00:00;22;146;180;326
2017;April;15;2017-04-12 00:00;23;158;178;336
2017;April;15;2017-04-12 00:00;24;178;194;372
2017;April;15;2017-04-12 00:00;25;169;195;364
2017;April;15;2017-04-12 00:00;26;162;224;386
2017;April;15;2017-04-12 00:00;27;191;196;387
2017;April;15;2017-04-12 00:00;28;148;179;327
2017;April;15;2017-04-12 00:00;29;166;186;352
2017;April;15;2017-04-12 00:00;30;169;184;353
2017;April;15;2017-04-12 00:00;31;153;176;329
2017;April;15;2017-04-12 00:00;32;173;184;357
2017;April;15;2017-04-12 00:00;33;176;173;349
2017;April;15;2017-04-12 00:00;34;210;168;378
2017;April;15;2017-04-12 00:00;35;197;185;382
2017;April;15;2017-04-12 00:00;36;159;177;336
2017;April;15;2017-04-12 00:00;37;224;187;411
2017;April;15;2017-04-12 00:00;38;205;163;368
2017;April;15;2017-04-12 00:00;39;182;202;384
2017;April;15;2017-04-12 00:00;40;182;200;382
2017;April;15;2017-04-12 00:00;41;215;218;433
2017;April;15;2017-04-12 00:00;42;222;243;465
2017;April;15;2017-04-12 00:00;43;226;270;496
2017;April;15;2017-04-12 00:00;44;204;217;421
2017;April;15;2017-04-12 00:00;45;224;247;471
2017;April;15;2017-04-12 00:00;46;211;217;428
2017;April;15;2017-04-12 00:00;47;213;220;433
2017;April;15;2017-04-12 00:00;48;211;202;413
2017;April;15;2017-04-12 00:00;49;216;224;440
2017;April;15;2017-04-12 00:00;50;242;232;474
2017;April;15;2017-04-12 00:00;51;189;225;414
2017;April;15;2017-04-12 00:00;52;197;216;413
2017;April;15;2017-04-12 00:00;53;191;221;412
2017;April;15;2017-04-12 00:00;54;185;214;399
2017;April;15;2017-04-12 00:00;55;186;188;374
2017;April;15;2017-04-12 00:00;56;154;165;319
2017;April;15;2017-04-12 00:00;57;156;152;308
2017;April;15;2017-04-12 00:00;58;157;169;326
2017;April;15;2017-04-12 00:00;59;156;158;314
2017;April;15;2017-04-12 00:00;60;148;161;309
2017;April;15;2017-04-12 00:00;61;145;153;298
2017;April;15;2017-04-12 00:00;62;136;129;265
2017;April;15;2017-04-12 00:00;63;135;140;275
2017;April;15;2017-04-12 00:00;64;146;142;288
2017;April;15;2017-04-12 00:00;65;140;161;301
2017;April;15;2017-04-12 00:00;66;145;140;285
2017;April;15;2017-04-12 00:00;67;145;157;302
2017;April;15;2017-04-12 00:00;68;154;165;319
2017;April;15;2017-04-12 00:00;69;174;167;341
2017;April;15;2017-04-12 00:00;70;164;162;326
2017;April;15;2017-04-12 00:00;71;185;154;339
2017;April;15;2017-04-12 00:00;72;188;177;365
2017;April;15;2017-04-12 00:00;73;156;163;319
2017;April;15;2017-04-12 00:00;74;156;171;327
2017;April;15;2017-04-12 00:00;75;143;138;281
2017;April;15;2017-04-12 00:00;76;115;108;223
2017;April;15;2017-04-12 00:00;77;85;127;212
2017;April;15;2017-04-12 00:00;78;90;95;185
2017;April;15;2017-04-12 00:00;79;98;80;178
2017;April;15;2017-04-12 00:00;80;80;80;160
2017;April;15;2017-04-12 00:00;81;91;70;161
2017;April;15;2017-04-12 00:00;82;66;66;132
2017;April;15;2017-04-12 00:00;83;74;48;122
2017;April;15;2017-04-12 00:00;84;59;50;109
2017;April;15;2017-04-12 00:00;85;34;40;74
2017;April;15;2017-04-12 00:00;86;50;33;83
2017;April;15;2017-04-12 00:00;87;48;31;79
2017;April;15;2017-04-12 00:00;88;37;25;62
2017;April;15;2017-04-12 00:00;89;32;21;53
2017;April;15;2017-04-12 00:00;90;32;13;45
2017;April;15;2017-04-12 00:00;91;25;11;36
2017;April;15;2017-04-12 00:00;92;21;9;30
2017;April;15;2017-04-12 00:00;93;12;9;21
2017;April;15;2017-04-12 00:00;94;12;9;21
2017;April;15;2017-04-12 00:00;95;15;3;18
2017;April;15;2017-04-12 00:00;96;6;4;10
2017;April;15;2017-04-12 00:00;97;4;3;7
2017;April;15;2017-04-12 00:00;98;0;1;1
2017;April;15;2017-04-12 00:00;99;2;2;4
2017;April;15;2017-04-12 00:00;100;1;1;2
2017;April;15;2017-04-12 00:00;105;1;0;1
2017;April;16;2017-04-19 00:00;0;50;51;101
2017;April;16;2017-04-19 00:00;1;161;186;347
2017;April;16;2017-04-19 00:00;2;173;195;368
2017;April;16;2017-04-19 00:00;3;177;210;387
2017;April;16;2017-04-19 00:00;4;196;214;410
2017;April;16;2017-04-19 00:00;5;192;194;386
2017;April;16;2017-04-19 00:00;6;209;230;439
2017;April;16;2017-04-19 00:00;7;211;228;439
2017;April;16;2017-04-19 00:00;8;199;211;410
2017;April;16;2017-04-19 00:00;9;191;192;383
2017;April;16;2017-04-19 00:00;10;182;199;381
2017;April;16;2017-04-19 00:00;11;224;199;423
2017;April;16;2017-04-19 00:00;12;187;204;391
2017;April;16;2017-04-19 00:00;13;185;200;385
2017;April;16;2017-04-19 00:00;14;177;186;363
2017;April;16;2017-04-19 00:00;15;174;218;392
2017;April;16;2017-04-19 00:00;16;143;183;326
2017;April;16;2017-04-19 00:00;17;184;204;388
2017;April;16;2017-04-19 00:00;18;185;189;374
2017;April;16;2017-04-19 00:00;19;161;177;338
2017;April;16;2017-04-19 00:00;20;164;193;357
2017;April;16;2017-04-19 00:00;21;162;174;336
2017;April;16;2017-04-19 00:00;22;146;180;326
2017;April;16;2017-04-19 00:00;23;158;178;336
2017;April;16;2017-04-19 00:00;24;177;193;370
2017;April;16;2017-04-19 00:00;25;171;194;365
2017;April;16;2017-04-19 00:00;26;162;224;386
2017;April;16;2017-04-19 00:00;27;191;197;388
2017;April;16;2017-04-19 00:00;28;148;178;326
2017;April;16;2017-04-19 00:00;29;166;186;352
2017;April;16;2017-04-19 00:00;30;170;185;355
2017;April;16;2017-04-19 00:00;31;153;177;330
2017;April;16;2017-04-19 00:00;32;172;182;354
2017;April;16;2017-04-19 00:00;33;176;173;349
2017;April;16;2017-04-19 00:00;34;209;168;377
2017;April;16;2017-04-19 00:00;35;197;184;381
2017;April;16;2017-04-19 00:00;36;159;177;336
2017;April;16;2017-04-19 00:00;37;225;187;412
2017;April;16;2017-04-19 00:00;38;205;163;368
2017;April;16;2017-04-19 00:00;39;183;202;385
2017;April;16;2017-04-19 00:00;40;181;200;381
2017;April;16;2017-04-19 00:00;41;215;218;433
2017;April;16;2017-04-19 00:00;42;222;243;465
2017;April;16;2017-04-19 00:00;43;226;270;496
2017;April;16;2017-04-19 00:00;44;204;217;421
2017;April;16;2017-04-19 00:00;45;225;248;473
2017;April;16;2017-04-19 00:00;46;211;217;428
2017;April;16;2017-04-19 00:00;47;213;221;434
2017;April;16;2017-04-19 00:00;48;209;202;411
2017;April;16;2017-04-19 00:00;49;216;223;439
2017;April;16;2017-04-19 00:00;50;242;232;474
2017;April;16;2017-04-19 00:00;51;188;225;413
2017;April;16;2017-04-19 00:00;52;197;217;414
2017;April;16;2017-04-19 00:00;53;191;221;412
2017;April;16;2017-04-19 00:00;54;185;214;399
2017;April;16;2017-04-19 00:00;55;186;188;374
2017;April;16;2017-04-19 00:00;56;154;165;319
2017;April;16;2017-04-19 00:00;57;155;152;307
2017;April;16;2017-04-19 00:00;58;157;169;326
2017;April;16;2017-04-19 00:00;59;156;158;314
2017;April;16;2017-04-19 00:00;60;148;162;310
2017;April;16;2017-04-19 00:00;61;145;153;298
2017;April;16;2017-04-19 00:00;62;136;129;265
2017;April;16;2017-04-19 00:00;63;135;140;275
2017;April;16;2017-04-19 00:00;64;146;142;288
2017;April;16;2017-04-19 00:00;65;140;161;301
2017;April;16;2017-04-19 00:00;66;145;140;285
2017;April;16;2017-04-19 00:00;67;145;157;302
2017;April;16;2017-04-19 00:00;68;154;165;319
2017;April;16;2017-04-19 00:00;69;174;167;341
2017;April;16;2017-04-19 00:00;70;164;162;326
2017;April;16;2017-04-19 00:00;71;185;153;338
2017;April;16;2017-04-19 00:00;72;188;177;365
2017;April;16;2017-04-19 00:00;73;156;163;319
2017;April;16;2017-04-19 00:00;74;156;171;327
2017;April;16;2017-04-19 00:00;75;142;138;280
2017;April;16;2017-04-19 00:00;76;115;108;223
2017;April;16;2017-04-19 00:00;77;85;127;212
2017;April;16;2017-04-19 00:00;78;90;95;185
2017;April;16;2017-04-19 00:00;79;98;80;178
2017;April;16;2017-04-19 00:00;80;80;80;160
2017;April;16;2017-04-19 00:00;81;91;70;161
2017;April;16;2017-04-19 00:00;82;66;66;132
2017;April;16;2017-04-19 00:00;83;74;48;122
2017;April;16;2017-04-19 00:00;84;59;50;109
2017;April;16;2017-04-19 00:00;85;34;40;74
2017;April;16;2017-04-19 00:00;86;50;33;83
2017;April;16;2017-04-19 00:00;87;48;31;79
2017;April;16;2017-04-19 00:00;88;37;25;62
2017;April;16;2017-04-19 00:00;89;32;21;53
2017;April;16;2017-04-19 00:00;90;32;13;45
2017;April;16;2017-04-19 00:00;91;25;11;36
2017;April;16;2017-04-19 00:00;92;21;9;30
2017;April;16;2017-04-19 00:00;93;12;9;21
2017;April;16;2017-04-19 00:00;94;12;9;21
2017;April;16;2017-04-19 00:00;95;15;3;18
2017;April;16;2017-04-19 00:00;96;6;4;10
2017;April;16;2017-04-19 00:00;97;4;3;7
2017;April;16;2017-04-19 00:00;98;0;1;1
2017;April;16;2017-04-19 00:00;99;2;2;4
2017;April;16;2017-04-19 00:00;100;1;1;2
2017;April;16;2017-04-19 00:00;105;1;0;1
2017;April;17;2017-04-26 00:00;0;51;54;105
2017;April;17;2017-04-26 00:00;1;160;186;346
2017;April;17;2017-04-26 00:00;2;173;195;368
2017;April;17;2017-04-26 00:00;3;178;210;388
2017;April;17;2017-04-26 00:00;4;196;214;410
2017;April;17;2017-04-26 00:00;5;192;193;385
2017;April;17;2017-04-26 00:00;6;209;230;439
2017;April;17;2017-04-26 00:00;7;211;230;441
2017;April;17;2017-04-26 00:00;8;199;211;410
2017;April;17;2017-04-26 00:00;9;192;192;384
2017;April;17;2017-04-26 00:00;10;182;200;382
2017;April;17;2017-04-26 00:00;11;225;199;424
2017;April;17;2017-04-26 00:00;12;187;205;392
2017;April;17;2017-04-26 00:00;13;185;200;385
2017;April;17;2017-04-26 00:00;14;178;187;365
2017;April;17;2017-04-26 00:00;15;174;218;392
2017;April;17;2017-04-26 00:00;16;143;184;327
2017;April;17;2017-04-26 00:00;17;184;205;389
2017;April;17;2017-04-26 00:00;18;185;189;374
2017;April;17;2017-04-26 00:00;19;161;177;338
2017;April;17;2017-04-26 00:00;20;164;193;357
2017;April;17;2017-04-26 00:00;21;161;174;335
2017;April;17;2017-04-26 00:00;22;147;180;327
2017;April;17;2017-04-26 00:00;23;157;177;334
2017;April;17;2017-04-26 00:00;24;178;193;371
2017;April;17;2017-04-26 00:00;25;172;195;367
2017;April;17;2017-04-26 00:00;26;162;223;385
2017;April;17;2017-04-26 00:00;27;191;197;388
2017;April;17;2017-04-26 00:00;28;146;178;324
2017;April;17;2017-04-26 00:00;29;166;185;351
2017;April;17;2017-04-26 00:00;30;170;185;355
2017;April;17;2017-04-26 00:00;31;153;178;331
2017;April;17;2017-04-26 00:00;32;172;182;354
2017;April;17;2017-04-26 00:00;33;177;174;351
2017;April;17;2017-04-26 00:00;34;209;168;377
2017;April;17;2017-04-26 00:00;35;197;183;380
2017;April;17;2017-04-26 00:00;36;159;179;338
2017;April;17;2017-04-26 00:00;37;226;187;413
2017;April;17;2017-04-26 00:00;38;205;164;369
2017;April;17;2017-04-26 00:00;39;183;202;385
2017;April;17;2017-04-26 00:00;40;181;200;381
2017;April;17;2017-04-26 00:00;41;214;218;432
2017;April;17;2017-04-26 00:00;42;222;243;465
2017;April;17;2017-04-26 00:00;43;226;271;497
2017;April;17;2017-04-26 00:00;44;204;218;422
2017;April;17;2017-04-26 00:00;45;225;248;473
2017;April;17;2017-04-26 00:00;46;211;217;428
2017;April;17;2017-04-26 00:00;47;214;220;434
2017;April;17;2017-04-26 00:00;48;209;202;411
2017;April;17;2017-04-26 00:00;49;216;223;439
2017;April;17;2017-04-26 00:00;50;243;232;475
2017;April;17;2017-04-26 00:00;51;188;226;414
2017;April;17;2017-04-26 00:00;52;197;217;414
2017;April;17;2017-04-26 00:00;53;192;221;413
2017;April;17;2017-04-26 00:00;54;183;214;397
2017;April;17;2017-04-26 00:00;55;186;188;374
2017;April;17;2017-04-26 00:00;56;154;164;318
2017;April;17;2017-04-26 00:00;57;155;152;307
2017;April;17;2017-04-26 00:00;58;157;169;326
2017;April;17;2017-04-26 00:00;59;156;158;314
2017;April;17;2017-04-26 00:00;60;148;162;310
2017;April;17;2017-04-26 00:00;61;145;153;298
2017;April;17;2017-04-26 00:00;62;136;129;265
2017;April;17;2017-04-26 00:00;63;134;140;274
2017;April;17;2017-04-26 00:00;64;146;141;287
2017;April;17;2017-04-26 00:00;65;140;161;301
2017;April;17;2017-04-26 00:00;66;145;139;284
2017;April;17;2017-04-26 00:00;67;145;157;302
2017;April;17;2017-04-26 00:00;68;154;165;319
2017;April;17;2017-04-26 00:00;69;174;167;341
2017;April;17;2017-04-26 00:00;70;164;162;326
2017;April;17;2017-04-26 00:00;71;185;153;338
2017;April;17;2017-04-26 00:00;72;188;177;365
2017;April;17;2017-04-26 00:00;73;156;163;319
2017;April;17;2017-04-26 00:00;74;156;171;327
2017;April;17;2017-04-26 00:00;75;142;138;280
2017;April;17;2017-04-26 00:00;76;115;108;223
2017;April;17;2017-04-26 00:00;77;85;127;212
2017;April;17;2017-04-26 00:00;78;90;95;185
2017;April;17;2017-04-26 00:00;79;98;80;178
2017;April;17;2017-04-26 00:00;80;80;79;159
2017;April;17;2017-04-26 00:00;81;91;70;161
2017;April;17;2017-04-26 00:00;82;66;66;132
2017;April;17;2017-04-26 00:00;83;74;48;122
2017;April;17;2017-04-26 00:00;84;58;50;108
2017;April;17;2017-04-26 00:00;85;34;40;74
2017;April;17;2017-04-26 00:00;86;49;32;81
2017;April;17;2017-04-26 00:00;87;48;31;79
2017;April;17;2017-04-26 00:00;88;37;25;62
2017;April;17;2017-04-26 00:00;89;32;21;53
2017;April;17;2017-04-26 00:00;90;32;13;45
2017;April;17;2017-04-26 00:00;91;25;11;36
2017;April;17;2017-04-26 00:00;92;21;8;29
2017;April;17;2017-04-26 00:00;93;12;9;21
2017;April;17;2017-04-26 00:00;94;12;9;21
2017;April;17;2017-04-26 00:00;95;15;3;18
2017;April;17;2017-04-26 00:00;96;6;4;10
2017;April;17;2017-04-26 00:00;97;4;3;7
2017;April;17;2017-04-26 00:00;98;0;1;1
2017;April;17;2017-04-26 00:00;99;2;2;4
2017;April;17;2017-04-26 00:00;100;1;1;2
2017;April;17;2017-04-26 00:00;105;1;0;1
2017;May;18;2017-05-03 00:00;0;55;59;114
2017;May;18;2017-05-03 00:00;1;161;187;348
2017;May;18;2017-05-03 00:00;2;174;196;370
2017;May;18;2017-05-03 00:00;3;178;210;388
2017;May;18;2017-05-03 00:00;4;197;215;412
2017;May;18;2017-05-03 00:00;5;192;192;384
2017;May;18;2017-05-03 00:00;6;210;230;440
2017;May;18;2017-05-03 00:00;7;212;231;443
2017;May;18;2017-05-03 00:00;8;199;211;410
2017;May;18;2017-05-03 00:00;9;194;191;385
2017;May;18;2017-05-03 00:00;10;182;200;382
2017;May;18;2017-05-03 00:00;11;225;200;425
2017;May;18;2017-05-03 00:00;12;186;205;391
2017;May;18;2017-05-03 00:00;13;185;200;385
2017;May;18;2017-05-03 00:00;14;178;186;364
2017;May;18;2017-05-03 00:00;15;174;218;392
2017;May;18;2017-05-03 00:00;16;143;184;327
2017;May;18;2017-05-03 00:00;17;183;206;389
2017;May;18;2017-05-03 00:00;18;185;189;374
2017;May;18;2017-05-03 00:00;19;162;177;339
2017;May;18;2017-05-03 00:00;20;163;193;356
2017;May;18;2017-05-03 00:00;21;161;172;333
2017;May;18;2017-05-03 00:00;22;145;180;325
2017;May;18;2017-05-03 00:00;23;158;175;333
2017;May;18;2017-05-03 00:00;24;176;195;371
2017;May;18;2017-05-03 00:00;25;171;195;366
2017;May;18;2017-05-03 00:00;26;162;220;382
2017;May;18;2017-05-03 00:00;27;190;197;387
2017;May;18;2017-05-03 00:00;28;147;180;327
2017;May;18;2017-05-03 00:00;29;166;186;352
2017;May;18;2017-05-03 00:00;30;171;185;356
2017;May;18;2017-05-03 00:00;31;155;180;335
2017;May;18;2017-05-03 00:00;32;173;184;357
2017;May;18;2017-05-03 00:00;33;178;174;352
2017;May;18;2017-05-03 00:00;34;209;168;377
2017;May;18;2017-05-03 00:00;35;197;183;380
2017;May;18;2017-05-03 00:00;36;160;178;338
2017;May;18;2017-05-03 00:00;37;227;188;415
2017;May;18;2017-05-03 00:00;38;206;166;372
2017;May;18;2017-05-03 00:00;39;185;203;388
2017;May;18;2017-05-03 00:00;40;181;199;380
2017;May;18;2017-05-03 00:00;41;214;219;433
2017;May;18;2017-05-03 00:00;42;222;243;465
2017;May;18;2017-05-03 00:00;43;226;270;496
2017;May;18;2017-05-03 00:00;44;205;218;423
2017;May;18;2017-05-03 00:00;45;225;248;473
2017;May;18;2017-05-03 00:00;46;210;217;427
2017;May;18;2017-05-03 00:00;47;214;220;434
2017;May;18;2017-05-03 00:00;48;209;203;412
2017;May;18;2017-05-03 00:00;49;216;223;439
2017;May;18;2017-05-03 00:00;50;242;230;472
2017;May;18;2017-05-03 00:00;51;189;225;414
2017;May;18;2017-05-03 00:00;52;198;218;416
2017;May;18;2017-05-03 00:00;53;190;221;411
2017;May;18;2017-05-03 00:00;54;183;215;398
2017;May;18;2017-05-03 00:00;55;186;188;374
2017;May;18;2017-05-03 00:00;56;154;163;317
2017;May;18;2017-05-03 00:00;57;155;152;307
2017;May;18;2017-05-03 00:00;58;157;170;327
2017;May;18;2017-05-03 00:00;59;156;157;313
2017;May;18;2017-05-03 00:00;60;149;161;310
2017;May;18;2017-05-03 00:00;61;145;154;299
2017;May;18;2017-05-03 00:00;62;136;129;265
2017;May;18;2017-05-03 00:00;63;133;140;273
2017;May;18;2017-05-03 00:00;64;146;141;287
2017;May;18;2017-05-03 00:00;65;140;161;301
2017;May;18;2017-05-03 00:00;66;145;139;284
2017;May;18;2017-05-03 00:00;67;145;157;302
2017;May;18;2017-05-03 00:00;68;155;165;320
2017;May;18;2017-05-03 00:00;69;174;167;341
2017;May;18;2017-05-03 00:00;70;164;162;326
2017;May;18;2017-05-03 00:00;71;185;153;338
2017;May;18;2017-05-03 00:00;72;188;178;366
2017;May;18;2017-05-03 00:00;73;155;163;318
2017;May;18;2017-05-03 00:00;74;156;171;327
2017;May;18;2017-05-03 00:00;75;141;138;279
2017;May;18;2017-05-03 00:00;76;115;108;223
2017;May;18;2017-05-03 00:00;77;85;127;212
2017;May;18;2017-05-03 00:00;78;90;95;185
2017;May;18;2017-05-03 00:00;79;98;80;178
2017;May;18;2017-05-03 00:00;80;80;79;159
2017;May;18;2017-05-03 00:00;81;91;70;161
2017;May;18;2017-05-03 00:00;82;66;66;132
2017;May;18;2017-05-03 00:00;83;74;48;122
2017;May;18;2017-05-03 00:00;84;58;50;108
2017;May;18;2017-05-03 00:00;85;34;40;74
2017;May;18;2017-05-03 00:00;86;49;32;81
2017;May;18;2017-05-03 00:00;87;48;30;78
2017;May;18;2017-05-03 00:00;88;37;25;62
2017;May;18;2017-05-03 00:00;89;32;21;53
2017;May;18;2017-05-03 00:00;90;32;13;45
2017;May;18;2017-05-03 00:00;91;25;11;36
2017;May;18;2017-05-03 00:00;92;21;8;29
2017;May;18;2017-05-03 00:00;93;12;9;21
2017;May;18;2017-05-03 00:00;94;12;9;21
2017;May;18;2017-05-03 00:00;95;15;3;18
2017;May;18;2017-05-03 00:00;96;6;4;10
2017;May;18;2017-05-03 00:00;97;4;3;7
2017;May;18;2017-05-03 00:00;98;0;1;1
2017;May;18;2017-05-03 00:00;99;2;2;4
2017;May;18;2017-05-03 00:00;100;1;1;2
2017;May;18;2017-05-03 00:00;105;1;0;1
2017;May;19;2017-05-10 00:00;0;60;66;126
2017;May;19;2017-05-10 00:00;1;164;186;350
2017;May;19;2017-05-10 00:00;2;175;197;372
2017;May;19;2017-05-10 00:00;3;176;209;385
2017;May;19;2017-05-10 00:00;4;197;214;411
2017;May;19;2017-05-10 00:00;5;192;193;385
2017;May;19;2017-05-10 00:00;6;210;230;440
2017;May;19;2017-05-10 00:00;7;213;231;444
2017;May;19;2017-05-10 00:00;8;200;211;411
2017;May;19;2017-05-10 00:00;9;194;191;385
2017;May;19;2017-05-10 00:00;10;182;200;382
2017;May;19;2017-05-10 00:00;11;225;200;425
2017;May;19;2017-05-10 00:00;12;186;204;390
2017;May;19;2017-05-10 00:00;13;185;200;385
2017;May;19;2017-05-10 00:00;14;178;186;364
2017;May;19;2017-05-10 00:00;15;174;218;392
2017;May;19;2017-05-10 00:00;16;143;184;327
2017;May;19;2017-05-10 00:00;17;183;206;389
2017;May;19;2017-05-10 00:00;18;185;189;374
2017;May;19;2017-05-10 00:00;19;161;177;338
2017;May;19;2017-05-10 00:00;20;163;192;355
2017;May;19;2017-05-10 00:00;21;160;171;331
2017;May;19;2017-05-10 00:00;22;147;180;327
2017;May;19;2017-05-10 00:00;23;159;175;334
2017;May;19;2017-05-10 00:00;24;174;195;369
2017;May;19;2017-05-10 00:00;25;172;195;367
2017;May;19;2017-05-10 00:00;26;162;223;385
2017;May;19;2017-05-10 00:00;27;188;198;386
2017;May;19;2017-05-10 00:00;28;148;182;330
2017;May;19;2017-05-10 00:00;29;166;186;352
2017;May;19;2017-05-10 00:00;30;173;185;358
2017;May;19;2017-05-10 00:00;31;156;180;336
2017;May;19;2017-05-10 00:00;32;173;185;358
2017;May;19;2017-05-10 00:00;33;178;174;352
2017;May;19;2017-05-10 00:00;34;209;169;378
2017;May;19;2017-05-10 00:00;35;197;183;380
2017;May;19;2017-05-10 00:00;36;160;177;337
2017;May;19;2017-05-10 00:00;37;228;188;416
2017;May;19;2017-05-10 00:00;38;206;167;373
2017;May;19;2017-05-10 00:00;39;185;204;389
2017;May;19;2017-05-10 00:00;40;182;200;382
2017;May;19;2017-05-10 00:00;41;214;219;433
2017;May;19;2017-05-10 00:00;42;222;242;464
2017;May;19;2017-05-10 00:00;43;226;270;496
2017;May;19;2017-05-10 00:00;44;205;218;423
2017;May;19;2017-05-10 00:00;45;225;249;474
2017;May;19;2017-05-10 00:00;46;210;217;427
2017;May;19;2017-05-10 00:00;47;214;221;435
2017;May;19;2017-05-10 00:00;48;208;202;410
2017;May;19;2017-05-10 00:00;49;216;223;439
2017;May;19;2017-05-10 00:00;50;242;230;472
2017;May;19;2017-05-10 00:00;51;189;225;414
2017;May;19;2017-05-10 00:00;52;198;218;416
2017;May;19;2017-05-10 00:00;53;190;221;411
2017;May;19;2017-05-10 00:00;54;183;216;399
2017;May;19;2017-05-10 00:00;55;186;188;374
2017;May;19;2017-05-10 00:00;56;154;163;317
2017;May;19;2017-05-10 00:00;57;155;152;307
2017;May;19;2017-05-10 00:00;58;157;170;327
2017;May;19;2017-05-10 00:00;59;156;157;313
2017;May;19;2017-05-10 00:00;60;149;161;310
2017;May;19;2017-05-10 00:00;61;145;154;299
2017;May;19;2017-05-10 00:00;62;136;129;265
2017;May;19;2017-05-10 00:00;63;133;140;273
2017;May;19;2017-05-10 00:00;64;146;141;287
2017;May;19;2017-05-10 00:00;65;140;161;301
2017;May;19;2017-05-10 00:00;66;145;139;284
2017;May;19;2017-05-10 00:00;67;145;156;301
2017;May;19;2017-05-10 00:00;68;155;164;319
2017;May;19;2017-05-10 00:00;69;174;167;341
2017;May;19;2017-05-10 00:00;70;164;161;325
2017;May;19;2017-05-10 00:00;71;185;153;338
2017;May;19;2017-05-10 00:00;72;188;178;366
2017;May;19;2017-05-10 00:00;73;155;163;318
2017;May;19;2017-05-10 00:00;74;156;170;326
2017;May;19;2017-05-10 00:00;75;141;138;279
2017;May;19;2017-05-10 00:00;76;115;108;223
2017;May;19;2017-05-10 00:00;77;85;127;212
2017;May;19;2017-05-10 00:00;78;89;95;184
2017;May;19;2017-05-10 00:00;79;98;80;178
2017;May;19;2017-05-10 00:00;80;80;78;158
2017;May;19;2017-05-10 00:00;81;91;70;161
2017;May;19;2017-05-10 00:00;82;66;66;132
2017;May;19;2017-05-10 00:00;83;74;48;122
2017;May;19;2017-05-10 00:00;84;58;50;108
2017;May;19;2017-05-10 00:00;85;34;40;74
2017;May;19;2017-05-10 00:00;86;49;31;80
2017;May;19;2017-05-10 00:00;87;48;30;78
2017;May;19;2017-05-10 00:00;88;37;25;62
2017;May;19;2017-05-10 00:00;89;32;21;53
2017;May;19;2017-05-10 00:00;90;32;13;45
2017;May;19;2017-05-10 00:00;91;25;11;36
2017;May;19;2017-05-10 00:00;92;21;8;29
2017;May;19;2017-05-10 00:00;93;12;9;21
2017;May;19;2017-05-10 00:00;94;11;9;20
2017;May;19;2017-05-10 00:00;95;15;3;18
2017;May;19;2017-05-10 00:00;96;6;4;10
2017;May;19;2017-05-10 00:00;97;4;3;7
2017;May;19;2017-05-10 00:00;98;0;1;1
2017;May;19;2017-05-10 00:00;99;2;2;4
2017;May;19;2017-05-10 00:00;100;1;1;2
2017;May;19;2017-05-10 00:00;105;1;0;1
2017;May;20;2017-05-17 00:00;0;67;69;136
2017;May;20;2017-05-17 00:00;1;164;187;351
2017;May;20;2017-05-17 00:00;2;174;197;371
2017;May;20;2017-05-17 00:00;3;176;209;385
2017;May;20;2017-05-17 00:00;4;198;214;412
2017;May;20;2017-05-17 00:00;5;192;193;385
2017;May;20;2017-05-17 00:00;6;210;230;440
2017;May;20;2017-05-17 00:00;7;213;231;444
2017;May;20;2017-05-17 00:00;8;200;212;412
2017;May;20;2017-05-17 00:00;9;194;192;386
2017;May;20;2017-05-17 00:00;10;182;200;382
2017;May;20;2017-05-17 00:00;11;225;200;425
2017;May;20;2017-05-17 00:00;12;185;204;389
2017;May;20;2017-05-17 00:00;13;185;200;385
2017;May;20;2017-05-17 00:00;14;178;186;364
2017;May;20;2017-05-17 00:00;15;174;218;392
2017;May;20;2017-05-17 00:00;16;143;184;327
2017;May;20;2017-05-17 00:00;17;183;206;389
2017;May;20;2017-05-17 00:00;18;184;189;373
2017;May;20;2017-05-17 00:00;19;161;177;338
2017;May;20;2017-05-17 00:00;20;163;192;355
2017;May;20;2017-05-17 00:00;21;160;172;332
2017;May;20;2017-05-17 00:00;22;147;180;327
2017;May;20;2017-05-17 00:00;23;159;174;333
2017;May;20;2017-05-17 00:00;24;174;195;369
2017;May;20;2017-05-17 00:00;25;173;195;368
2017;May;20;2017-05-17 00:00;26;162;224;386
2017;May;20;2017-05-17 00:00;27;189;198;387
2017;May;20;2017-05-17 00:00;28;149;181;330
2017;May;20;2017-05-17 00:00;29;166;187;353
2017;May;20;2017-05-17 00:00;30;173;185;358
2017;May;20;2017-05-17 00:00;31;157;180;337
2017;May;20;2017-05-17 00:00;32;173;186;359
2017;May;20;2017-05-17 00:00;33;179;174;353
2017;May;20;2017-05-17 00:00;34;210;170;380
2017;May;20;2017-05-17 00:00;35;198;184;382
2017;May;20;2017-05-17 00:00;36;160;175;335
2017;May;20;2017-05-17 00:00;37;228;188;416
2017;May;20;2017-05-17 00:00;38;206;167;373
2017;May;20;2017-05-17 00:00;39;185;204;389
2017;May;20;2017-05-17 00:00;40;182;201;383
2017;May;20;2017-05-17 00:00;41;214;218;432
2017;May;20;2017-05-17 00:00;42;222;241;463
2017;May;20;2017-05-17 00:00;43;226;270;496
2017;May;20;2017-05-17 00:00;44;205;217;422
2017;May;20;2017-05-17 00:00;45;226;249;475
2017;May;20;2017-05-17 00:00;46;210;217;427
2017;May;20;2017-05-17 00:00;47;214;222;436
2017;May;20;2017-05-17 00:00;48;208;201;409
2017;May;20;2017-05-17 00:00;49;216;223;439
2017;May;20;2017-05-17 00:00;50;242;229;471
2017;May;20;2017-05-17 00:00;51;189;225;414
2017;May;20;2017-05-17 00:00;52;198;218;416
2017;May;20;2017-05-17 00:00;53;190;221;411
2017;May;20;2017-05-17 00:00;54;183;216;399
2017;May;20;2017-05-17 00:00;55;186;188;374
2017;May;20;2017-05-17 00:00;56;154;163;317
2017;May;20;2017-05-17 00:00;57;155;152;307
2017;May;20;2017-05-17 00:00;58;157;170;327
2017;May;20;2017-05-17 00:00;59;156;157;313
2017;May;20;2017-05-17 00:00;60;149;161;310
2017;May;20;2017-05-17 00:00;61;145;154;299
2017;May;20;2017-05-17 00:00;62;136;129;265
2017;May;20;2017-05-17 00:00;63;133;140;273
2017;May;20;2017-05-17 00:00;64;146;141;287
2017;May;20;2017-05-17 00:00;65;140;161;301
2017;May;20;2017-05-17 00:00;66;145;139;284
2017;May;20;2017-05-17 00:00;67;145;156;301
2017;May;20;2017-05-17 00:00;68;153;163;316
2017;May;20;2017-05-17 00:00;69;175;167;342
2017;May;20;2017-05-17 00:00;70;164;161;325
2017;May;20;2017-05-17 00:00;71;185;153;338
2017;May;20;2017-05-17 00:00;72;188;177;365
2017;May;20;2017-05-17 00:00;73;155;163;318
2017;May;20;2017-05-17 00:00;74;156;169;325
2017;May;20;2017-05-17 00:00;75;141;138;279
2017;May;20;2017-05-17 00:00;76;115;108;223
2017;May;20;2017-05-17 00:00;77;85;127;212
2017;May;20;2017-05-17 00:00;78;88;95;183
2017;May;20;2017-05-17 00:00;79;98;80;178
2017;May;20;2017-05-17 00:00;80;80;78;158
2017;May;20;2017-05-17 00:00;81;91;69;160
2017;May;20;2017-05-17 00:00;82;66;66;132
2017;May;20;2017-05-17 00:00;83;74;48;122
2017;May;20;2017-05-17 00:00;84;58;50;108
2017;May;20;2017-05-17 00:00;85;34;40;74
2017;May;20;2017-05-17 00:00;86;48;31;79
2017;May;20;2017-05-17 00:00;87;48;30;78
2017;May;20;2017-05-17 00:00;88;37;25;62
2017;May;20;2017-05-17 00:00;89;32;21;53
2017;May;20;2017-05-17 00:00;90;32;13;45
2017;May;20;2017-05-17 00:00;91;25;11;36
2017;May;20;2017-05-17 00:00;92;21;8;29
2017;May;20;2017-05-17 00:00;93;12;9;21
2017;May;20;2017-05-17 00:00;94;11;9;20
2017;May;20;2017-05-17 00:00;95;15;3;18
2017;May;20;2017-05-17 00:00;96;6;4;10
2017;May;20;2017-05-17 00:00;97;4;3;7
2017;May;20;2017-05-17 00:00;98;0;1;1
2017;May;20;2017-05-17 00:00;99;2;2;4
2017;May;20;2017-05-17 00:00;100;1;1;2
2017;May;20;2017-05-17 00:00;105;1;0;1
2017;May;21;2017-05-24 00:00;0;71;70;141
2017;May;21;2017-05-24 00:00;1;164;186;350
2017;May;21;2017-05-24 00:00;2;175;197;372
2017;May;21;2017-05-24 00:00;3;176;209;385
2017;May;21;2017-05-24 00:00;4;199;214;413
2017;May;21;2017-05-24 00:00;5;192;193;385
2017;May;21;2017-05-24 00:00;6;210;230;440
2017;May;21;2017-05-24 00:00;7;214;231;445
2017;May;21;2017-05-24 00:00;8;200;211;411
2017;May;21;2017-05-24 00:00;9;194;193;387
2017;May;21;2017-05-24 00:00;10;182;200;382
2017;May;21;2017-05-24 00:00;11;225;200;425
2017;May;21;2017-05-24 00:00;12;185;205;390
2017;May;21;2017-05-24 00:00;13;185;200;385
2017;May;21;2017-05-24 00:00;14;178;186;364
2017;May;21;2017-05-24 00:00;15;174;219;393
2017;May;21;2017-05-24 00:00;16;142;184;326
2017;May;21;2017-05-24 00:00;17;183;206;389
2017;May;21;2017-05-24 00:00;18;184;189;373
2017;May;21;2017-05-24 00:00;19;161;177;338
2017;May;21;2017-05-24 00:00;20;163;192;355
2017;May;21;2017-05-24 00:00;21;161;172;333
2017;May;21;2017-05-24 00:00;22;148;182;330
2017;May;21;2017-05-24 00:00;23;159;174;333
2017;May;21;2017-05-24 00:00;24;175;194;369
2017;May;21;2017-05-24 00:00;25;173;194;367
2017;May;21;2017-05-24 00:00;26;163;223;386
2017;May;21;2017-05-24 00:00;27;189;198;387
2017;May;21;2017-05-24 00:00;28;150;180;330
2017;May;21;2017-05-24 00:00;29;167;188;355
2017;May;21;2017-05-24 00:00;30;173;185;358
2017;May;21;2017-05-24 00:00;31;158;180;338
2017;May;21;2017-05-24 00:00;32;173;185;358
2017;May;21;2017-05-24 00:00;33;179;174;353
2017;May;21;2017-05-24 00:00;34;209;173;382
2017;May;21;2017-05-24 00:00;35;198;185;383
2017;May;21;2017-05-24 00:00;36;160;174;334
2017;May;21;2017-05-24 00:00;37;228;188;416
2017;May;21;2017-05-24 00:00;38;205;167;372
2017;May;21;2017-05-24 00:00;39;185;203;388
2017;May;21;2017-05-24 00:00;40;182;201;383
2017;May;21;2017-05-24 00:00;41;214;218;432
2017;May;21;2017-05-24 00:00;42;222;240;462
2017;May;21;2017-05-24 00:00;43;226;270;496
2017;May;21;2017-05-24 00:00;44;205;217;422
2017;May;21;2017-05-24 00:00;45;226;249;475
2017;May;21;2017-05-24 00:00;46;210;216;426
2017;May;21;2017-05-24 00:00;47;214;222;436
2017;May;21;2017-05-24 00:00;48;207;201;408
2017;May;21;2017-05-24 00:00;49;216;223;439
2017;May;21;2017-05-24 00:00;50;242;228;470
2017;May;21;2017-05-24 00:00;51;189;225;414
2017;May;21;2017-05-24 00:00;52;198;219;417
2017;May;21;2017-05-24 00:00;53;190;221;411
2017;May;21;2017-05-24 00:00;54;182;216;398
2017;May;21;2017-05-24 00:00;55;187;188;375
2017;May;21;2017-05-24 00:00;56;154;165;319
2017;May;21;2017-05-24 00:00;57;156;152;308
2017;May;21;2017-05-24 00:00;58;157;170;327
2017;May;21;2017-05-24 00:00;59;156;157;313
2017;May;21;2017-05-24 00:00;60;149;160;309
2017;May;21;2017-05-24 00:00;61;145;154;299
2017;May;21;2017-05-24 00:00;62;136;128;264
2017;May;21;2017-05-24 00:00;63;133;140;273
2017;May;21;2017-05-24 00:00;64;146;140;286
2017;May;21;2017-05-24 00:00;65;140;161;301
2017;May;21;2017-05-24 00:00;66;145;139;284
2017;May;21;2017-05-24 00:00;67;145;156;301
2017;May;21;2017-05-24 00:00;68;153;162;315
2017;May;21;2017-05-24 00:00;69;175;167;342
2017;May;21;2017-05-24 00:00;70;164;161;325
2017;May;21;2017-05-24 00:00;71;185;153;338
2017;May;21;2017-05-24 00:00;72;188;177;365
2017;May;21;2017-05-24 00:00;73;155;163;318
2017;May;21;2017-05-24 00:00;74;156;169;325
2017;May;21;2017-05-24 00:00;75;141;138;279
2017;May;21;2017-05-24 00:00;76;115;108;223
2017;May;21;2017-05-24 00:00;77;85;127;212
2017;May;21;2017-05-24 00:00;78;87;95;182
2017;May;21;2017-05-24 00:00;79;98;80;178
2017;May;21;2017-05-24 00:00;80;80;78;158
2017;May;21;2017-05-24 00:00;81;91;69;160
2017;May;21;2017-05-24 00:00;82;65;66;131
2017;May;21;2017-05-24 00:00;83;74;48;122
2017;May;21;2017-05-24 00:00;84;58;50;108
2017;May;21;2017-05-24 00:00;85;34;40;74
2017;May;21;2017-05-24 00:00;86;48;31;79
2017;May;21;2017-05-24 00:00;87;48;30;78
2017;May;21;2017-05-24 00:00;88;37;25;62
2017;May;21;2017-05-24 00:00;89;32;21;53
2017;May;21;2017-05-24 00:00;90;32;13;45
2017;May;21;2017-05-24 00:00;91;25;11;36
2017;May;21;2017-05-24 00:00;92;21;8;29
2017;May;21;2017-05-24 00:00;93;12;9;21
2017;May;21;2017-05-24 00:00;94;11;9;20
2017;May;21;2017-05-24 00:00;95;15;3;18
2017;May;21;2017-05-24 00:00;96;6;4;10
2017;May;21;2017-05-24 00:00;97;4;3;7
2017;May;21;2017-05-24 00:00;98;0;1;1
2017;May;21;2017-05-24 00:00;99;2;2;4
2017;May;21;2017-05-24 00:00;100;1;1;2
2017;May;21;2017-05-24 00:00;105;1;0;1
2017;May;22;2017-05-31 00:00;0;72;75;147
2017;May;22;2017-05-31 00:00;1;162;186;348
2017;May;22;2017-05-31 00:00;2;175;197;372
2017;May;22;2017-05-31 00:00;3;177;209;386
2017;May;22;2017-05-31 00:00;4;199;214;413
2017;May;22;2017-05-31 00:00;5;191;194;385
2017;May;22;2017-05-31 00:00;6;210;230;440
2017;May;22;2017-05-31 00:00;7;214;231;445
2017;May;22;2017-05-31 00:00;8;200;211;411
2017;May;22;2017-05-31 00:00;9;195;193;388
2017;May;22;2017-05-31 00:00;10;181;201;382
2017;May;22;2017-05-31 00:00;11;225;200;425
2017;May;22;2017-05-31 00:00;12;184;205;389
2017;May;22;2017-05-31 00:00;13;185;200;385
2017;May;22;2017-05-31 00:00;14;178;186;364
2017;May;22;2017-05-31 00:00;15;174;219;393
2017;May;22;2017-05-31 00:00;16;141;184;325
2017;May;22;2017-05-31 00:00;17;183;206;389
2017;May;22;2017-05-31 00:00;18;183;189;372
2017;May;22;2017-05-31 00:00;19;162;177;339
2017;May;22;2017-05-31 00:00;20;163;192;355
2017;May;22;2017-05-31 00:00;21;160;171;331
2017;May;22;2017-05-31 00:00;22;148;181;329
2017;May;22;2017-05-31 00:00;23;157;174;331
2017;May;22;2017-05-31 00:00;24;175;194;369
2017;May;22;2017-05-31 00:00;25;173;196;369
2017;May;22;2017-05-31 00:00;26;163;222;385
2017;May;22;2017-05-31 00:00;27;191;200;391
2017;May;22;2017-05-31 00:00;28;150;179;329
2017;May;22;2017-05-31 00:00;29;168;188;356
2017;May;22;2017-05-31 00:00;30;173;184;357
2017;May;22;2017-05-31 00:00;31;158;182;340
2017;May;22;2017-05-31 00:00;32;174;186;360
2017;May;22;2017-05-31 00:00;33;179;174;353
2017;May;22;2017-05-31 00:00;34;211;173;384
2017;May;22;2017-05-31 00:00;35;198;186;384
2017;May;22;2017-05-31 00:00;36;160;174;334
2017;May;22;2017-05-31 00:00;37;228;188;416
2017;May;22;2017-05-31 00:00;38;205;167;372
2017;May;22;2017-05-31 00:00;39;185;203;388
2017;May;22;2017-05-31 00:00;40;182;201;383
2017;May;22;2017-05-31 00:00;41;214;218;432
2017;May;22;2017-05-31 00:00;42;222;240;462
2017;May;22;2017-05-31 00:00;43;226;270;496
2017;May;22;2017-05-31 00:00;44;205;217;422
2017;May;22;2017-05-31 00:00;45;226;249;475
2017;May;22;2017-05-31 00:00;46;210;216;426
2017;May;22;2017-05-31 00:00;47;213;222;435
2017;May;22;2017-05-31 00:00;48;206;202;408
2017;May;22;2017-05-31 00:00;49;215;221;436
2017;May;22;2017-05-31 00:00;50;242;228;470
2017;May;22;2017-05-31 00:00;51;189;225;414
2017;May;22;2017-05-31 00:00;52;198;219;417
2017;May;22;2017-05-31 00:00;53;190;220;410
2017;May;22;2017-05-31 00:00;54;182;216;398
2017;May;22;2017-05-31 00:00;55;187;189;376
2017;May;22;2017-05-31 00:00;56;154;165;319
2017;May;22;2017-05-31 00:00;57;155;152;307
2017;May;22;2017-05-31 00:00;58;158;170;328
2017;May;22;2017-05-31 00:00;59;156;157;313
2017;May;22;2017-05-31 00:00;60;149;160;309
2017;May;22;2017-05-31 00:00;61;145;154;299
2017;May;22;2017-05-31 00:00;62;136;128;264
2017;May;22;2017-05-31 00:00;63;133;139;272
2017;May;22;2017-05-31 00:00;64;146;140;286
2017;May;22;2017-05-31 00:00;65;139;161;300
2017;May;22;2017-05-31 00:00;66;145;139;284
2017;May;22;2017-05-31 00:00;67;145;156;301
2017;May;22;2017-05-31 00:00;68;152;162;314
2017;May;22;2017-05-31 00:00;69;175;167;342
2017;May;22;2017-05-31 00:00;70;164;161;325
2017;May;22;2017-05-31 00:00;71;185;153;338
2017;May;22;2017-05-31 00:00;72;188;176;364
2017;May;22;2017-05-31 00:00;73;155;163;318
2017;May;22;2017-05-31 00:00;74;156;169;325
2017;May;22;2017-05-31 00:00;75;141;138;279
2017;May;22;2017-05-31 00:00;76;115;108;223
2017;May;22;2017-05-31 00:00;77;85;127;212
2017;May;22;2017-05-31 00:00;78;87;94;181
2017;May;22;2017-05-31 00:00;79;98;80;178
2017;May;22;2017-05-31 00:00;80;80;77;157
2017;May;22;2017-05-31 00:00;81;91;69;160
2017;May;22;2017-05-31 00:00;82;65;66;131
2017;May;22;2017-05-31 00:00;83;74;48;122
2017;May;22;2017-05-31 00:00;84;58;50;108
2017;May;22;2017-05-31 00:00;85;34;40;74
2017;May;22;2017-05-31 00:00;86;48;31;79
2017;May;22;2017-05-31 00:00;87;48;29;77
2017;May;22;2017-05-31 00:00;88;37;25;62
2017;May;22;2017-05-31 00:00;89;32;21;53
2017;May;22;2017-05-31 00:00;90;31;13;44
2017;May;22;2017-05-31 00:00;91;25;11;36
2017;May;22;2017-05-31 00:00;92;20;8;28
2017;May;22;2017-05-31 00:00;93;12;9;21
2017;May;22;2017-05-31 00:00;94;11;9;20
2017;May;22;2017-05-31 00:00;95;15;3;18
2017;May;22;2017-05-31 00:00;96;6;4;10
2017;May;22;2017-05-31 00:00;97;4;3;7
2017;May;22;2017-05-31 00:00;98;0;1;1
2017;May;22;2017-05-31 00:00;99;2;2;4
2017;May;22;2017-05-31 00:00;100;1;1;2
2017;May;22;2017-05-31 00:00;105;1;0;1
2017;June;23;2017-06-07 00:00;0;77;78;155
2017;June;23;2017-06-07 00:00;1;162;187;349
2017;June;23;2017-06-07 00:00;2;177;197;374
2017;June;23;2017-06-07 00:00;3;177;210;387
2017;June;23;2017-06-07 00:00;4;199;214;413
2017;June;23;2017-06-07 00:00;5;191;193;384
2017;June;23;2017-06-07 00:00;6;210;230;440
2017;June;23;2017-06-07 00:00;7;214;231;445
2017;June;23;2017-06-07 00:00;8;201;211;412
2017;June;23;2017-06-07 00:00;9;195;193;388
2017;June;23;2017-06-07 00:00;10;181;201;382
2017;June;23;2017-06-07 00:00;11;224;199;423
2017;June;23;2017-06-07 00:00;12;184;206;390
2017;June;23;2017-06-07 00:00;13;185;200;385
2017;June;23;2017-06-07 00:00;14;177;186;363
2017;June;23;2017-06-07 00:00;15;173;219;392
2017;June;23;2017-06-07 00:00;16;142;183;325
2017;June;23;2017-06-07 00:00;17;181;205;386
2017;June;23;2017-06-07 00:00;18;183;189;372
2017;June;23;2017-06-07 00:00;19;161;177;338
2017;June;23;2017-06-07 00:00;20;164;192;356
2017;June;23;2017-06-07 00:00;21;161;171;332
2017;June;23;2017-06-07 00:00;22;148;180;328
2017;June;23;2017-06-07 00:00;23;156;172;328
2017;June;23;2017-06-07 00:00;24;176;194;370
2017;June;23;2017-06-07 00:00;25;174;194;368
2017;June;23;2017-06-07 00:00;26;164;222;386
2017;June;23;2017-06-07 00:00;27;192;198;390
2017;June;23;2017-06-07 00:00;28;150;179;329
2017;June;23;2017-06-07 00:00;29;166;187;353
2017;June;23;2017-06-07 00:00;30;173;184;357
2017;June;23;2017-06-07 00:00;31;158;182;340
2017;June;23;2017-06-07 00:00;32;174;188;362
2017;June;23;2017-06-07 00:00;33;179;174;353
2017;June;23;2017-06-07 00:00;34;211;173;384
2017;June;23;2017-06-07 00:00;35;200;186;386
2017;June;23;2017-06-07 00:00;36;162;174;336
2017;June;23;2017-06-07 00:00;37;228;189;417
2017;June;23;2017-06-07 00:00;38;205;169;374
2017;June;23;2017-06-07 00:00;39;185;203;388
2017;June;23;2017-06-07 00:00;40;183;201;384
2017;June;23;2017-06-07 00:00;41;214;217;431
2017;June;23;2017-06-07 00:00;42;222;240;462
2017;June;23;2017-06-07 00:00;43;226;271;497
2017;June;23;2017-06-07 00:00;44;205;218;423
2017;June;23;2017-06-07 00:00;45;226;249;475
2017;June;23;2017-06-07 00:00;46;210;215;425
2017;June;23;2017-06-07 00:00;47;214;223;437
2017;June;23;2017-06-07 00:00;48;205;202;407
2017;June;23;2017-06-07 00:00;49;214;221;435
2017;June;23;2017-06-07 00:00;50;242;228;470
2017;June;23;2017-06-07 00:00;51;189;224;413
2017;June;23;2017-06-07 00:00;52;196;219;415
2017;June;23;2017-06-07 00:00;53;190;220;410
2017;June;23;2017-06-07 00:00;54;181;216;397
2017;June;23;2017-06-07 00:00;55;187;187;374
2017;June;23;2017-06-07 00:00;56;154;166;320
2017;June;23;2017-06-07 00:00;57;154;152;306
2017;June;23;2017-06-07 00:00;58;158;170;328
2017;June;23;2017-06-07 00:00;59;156;157;313
2017;June;23;2017-06-07 00:00;60;149;160;309
2017;June;23;2017-06-07 00:00;61;145;154;299
2017;June;23;2017-06-07 00:00;62;136;128;264
2017;June;23;2017-06-07 00:00;63;133;139;272
2017;June;23;2017-06-07 00:00;64;146;140;286
2017;June;23;2017-06-07 00:00;65;139;160;299
2017;June;23;2017-06-07 00:00;66;145;139;284
2017;June;23;2017-06-07 00:00;67;146;156;302
2017;June;23;2017-06-07 00:00;68;152;162;314
2017;June;23;2017-06-07 00:00;69;176;167;343
2017;June;23;2017-06-07 00:00;70;164;161;325
2017;June;23;2017-06-07 00:00;71;185;152;337
2017;June;23;2017-06-07 00:00;72;187;176;363
2017;June;23;2017-06-07 00:00;73;155;163;318
2017;June;23;2017-06-07 00:00;74;156;169;325
2017;June;23;2017-06-07 00:00;75;141;138;279
2017;June;23;2017-06-07 00:00;76;114;107;221
2017;June;23;2017-06-07 00:00;77;84;127;211
2017;June;23;2017-06-07 00:00;78;87;94;181
2017;June;23;2017-06-07 00:00;79;98;80;178
2017;June;23;2017-06-07 00:00;80;80;77;157
2017;June;23;2017-06-07 00:00;81;91;68;159
2017;June;23;2017-06-07 00:00;82;65;66;131
2017;June;23;2017-06-07 00:00;83;74;48;122
2017;June;23;2017-06-07 00:00;84;58;50;108
2017;June;23;2017-06-07 00:00;85;34;40;74
2017;June;23;2017-06-07 00:00;86;48;31;79
2017;June;23;2017-06-07 00:00;87;48;29;77
2017;June;23;2017-06-07 00:00;88;37;25;62
2017;June;23;2017-06-07 00:00;89;32;21;53
2017;June;23;2017-06-07 00:00;90;31;13;44
2017;June;23;2017-06-07 00:00;91;25;11;36
2017;June;23;2017-06-07 00:00;92;20;8;28
2017;June;23;2017-06-07 00:00;93;12;9;21
2017;June;23;2017-06-07 00:00;94;11;9;20
2017;June;23;2017-06-07 00:00;95;15;3;18
2017;June;23;2017-06-07 00:00;96;6;4;10
2017;June;23;2017-06-07 00:00;97;4;3;7
2017;June;23;2017-06-07 00:00;98;0;1;1
2017;June;23;2017-06-07 00:00;99;2;2;4
2017;June;23;2017-06-07 00:00;100;1;1;2
2017;June;23;2017-06-07 00:00;105;1;0;1
2017;June;24;2017-06-14 00:00;0;77;78;155
2017;June;24;2017-06-14 00:00;1;163;187;350
2017;June;24;2017-06-14 00:00;2;177;198;375
2017;June;24;2017-06-14 00:00;3;178;211;389
2017;June;24;2017-06-14 00:00;4;199;214;413
2017;June;24;2017-06-14 00:00;5;191;193;384
2017;June;24;2017-06-14 00:00;6;212;230;442
2017;June;24;2017-06-14 00:00;7;215;231;446
2017;June;24;2017-06-14 00:00;8;201;211;412
2017;June;24;2017-06-14 00:00;9;195;195;390
2017;June;24;2017-06-14 00:00;10;182;201;383
2017;June;24;2017-06-14 00:00;11;224;199;423
2017;June;24;2017-06-14 00:00;12;184;207;391
2017;June;24;2017-06-14 00:00;13;185;200;385
2017;June;24;2017-06-14 00:00;14;177;186;363
2017;June;24;2017-06-14 00:00;15;173;219;392
2017;June;24;2017-06-14 00:00;16;142;182;324
2017;June;24;2017-06-14 00:00;17;180;204;384
2017;June;24;2017-06-14 00:00;18;183;189;372
2017;June;24;2017-06-14 00:00;19;160;177;337
2017;June;24;2017-06-14 00:00;20;164;192;356
2017;June;24;2017-06-14 00:00;21;162;171;333
2017;June;24;2017-06-14 00:00;22;149;180;329
2017;June;24;2017-06-14 00:00;23;155;174;329
2017;June;24;2017-06-14 00:00;24;176;194;370
2017;June;24;2017-06-14 00:00;25;175;194;369
2017;June;24;2017-06-14 00:00;26;162;222;384
2017;June;24;2017-06-14 00:00;27;193;198;391
2017;June;24;2017-06-14 00:00;28;151;178;329
2017;June;24;2017-06-14 00:00;29;166;187;353
2017;June;24;2017-06-14 00:00;30;175;184;359
2017;June;24;2017-06-14 00:00;31;158;181;339
2017;June;24;2017-06-14 00:00;32;175;191;366
2017;June;24;2017-06-14 00:00;33;181;174;355
2017;June;24;2017-06-14 00:00;34;210;173;383
2017;June;24;2017-06-14 00:00;35;200;185;385
2017;June;24;2017-06-14 00:00;36;162;174;336
2017;June;24;2017-06-14 00:00;37;228;190;418
2017;June;24;2017-06-14 00:00;38;206;170;376
2017;June;24;2017-06-14 00:00;39;186;202;388
2017;June;24;2017-06-14 00:00;40;183;202;385
2017;June;24;2017-06-14 00:00;41;214;217;431
2017;June;24;2017-06-14 00:00;42;221;240;461
2017;June;24;2017-06-14 00:00;43;226;271;497
2017;June;24;2017-06-14 00:00;44;207;218;425
2017;June;24;2017-06-14 00:00;45;226;249;475
2017;June;24;2017-06-14 00:00;46;210;216;426
2017;June;24;2017-06-14 00:00;47;213;223;436
2017;June;24;2017-06-14 00:00;48;205;201;406
2017;June;24;2017-06-14 00:00;49;214;222;436
2017;June;24;2017-06-14 00:00;50;242;227;469
2017;June;24;2017-06-14 00:00;51;189;223;412
2017;June;24;2017-06-14 00:00;52;196;219;415
2017;June;24;2017-06-14 00:00;53;190;220;410
2017;June;24;2017-06-14 00:00;54;181;215;396
2017;June;24;2017-06-14 00:00;55;187;187;374
2017;June;24;2017-06-14 00:00;56;154;166;320
2017;June;24;2017-06-14 00:00;57;154;152;306
2017;June;24;2017-06-14 00:00;58;158;170;328
2017;June;24;2017-06-14 00:00;59;156;157;313
2017;June;24;2017-06-14 00:00;60;149;160;309
2017;June;24;2017-06-14 00:00;61;145;154;299
2017;June;24;2017-06-14 00:00;62;136;128;264
2017;June;24;2017-06-14 00:00;63;133;139;272
2017;June;24;2017-06-14 00:00;64;146;140;286
2017;June;24;2017-06-14 00:00;65;140;160;300
2017;June;24;2017-06-14 00:00;66;145;139;284
2017;June;24;2017-06-14 00:00;67;146;156;302
2017;June;24;2017-06-14 00:00;68;152;162;314
2017;June;24;2017-06-14 00:00;69;176;167;343
2017;June;24;2017-06-14 00:00;70;164;161;325
2017;June;24;2017-06-14 00:00;71;185;152;337
2017;June;24;2017-06-14 00:00;72;187;176;363
2017;June;24;2017-06-14 00:00;73;155;163;318
2017;June;24;2017-06-14 00:00;74;156;169;325
2017;June;24;2017-06-14 00:00;75;141;138;279
2017;June;24;2017-06-14 00:00;76;114;107;221
2017;June;24;2017-06-14 00:00;77;84;127;211
2017;June;24;2017-06-14 00:00;78;87;93;180
2017;June;24;2017-06-14 00:00;79;98;80;178
2017;June;24;2017-06-14 00:00;80;80;76;156
2017;June;24;2017-06-14 00:00;81;91;68;159
2017;June;24;2017-06-14 00:00;82;65;66;131
2017;June;24;2017-06-14 00:00;83;75;47;122
2017;June;24;2017-06-14 00:00;84;58;50;108
2017;June;24;2017-06-14 00:00;85;34;40;74
2017;June;24;2017-06-14 00:00;86;48;31;79
2017;June;24;2017-06-14 00:00;87;48;29;77
2017;June;24;2017-06-14 00:00;88;36;25;61
2017;June;24;2017-06-14 00:00;89;32;20;52
2017;June;24;2017-06-14 00:00;90;31;13;44
2017;June;24;2017-06-14 00:00;91;25;11;36
2017;June;24;2017-06-14 00:00;92;20;8;28
2017;June;24;2017-06-14 00:00;93;12;9;21
2017;June;24;2017-06-14 00:00;94;11;9;20
2017;June;24;2017-06-14 00:00;95;15;3;18
2017;June;24;2017-06-14 00:00;96;6;4;10
2017;June;24;2017-06-14 00:00;97;4;3;7
2017;June;24;2017-06-14 00:00;98;0;1;1
2017;June;24;2017-06-14 00:00;99;2;2;4
2017;June;24;2017-06-14 00:00;100;1;1;2
2017;June;24;2017-06-14 00:00;105;1;0;1
2017;June;25;2017-06-21 00:00;0;79;79;158
2017;June;25;2017-06-21 00:00;1;164;189;353
2017;June;25;2017-06-21 00:00;2;177;197;374
2017;June;25;2017-06-21 00:00;3;178;213;391
2017;June;25;2017-06-21 00:00;4;199;214;413
2017;June;25;2017-06-21 00:00;5;191;193;384
2017;June;25;2017-06-21 00:00;6;215;230;445
2017;June;25;2017-06-21 00:00;7;216;231;447
2017;June;25;2017-06-21 00:00;8;201;211;412
2017;June;25;2017-06-21 00:00;9;195;196;391
2017;June;25;2017-06-21 00:00;10;182;201;383
2017;June;25;2017-06-21 00:00;11;224;199;423
2017;June;25;2017-06-21 00:00;12;184;207;391
2017;June;25;2017-06-21 00:00;13;185;200;385
2017;June;25;2017-06-21 00:00;14;177;186;363
2017;June;25;2017-06-21 00:00;15;173;219;392
2017;June;25;2017-06-21 00:00;16;142;182;324
2017;June;25;2017-06-21 00:00;17;180;204;384
2017;June;25;2017-06-21 00:00;18;182;189;371
2017;June;25;2017-06-21 00:00;19;162;175;337
2017;June;25;2017-06-21 00:00;20;164;192;356
2017;June;25;2017-06-21 00:00;21;161;172;333
2017;June;25;2017-06-21 00:00;22;151;181;332
2017;June;25;2017-06-21 00:00;23;157;175;332
2017;June;25;2017-06-21 00:00;24;177;193;370
2017;June;25;2017-06-21 00:00;25;177;194;371
2017;June;25;2017-06-21 00:00;26;160;222;382
2017;June;25;2017-06-21 00:00;27;194;198;392
2017;June;25;2017-06-21 00:00;28;153;179;332
2017;June;25;2017-06-21 00:00;29;167;189;356
2017;June;25;2017-06-21 00:00;30;174;185;359
2017;June;25;2017-06-21 00:00;31;157;180;337
2017;June;25;2017-06-21 00:00;32;175;191;366
2017;June;25;2017-06-21 00:00;33;182;174;356
2017;June;25;2017-06-21 00:00;34;210;174;384
2017;June;25;2017-06-21 00:00;35;201;184;385
2017;June;25;2017-06-21 00:00;36;162;176;338
2017;June;25;2017-06-21 00:00;37;228;193;421
2017;June;25;2017-06-21 00:00;38;206;171;377
2017;June;25;2017-06-21 00:00;39;186;202;388
2017;June;25;2017-06-21 00:00;40;184;202;386
2017;June;25;2017-06-21 00:00;41;214;218;432
2017;June;25;2017-06-21 00:00;42;221;240;461
2017;June;25;2017-06-21 00:00;43;226;271;497
2017;June;25;2017-06-21 00:00;44;208;218;426
2017;June;25;2017-06-21 00:00;45;225;249;474
2017;June;25;2017-06-21 00:00;46;210;215;425
2017;June;25;2017-06-21 00:00;47;213;223;436
2017;June;25;2017-06-21 00:00;48;205;200;405
2017;June;25;2017-06-21 00:00;49;213;222;435
2017;June;25;2017-06-21 00:00;50;242;227;469
2017;June;25;2017-06-21 00:00;51;189;223;412
2017;June;25;2017-06-21 00:00;52;198;219;417
2017;June;25;2017-06-21 00:00;53;189;221;410
2017;June;25;2017-06-21 00:00;54;182;215;397
2017;June;25;2017-06-21 00:00;55;186;188;374
2017;June;25;2017-06-21 00:00;56;154;166;320
2017;June;25;2017-06-21 00:00;57;154;152;306
2017;June;25;2017-06-21 00:00;58;158;170;328
2017;June;25;2017-06-21 00:00;59;156;157;313
2017;June;25;2017-06-21 00:00;60;149;160;309
2017;June;25;2017-06-21 00:00;61;145;154;299
2017;June;25;2017-06-21 00:00;62;136;128;264
2017;June;25;2017-06-21 00:00;63;134;139;273
2017;June;25;2017-06-21 00:00;64;146;140;286
2017;June;25;2017-06-21 00:00;65;141;160;301
2017;June;25;2017-06-21 00:00;66;145;139;284
2017;June;25;2017-06-21 00:00;67;146;156;302
2017;June;25;2017-06-21 00:00;68;152;162;314
2017;June;25;2017-06-21 00:00;69;176;167;343
2017;June;25;2017-06-21 00:00;70;164;161;325
2017;June;25;2017-06-21 00:00;71;185;152;337
2017;June;25;2017-06-21 00:00;72;186;176;362
2017;June;25;2017-06-21 00:00;73;154;163;317
2017;June;25;2017-06-21 00:00;74;156;169;325
2017;June;25;2017-06-21 00:00;75;141;138;279
2017;June;25;2017-06-21 00:00;76;114;107;221
2017;June;25;2017-06-21 00:00;77;84;127;211
2017;June;25;2017-06-21 00:00;78;87;93;180
2017;June;25;2017-06-21 00:00;79;98;80;178
2017;June;25;2017-06-21 00:00;80;80;76;156
2017;June;25;2017-06-21 00:00;81;91;68;159
2017;June;25;2017-06-21 00:00;82;65;65;130
2017;June;25;2017-06-21 00:00;83;75;47;122
2017;June;25;2017-06-21 00:00;84;58;49;107
2017;June;25;2017-06-21 00:00;85;34;40;74
2017;June;25;2017-06-21 00:00;86;48;31;79
2017;June;25;2017-06-21 00:00;87;48;29;77
2017;June;25;2017-06-21 00:00;88;36;25;61
2017;June;25;2017-06-21 00:00;89;32;20;52
2017;June;25;2017-06-21 00:00;90;31;13;44
2017;June;25;2017-06-21 00:00;91;25;11;36
2017;June;25;2017-06-21 00:00;92;20;8;28
2017;June;25;2017-06-21 00:00;93;12;9;21
2017;June;25;2017-06-21 00:00;94;11;9;20
2017;June;25;2017-06-21 00:00;95;15;3;18
2017;June;25;2017-06-21 00:00;96;6;4;10
2017;June;25;2017-06-21 00:00;97;4;3;7
2017;June;25;2017-06-21 00:00;98;0;1;1
2017;June;25;2017-06-21 00:00;99;2;2;4
2017;June;25;2017-06-21 00:00;100;1;1;2
2017;June;25;2017-06-21 00:00;105;1;0;1
2017;June;26;2017-06-28 00:00;0;82;83;165
2017;June;26;2017-06-28 00:00;1;166;189;355
2017;June;26;2017-06-28 00:00;2;177;198;375
2017;June;26;2017-06-28 00:00;3;179;213;392
2017;June;26;2017-06-28 00:00;4;199;214;413
2017;June;26;2017-06-28 00:00;5;191;193;384
2017;June;26;2017-06-28 00:00;6;215;230;445
2017;June;26;2017-06-28 00:00;7;216;231;447
2017;June;26;2017-06-28 00:00;8;201;211;412
2017;June;26;2017-06-28 00:00;9;195;196;391
2017;June;26;2017-06-28 00:00;10;182;201;383
2017;June;26;2017-06-28 00:00;11;223;199;422
2017;June;26;2017-06-28 00:00;12;184;208;392
2017;June;26;2017-06-28 00:00;13;184;200;384
2017;June;26;2017-06-28 00:00;14;178;186;364
2017;June;26;2017-06-28 00:00;15;173;219;392
2017;June;26;2017-06-28 00:00;16;142;182;324
2017;June;26;2017-06-28 00:00;17;180;204;384
2017;June;26;2017-06-28 00:00;18;181;189;370
2017;June;26;2017-06-28 00:00;19;160;175;335
2017;June;26;2017-06-28 00:00;20;164;192;356
2017;June;26;2017-06-28 00:00;21;161;173;334
2017;June;26;2017-06-28 00:00;22;151;182;333
2017;June;26;2017-06-28 00:00;23;156;174;330
2017;June;26;2017-06-28 00:00;24;177;194;371
2017;June;26;2017-06-28 00:00;25;177;194;371
2017;June;26;2017-06-28 00:00;26;159;223;382
2017;June;26;2017-06-28 00:00;27;195;199;394
2017;June;26;2017-06-28 00:00;28;154;179;333
2017;June;26;2017-06-28 00:00;29;167;189;356
2017;June;26;2017-06-28 00:00;30;175;186;361
2017;June;26;2017-06-28 00:00;31;157;179;336
2017;June;26;2017-06-28 00:00;32;175;191;366
2017;June;26;2017-06-28 00:00;33;183;177;360
2017;June;26;2017-06-28 00:00;34;209;174;383
2017;June;26;2017-06-28 00:00;35;201;185;386
2017;June;26;2017-06-28 00:00;36;162;176;338
2017;June;26;2017-06-28 00:00;37;228;193;421
2017;June;26;2017-06-28 00:00;38;206;171;377
2017;June;26;2017-06-28 00:00;39;186;202;388
2017;June;26;2017-06-28 00:00;40;184;202;386
2017;June;26;2017-06-28 00:00;41;215;218;433
2017;June;26;2017-06-28 00:00;42;221;240;461
2017;June;26;2017-06-28 00:00;43;226;271;497
2017;June;26;2017-06-28 00:00;44;208;218;426
2017;June;26;2017-06-28 00:00;45;224;249;473
2017;June;26;2017-06-28 00:00;46;211;214;425
2017;June;26;2017-06-28 00:00;47;213;223;436
2017;June;26;2017-06-28 00:00;48;205;200;405
2017;June;26;2017-06-28 00:00;49;213;221;434
2017;June;26;2017-06-28 00:00;50;242;227;469
2017;June;26;2017-06-28 00:00;51;188;223;411
2017;June;26;2017-06-28 00:00;52;198;219;417
2017;June;26;2017-06-28 00:00;53;189;221;410
2017;June;26;2017-06-28 00:00;54;181;215;396
2017;June;26;2017-06-28 00:00;55;186;188;374
2017;June;26;2017-06-28 00:00;56;154;166;320
2017;June;26;2017-06-28 00:00;57;154;152;306
2017;June;26;2017-06-28 00:00;58;158;170;328
2017;June;26;2017-06-28 00:00;59;156;157;313
2017;June;26;2017-06-28 00:00;60;149;160;309
2017;June;26;2017-06-28 00:00;61;146;154;300
2017;June;26;2017-06-28 00:00;62;136;128;264
2017;June;26;2017-06-28 00:00;63;134;139;273
2017;June;26;2017-06-28 00:00;64;145;139;284
2017;June;26;2017-06-28 00:00;65;141;159;300
2017;June;26;2017-06-28 00:00;66;145;139;284
2017;June;26;2017-06-28 00:00;67;146;156;302
2017;June;26;2017-06-28 00:00;68;152;162;314
2017;June;26;2017-06-28 00:00;69;176;167;343
2017;June;26;2017-06-28 00:00;70;164;160;324
2017;June;26;2017-06-28 00:00;71;185;152;337
2017;June;26;2017-06-28 00:00;72;186;176;362
2017;June;26;2017-06-28 00:00;73;154;163;317
2017;June;26;2017-06-28 00:00;74;156;169;325
2017;June;26;2017-06-28 00:00;75;141;138;279
2017;June;26;2017-06-28 00:00;76;114;107;221
2017;June;26;2017-06-28 00:00;77;84;126;210
2017;June;26;2017-06-28 00:00;78;87;93;180
2017;June;26;2017-06-28 00:00;79;99;80;179
2017;June;26;2017-06-28 00:00;80;80;76;156
2017;June;26;2017-06-28 00:00;81;90;68;158
2017;June;26;2017-06-28 00:00;82;65;64;129
2017;June;26;2017-06-28 00:00;83;75;47;122
2017;June;26;2017-06-28 00:00;84;58;48;106
2017;June;26;2017-06-28 00:00;85;34;40;74
2017;June;26;2017-06-28 00:00;86;48;31;79
2017;June;26;2017-06-28 00:00;87;48;29;77
2017;June;26;2017-06-28 00:00;88;36;25;61
2017;June;26;2017-06-28 00:00;89;32;20;52
2017;June;26;2017-06-28 00:00;90;31;13;44
2017;June;26;2017-06-28 00:00;91;25;11;36
2017;June;26;2017-06-28 00:00;92;20;8;28
2017;June;26;2017-06-28 00:00;93;12;9;21
2017;June;26;2017-06-28 00:00;94;11;9;20
2017;June;26;2017-06-28 00:00;95;15;3;18
2017;June;26;2017-06-28 00:00;96;6;4;10
2017;June;26;2017-06-28 00:00;97;4;3;7
2017;June;26;2017-06-28 00:00;98;0;1;1
2017;June;26;2017-06-28 00:00;99;2;2;4
2017;June;26;2017-06-28 00:00;100;1;1;2
2017;June;26;2017-06-28 00:00;105;1;0;1
2017;July;27;2017-07-05 00:00;0;84;93;177
2017;July;27;2017-07-05 00:00;1;165;190;355
2017;July;27;2017-07-05 00:00;2;177;198;375
2017;July;27;2017-07-05 00:00;3;179;214;393
2017;July;27;2017-07-05 00:00;4;199;214;413
2017;July;27;2017-07-05 00:00;5;191;194;385
2017;July;27;2017-07-05 00:00;6;215;230;445
2017;July;27;2017-07-05 00:00;7;215;231;446
2017;July;27;2017-07-05 00:00;8;201;211;412
2017;July;27;2017-07-05 00:00;9;195;196;391
2017;July;27;2017-07-05 00:00;10;183;201;384
2017;July;27;2017-07-05 00:00;11;224;199;423
2017;July;27;2017-07-05 00:00;12;184;208;392
2017;July;27;2017-07-05 00:00;13;184;200;384
2017;July;27;2017-07-05 00:00;14;178;186;364
2017;July;27;2017-07-05 00:00;15;174;219;393
2017;July;27;2017-07-05 00:00;16;143;182;325
2017;July;27;2017-07-05 00:00;17;180;203;383
2017;July;27;2017-07-05 00:00;18;180;188;368
2017;July;27;2017-07-05 00:00;19;160;176;336
2017;July;27;2017-07-05 00:00;20;164;193;357
2017;July;27;2017-07-05 00:00;21;161;172;333
2017;July;27;2017-07-05 00:00;22;150;183;333
2017;July;27;2017-07-05 00:00;23;156;175;331
2017;July;27;2017-07-05 00:00;24;178;192;370
2017;July;27;2017-07-05 00:00;25;175;194;369
2017;July;27;2017-07-05 00:00;26;160;222;382
2017;July;27;2017-07-05 00:00;27;196;198;394
2017;July;27;2017-07-05 00:00;28;153;178;331
2017;July;27;2017-07-05 00:00;29;167;187;354
2017;July;27;2017-07-05 00:00;30;175;185;360
2017;July;27;2017-07-05 00:00;31;157;180;337
2017;July;27;2017-07-05 00:00;32;176;190;366
2017;July;27;2017-07-05 00:00;33;184;177;361
2017;July;27;2017-07-05 00:00;34;210;173;383
2017;July;27;2017-07-05 00:00;35;201;187;388
2017;July;27;2017-07-05 00:00;36;163;176;339
2017;July;27;2017-07-05 00:00;37;228;193;421
2017;July;27;2017-07-05 00:00;38;206;171;377
2017;July;27;2017-07-05 00:00;39;186;202;388
2017;July;27;2017-07-05 00:00;40;183;202;385
2017;July;27;2017-07-05 00:00;41;214;218;432
2017;July;27;2017-07-05 00:00;42;222;240;462
2017;July;27;2017-07-05 00:00;43;225;272;497
2017;July;27;2017-07-05 00:00;44;208;218;426
2017;July;27;2017-07-05 00:00;45;224;248;472
2017;July;27;2017-07-05 00:00;46;211;214;425
2017;July;27;2017-07-05 00:00;47;213;223;436
2017;July;27;2017-07-05 00:00;48;205;201;406
2017;July;27;2017-07-05 00:00;49;212;221;433
2017;July;27;2017-07-05 00:00;50;241;227;468
2017;July;27;2017-07-05 00:00;51;188;222;410
2017;July;27;2017-07-05 00:00;52;198;220;418
2017;July;27;2017-07-05 00:00;53;189;221;410
2017;July;27;2017-07-05 00:00;54;181;215;396
2017;July;27;2017-07-05 00:00;55;186;188;374
2017;July;27;2017-07-05 00:00;56;153;166;319
2017;July;27;2017-07-05 00:00;57;154;152;306
2017;July;27;2017-07-05 00:00;58;158;171;329
2017;July;27;2017-07-05 00:00;59;156;157;313
2017;July;27;2017-07-05 00:00;60;149;160;309
2017;July;27;2017-07-05 00:00;61;148;155;303
2017;July;27;2017-07-05 00:00;62;136;128;264
2017;July;27;2017-07-05 00:00;63;134;139;273
2017;July;27;2017-07-05 00:00;64;145;139;284
2017;July;27;2017-07-05 00:00;65;142;158;300
2017;July;27;2017-07-05 00:00;66;145;140;285
2017;July;27;2017-07-05 00:00;67;146;155;301
2017;July;27;2017-07-05 00:00;68;152;162;314
2017;July;27;2017-07-05 00:00;69;176;167;343
2017;July;27;2017-07-05 00:00;70;164;160;324
2017;July;27;2017-07-05 00:00;71;183;152;335
2017;July;27;2017-07-05 00:00;72;186;176;362
2017;July;27;2017-07-05 00:00;73;154;163;317
2017;July;27;2017-07-05 00:00;74;156;169;325
2017;July;27;2017-07-05 00:00;75;141;138;279
2017;July;27;2017-07-05 00:00;76;114;107;221
2017;July;27;2017-07-05 00:00;77;84;126;210
2017;July;27;2017-07-05 00:00;78;87;93;180
2017;July;27;2017-07-05 00:00;79;99;80;179
2017;July;27;2017-07-05 00:00;80;80;75;155
2017;July;27;2017-07-05 00:00;81;90;68;158
2017;July;27;2017-07-05 00:00;82;65;64;129
2017;July;27;2017-07-05 00:00;83;75;47;122
2017;July;27;2017-07-05 00:00;84;58;48;106
2017;July;27;2017-07-05 00:00;85;34;40;74
2017;July;27;2017-07-05 00:00;86;47;31;78
2017;July;27;2017-07-05 00:00;87;48;29;77
2017;July;27;2017-07-05 00:00;88;36;25;61
2017;July;27;2017-07-05 00:00;89;32;19;51
2017;July;27;2017-07-05 00:00;90;31;13;44
2017;July;27;2017-07-05 00:00;91;25;11;36
2017;July;27;2017-07-05 00:00;92;20;8;28
2017;July;27;2017-07-05 00:00;93;12;9;21
2017;July;27;2017-07-05 00:00;94;11;9;20
2017;July;27;2017-07-05 00:00;95;15;3;18
2017;July;27;2017-07-05 00:00;96;6;4;10
2017;July;27;2017-07-05 00:00;97;4;3;7
2017;July;27;2017-07-05 00:00;98;0;1;1
2017;July;27;2017-07-05 00:00;99;2;2;4
2017;July;27;2017-07-05 00:00;100;1;0;1
2017;July;27;2017-07-05 00:00;105;1;0;1
2017;July;28;2017-07-12 00:00;0;87;97;184
2017;July;28;2017-07-12 00:00;1;164;190;354
2017;July;28;2017-07-12 00:00;2;176;198;374
2017;July;28;2017-07-12 00:00;3;180;215;395
2017;July;28;2017-07-12 00:00;4;199;214;413
2017;July;28;2017-07-12 00:00;5;192;194;386
2017;July;28;2017-07-12 00:00;6;215;230;445
2017;July;28;2017-07-12 00:00;7;215;231;446
2017;July;28;2017-07-12 00:00;8;201;212;413
2017;July;28;2017-07-12 00:00;9;195;196;391
2017;July;28;2017-07-12 00:00;10;184;201;385
2017;July;28;2017-07-12 00:00;11;225;199;424
2017;July;28;2017-07-12 00:00;12;183;208;391
2017;July;28;2017-07-12 00:00;13;185;200;385
2017;July;28;2017-07-12 00:00;14;178;186;364
2017;July;28;2017-07-12 00:00;15;174;219;393
2017;July;28;2017-07-12 00:00;16;143;183;326
2017;July;28;2017-07-12 00:00;17;180;204;384
2017;July;28;2017-07-12 00:00;18;179;188;367
2017;July;28;2017-07-12 00:00;19;159;176;335
2017;July;28;2017-07-12 00:00;20;164;194;358
2017;July;28;2017-07-12 00:00;21;161;172;333
2017;July;28;2017-07-12 00:00;22;150;184;334
2017;July;28;2017-07-12 00:00;23;156;175;331
2017;July;28;2017-07-12 00:00;24;178;192;370
2017;July;28;2017-07-12 00:00;25;174;195;369
2017;July;28;2017-07-12 00:00;26;159;222;381
2017;July;28;2017-07-12 00:00;27;195;198;393
2017;July;28;2017-07-12 00:00;28;153;180;333
2017;July;28;2017-07-12 00:00;29;168;188;356
2017;July;28;2017-07-12 00:00;30;175;186;361
2017;July;28;2017-07-12 00:00;31;156;179;335
2017;July;28;2017-07-12 00:00;32;178;191;369
2017;July;28;2017-07-12 00:00;33;186;177;363
2017;July;28;2017-07-12 00:00;34;210;173;383
2017;July;28;2017-07-12 00:00;35;201;187;388
2017;July;28;2017-07-12 00:00;36;163;177;340
2017;July;28;2017-07-12 00:00;37;228;192;420
2017;July;28;2017-07-12 00:00;38;206;171;377
2017;July;28;2017-07-12 00:00;39;187;202;389
2017;July;28;2017-07-12 00:00;40;186;203;389
2017;July;28;2017-07-12 00:00;41;215;218;433
2017;July;28;2017-07-12 00:00;42;222;241;463
2017;July;28;2017-07-12 00:00;43;225;272;497
2017;July;28;2017-07-12 00:00;44;208;218;426
2017;July;28;2017-07-12 00:00;45;224;248;472
2017;July;28;2017-07-12 00:00;46;211;214;425
2017;July;28;2017-07-12 00:00;47;214;225;439
2017;July;28;2017-07-12 00:00;48;205;201;406
2017;July;28;2017-07-12 00:00;49;212;221;433
2017;July;28;2017-07-12 00:00;50;239;227;466
2017;July;28;2017-07-12 00:00;51;188;221;409
2017;July;28;2017-07-12 00:00;52;198;220;418
2017;July;28;2017-07-12 00:00;53;188;221;409
2017;July;28;2017-07-12 00:00;54;181;214;395
2017;July;28;2017-07-12 00:00;55;187;188;375
2017;July;28;2017-07-12 00:00;56;153;165;318
2017;July;28;2017-07-12 00:00;57;154;152;306
2017;July;28;2017-07-12 00:00;58;158;171;329
2017;July;28;2017-07-12 00:00;59;156;157;313
2017;July;28;2017-07-12 00:00;60;149;160;309
2017;July;28;2017-07-12 00:00;61;148;155;303
2017;July;28;2017-07-12 00:00;62;136;128;264
2017;July;28;2017-07-12 00:00;63;134;139;273
2017;July;28;2017-07-12 00:00;64;145;139;284
2017;July;28;2017-07-12 00:00;65;142;158;300
2017;July;28;2017-07-12 00:00;66;145;140;285
2017;July;28;2017-07-12 00:00;67;146;155;301
2017;July;28;2017-07-12 00:00;68;152;161;313
2017;July;28;2017-07-12 00:00;69;176;167;343
2017;July;28;2017-07-12 00:00;70;164;160;324
2017;July;28;2017-07-12 00:00;71;183;152;335
2017;July;28;2017-07-12 00:00;72;186;176;362
2017;July;28;2017-07-12 00:00;73;154;163;317
2017;July;28;2017-07-12 00:00;74;156;169;325
2017;July;28;2017-07-12 00:00;75;141;137;278
2017;July;28;2017-07-12 00:00;76;114;107;221
2017;July;28;2017-07-12 00:00;77;84;126;210
2017;July;28;2017-07-12 00:00;78;87;93;180
2017;July;28;2017-07-12 00:00;79;99;80;179
2017;July;28;2017-07-12 00:00;80;80;75;155
2017;July;28;2017-07-12 00:00;81;90;68;158
2017;July;28;2017-07-12 00:00;82;66;64;130
2017;July;28;2017-07-12 00:00;83;75;47;122
2017;July;28;2017-07-12 00:00;84;58;48;106
2017;July;28;2017-07-12 00:00;85;34;40;74
2017;July;28;2017-07-12 00:00;86;47;31;78
2017;July;28;2017-07-12 00:00;87;48;29;77
2017;July;28;2017-07-12 00:00;88;36;25;61
2017;July;28;2017-07-12 00:00;89;32;19;51
2017;July;28;2017-07-12 00:00;90;31;13;44
2017;July;28;2017-07-12 00:00;91;25;11;36
2017;July;28;2017-07-12 00:00;92;20;8;28
2017;July;28;2017-07-12 00:00;93;12;9;21
2017;July;28;2017-07-12 00:00;94;11;9;20
2017;July;28;2017-07-12 00:00;95;15;3;18
2017;July;28;2017-07-12 00:00;96;6;4;10
2017;July;28;2017-07-12 00:00;97;4;3;7
2017;July;28;2017-07-12 00:00;98;0;1;1
2017;July;28;2017-07-12 00:00;99;2;2;4
2017;July;28;2017-07-12 00:00;100;1;0;1
2017;July;28;2017-07-12 00:00;105;1;0;1
2017;August;31;2017-08-03 00:00;0;97;107;204
2017;August;31;2017-08-03 00:00;1;166;191;357
2017;August;31;2017-08-03 00:00;2;178;199;377
2017;August;31;2017-08-03 00:00;3;180;216;396
2017;August;31;2017-08-03 00:00;4;197;214;411
2017;August;31;2017-08-03 00:00;5;190;194;384
2017;August;31;2017-08-03 00:00;6;216;230;446
2017;August;31;2017-08-03 00:00;7;215;231;446
2017;August;31;2017-08-03 00:00;8;201;211;412
2017;August;31;2017-08-03 00:00;9;194;197;391
2017;August;31;2017-08-03 00:00;10;184;201;385
2017;August;31;2017-08-03 00:00;11;226;199;425
2017;August;31;2017-08-03 00:00;12;182;208;390
2017;August;31;2017-08-03 00:00;13;185;200;385
2017;August;31;2017-08-03 00:00;14;178;187;365
2017;August;31;2017-08-03 00:00;15;174;219;393
2017;August;31;2017-08-03 00:00;16;142;183;325
2017;August;31;2017-08-03 00:00;17;180;204;384
2017;August;31;2017-08-03 00:00;18;175;189;364
2017;August;31;2017-08-03 00:00;19;161;175;336
2017;August;31;2017-08-03 00:00;20;164;195;359
2017;August;31;2017-08-03 00:00;21;162;173;335
2017;August;31;2017-08-03 00:00;22;151;184;335
2017;August;31;2017-08-03 00:00;23;158;178;336
2017;August;31;2017-08-03 00:00;24;179;190;369
2017;August;31;2017-08-03 00:00;25;175;196;371
2017;August;31;2017-08-03 00:00;26;166;225;391
2017;August;31;2017-08-03 00:00;27;195;200;395
2017;August;31;2017-08-03 00:00;28;153;182;335
2017;August;31;2017-08-03 00:00;29;170;186;356
2017;August;31;2017-08-03 00:00;30;177;185;362
2017;August;31;2017-08-03 00:00;31;155;178;333
2017;August;31;2017-08-03 00:00;32;180;192;372
2017;August;31;2017-08-03 00:00;33;186;177;363
2017;August;31;2017-08-03 00:00;34;209;174;383
2017;August;31;2017-08-03 00:00;35;202;188;390
2017;August;31;2017-08-03 00:00;36;163;178;341
2017;August;31;2017-08-03 00:00;37;228;194;422
2017;August;31;2017-08-03 00:00;38;207;170;377
2017;August;31;2017-08-03 00:00;39;186;203;389
2017;August;31;2017-08-03 00:00;40;186;204;390
2017;August;31;2017-08-03 00:00;41;216;217;433
2017;August;31;2017-08-03 00:00;42;223;244;467
2017;August;31;2017-08-03 00:00;43;225;273;498
2017;August;31;2017-08-03 00:00;44;209;220;429
2017;August;31;2017-08-03 00:00;45;223;250;473
2017;August;31;2017-08-03 00:00;46;211;214;425
2017;August;31;2017-08-03 00:00;47;214;225;439
2017;August;31;2017-08-03 00:00;48;204;201;405
2017;August;31;2017-08-03 00:00;49;211;221;432
2017;August;31;2017-08-03 00:00;50;239;227;466
2017;August;31;2017-08-03 00:00;51;188;223;411
2017;August;31;2017-08-03 00:00;52;197;220;417
2017;August;31;2017-08-03 00:00;53;188;221;409
2017;August;31;2017-08-03 00:00;54;181;215;396
2017;August;31;2017-08-03 00:00;55;187;186;373
2017;August;31;2017-08-03 00:00;56;153;165;318
2017;August;31;2017-08-03 00:00;57;154;152;306
2017;August;31;2017-08-03 00:00;58;157;171;328
2017;August;31;2017-08-03 00:00;59;156;156;312
2017;August;31;2017-08-03 00:00;60;149;159;308
2017;August;31;2017-08-03 00:00;61;148;155;303
2017;August;31;2017-08-03 00:00;62;136;128;264
2017;August;31;2017-08-03 00:00;63;134;139;273
2017;August;31;2017-08-03 00:00;64;144;139;283
2017;August;31;2017-08-03 00:00;65;142;157;299
2017;August;31;2017-08-03 00:00;66;145;140;285
2017;August;31;2017-08-03 00:00;67;146;155;301
2017;August;31;2017-08-03 00:00;68;151;161;312
2017;August;31;2017-08-03 00:00;69;176;167;343
2017;August;31;2017-08-03 00:00;70;163;160;323
2017;August;31;2017-08-03 00:00;71;182;152;334
2017;August;31;2017-08-03 00:00;72;183;175;358
2017;August;31;2017-08-03 00:00;73;154;162;316
2017;August;31;2017-08-03 00:00;74;156;168;324
2017;August;31;2017-08-03 00:00;75;140;136;276
2017;August;31;2017-08-03 00:00;76;114;105;219
2017;August;31;2017-08-03 00:00;77;84;126;210
2017;August;31;2017-08-03 00:00;78;87;93;180
2017;August;31;2017-08-03 00:00;79;99;79;178
2017;August;31;2017-08-03 00:00;80;80;75;155
2017;August;31;2017-08-03 00:00;81;90;67;157
2017;August;31;2017-08-03 00:00;82;66;64;130
2017;August;31;2017-08-03 00:00;83;74;47;121
2017;August;31;2017-08-03 00:00;84;58;48;106
2017;August;31;2017-08-03 00:00;85;34;40;74
2017;August;31;2017-08-03 00:00;86;46;31;77
2017;August;31;2017-08-03 00:00;87;48;29;77
2017;August;31;2017-08-03 00:00;88;36;25;61
2017;August;31;2017-08-03 00:00;89;31;19;50
2017;August;31;2017-08-03 00:00;90;31;12;43
2017;August;31;2017-08-03 00:00;91;23;11;34
2017;August;31;2017-08-03 00:00;92;20;9;29
2017;August;31;2017-08-03 00:00;93;12;9;21
2017;August;31;2017-08-03 00:00;94;12;8;20
2017;August;31;2017-08-03 00:00;95;15;3;18
2017;August;31;2017-08-03 00:00;96;6;4;10
2017;August;31;2017-08-03 00:00;97;4;2;6
2017;August;31;2017-08-03 00:00;98;0;1;1
2017;August;31;2017-08-03 00:00;99;2;2;4
2017;August;31;2017-08-03 00:00;100;1;0;1
2017;August;31;2017-08-03 00:00;105;1;0;1
2017;August;33;2017-08-14 00:00;0;100;110;210
2017;August;33;2017-08-14 00:00;1;165;192;357
2017;August;33;2017-08-14 00:00;2;180;199;379
2017;August;33;2017-08-14 00:00;3;181;216;397
2017;August;33;2017-08-14 00:00;4;195;214;409
2017;August;33;2017-08-14 00:00;5;189;194;383
2017;August;33;2017-08-14 00:00;6;217;230;447
2017;August;33;2017-08-14 00:00;7;214;234;448
2017;August;33;2017-08-14 00:00;8;201;211;412
2017;August;33;2017-08-14 00:00;9;195;196;391
2017;August;33;2017-08-14 00:00;10;184;202;386
2017;August;33;2017-08-14 00:00;11;226;199;425
2017;August;33;2017-08-14 00:00;12;182;208;390
2017;August;33;2017-08-14 00:00;13;184;199;383
2017;August;33;2017-08-14 00:00;14;178;187;365
2017;August;33;2017-08-14 00:00;15;174;220;394
2017;August;33;2017-08-14 00:00;16;141;183;324
2017;August;33;2017-08-14 00:00;17;178;202;380
2017;August;33;2017-08-14 00:00;18;174;189;363
2017;August;33;2017-08-14 00:00;19;160;174;334
2017;August;33;2017-08-14 00:00;20;163;193;356
2017;August;33;2017-08-14 00:00;21;162;172;334
2017;August;33;2017-08-14 00:00;22;151;185;336
2017;August;33;2017-08-14 00:00;23;159;178;337
2017;August;33;2017-08-14 00:00;24;179;189;368
2017;August;33;2017-08-14 00:00;25;176;196;372
2017;August;33;2017-08-14 00:00;26;169;226;395
2017;August;33;2017-08-14 00:00;27;194;199;393
2017;August;33;2017-08-14 00:00;28;153;182;335
2017;August;33;2017-08-14 00:00;29;169;185;354
2017;August;33;2017-08-14 00:00;30;178;186;364
2017;August;33;2017-08-14 00:00;31;156;178;334
2017;August;33;2017-08-14 00:00;32;180;192;372
2017;August;33;2017-08-14 00:00;33;186;176;362
2017;August;33;2017-08-14 00:00;34;209;173;382
2017;August;33;2017-08-14 00:00;35;202;189;391
2017;August;33;2017-08-14 00:00;36;165;179;344
2017;August;33;2017-08-14 00:00;37;229;193;422
2017;August;33;2017-08-14 00:00;38;207;171;378
2017;August;33;2017-08-14 00:00;39;185;204;389
2017;August;33;2017-08-14 00:00;40;187;204;391
2017;August;33;2017-08-14 00:00;41;216;216;432
2017;August;33;2017-08-14 00:00;42;223;244;467
2017;August;33;2017-08-14 00:00;43;225;273;498
2017;August;33;2017-08-14 00:00;44;210;219;429
2017;August;33;2017-08-14 00:00;45;224;248;472
2017;August;33;2017-08-14 00:00;46;211;214;425
2017;August;33;2017-08-14 00:00;47;212;225;437
2017;August;33;2017-08-14 00:00;48;202;200;402
2017;August;33;2017-08-14 00:00;49;210;221;431
2017;August;33;2017-08-14 00:00;50;237;227;464
2017;August;33;2017-08-14 00:00;51;188;222;410
2017;August;33;2017-08-14 00:00;52;197;220;417
2017;August;33;2017-08-14 00:00;53;188;221;409
2017;August;33;2017-08-14 00:00;54;181;217;398
2017;August;33;2017-08-14 00:00;55;187;186;373
2017;August;33;2017-08-14 00:00;56;152;165;317
2017;August;33;2017-08-14 00:00;57;154;152;306
2017;August;33;2017-08-14 00:00;58;157;170;327
2017;August;33;2017-08-14 00:00;59;156;156;312
2017;August;33;2017-08-14 00:00;60;149;159;308
2017;August;33;2017-08-14 00:00;61;148;155;303
2017;August;33;2017-08-14 00:00;62;136;128;264
2017;August;33;2017-08-14 00:00;63;134;139;273
2017;August;33;2017-08-14 00:00;64;144;139;283
2017;August;33;2017-08-14 00:00;65;142;156;298
2017;August;33;2017-08-14 00:00;66;145;140;285
2017;August;33;2017-08-14 00:00;67;146;155;301
2017;August;33;2017-08-14 00:00;68;151;161;312
2017;August;33;2017-08-14 00:00;69;176;167;343
2017;August;33;2017-08-14 00:00;70;163;160;323
2017;August;33;2017-08-14 00:00;71;182;152;334
2017;August;33;2017-08-14 00:00;72;183;175;358
2017;August;33;2017-08-14 00:00;73;154;162;316
2017;August;33;2017-08-14 00:00;74;156;168;324
2017;August;33;2017-08-14 00:00;75;140;136;276
2017;August;33;2017-08-14 00:00;76;114;104;218
2017;August;33;2017-08-14 00:00;77;84;126;210
2017;August;33;2017-08-14 00:00;78;87;93;180
2017;August;33;2017-08-14 00:00;79;99;79;178
2017;August;33;2017-08-14 00:00;80;80;75;155
2017;August;33;2017-08-14 00:00;81;90;67;157
2017;August;33;2017-08-14 00:00;82;66;64;130
2017;August;33;2017-08-14 00:00;83;74;47;121
2017;August;33;2017-08-14 00:00;84;58;48;106
2017;August;33;2017-08-14 00:00;85;34;40;74
2017;August;33;2017-08-14 00:00;86;46;31;77
2017;August;33;2017-08-14 00:00;87;48;29;77
2017;August;33;2017-08-14 00:00;88;36;25;61
2017;August;33;2017-08-14 00:00;89;31;19;50
2017;August;33;2017-08-14 00:00;90;31;12;43
2017;August;33;2017-08-14 00:00;91;23;11;34
2017;August;33;2017-08-14 00:00;92;20;9;29
2017;August;33;2017-08-14 00:00;93;12;9;21
2017;August;33;2017-08-14 00:00;94;12;8;20
2017;August;33;2017-08-14 00:00;95;15;3;18
2017;August;33;2017-08-14 00:00;96;6;4;10
2017;August;33;2017-08-14 00:00;97;4;2;6
2017;August;33;2017-08-14 00:00;98;0;1;1
2017;August;33;2017-08-14 00:00;99;2;2;4
2017;August;33;2017-08-14 00:00;100;1;0;1
2017;August;33;2017-08-14 00:00;105;1;0;1
2017;August;33;2017-08-16 00:00;0;107;115;222
2017;August;33;2017-08-16 00:00;1;165;191;356
2017;August;33;2017-08-16 00:00;2;180;199;379
2017;August;33;2017-08-16 00:00;3;181;216;397
2017;August;33;2017-08-16 00:00;4;195;216;411
2017;August;33;2017-08-16 00:00;5;189;195;384
2017;August;33;2017-08-16 00:00;6;217;230;447
2017;August;33;2017-08-16 00:00;7;215;235;450
2017;August;33;2017-08-16 00:00;8;202;211;413
2017;August;33;2017-08-16 00:00;9;195;196;391
2017;August;33;2017-08-16 00:00;10;184;202;386
2017;August;33;2017-08-16 00:00;11;226;199;425
2017;August;33;2017-08-16 00:00;12;182;209;391
2017;August;33;2017-08-16 00:00;13;184;199;383
2017;August;33;2017-08-16 00:00;14;178;186;364
2017;August;33;2017-08-16 00:00;15;174;221;395
2017;August;33;2017-08-16 00:00;16;142;183;325
2017;August;33;2017-08-16 00:00;17;178;202;380
2017;August;33;2017-08-16 00:00;18;175;189;364
2017;August;33;2017-08-16 00:00;19;160;174;334
2017;August;33;2017-08-16 00:00;20;161;193;354
2017;August;33;2017-08-16 00:00;21;161;172;333
2017;August;33;2017-08-16 00:00;22;150;185;335
2017;August;33;2017-08-16 00:00;23;161;179;340
2017;August;33;2017-08-16 00:00;24;179;190;369
2017;August;33;2017-08-16 00:00;25;176;195;371
2017;August;33;2017-08-16 00:00;26;170;225;395
2017;August;33;2017-08-16 00:00;27;195;200;395
2017;August;33;2017-08-16 00:00;28;154;183;337
2017;August;33;2017-08-16 00:00;29;169;184;353
2017;August;33;2017-08-16 00:00;30;177;187;364
2017;August;33;2017-08-16 00:00;31;157;178;335
2017;August;33;2017-08-16 00:00;32;180;192;372
2017;August;33;2017-08-16 00:00;33;186;177;363
2017;August;33;2017-08-16 00:00;34;210;173;383
2017;August;33;2017-08-16 00:00;35;202;190;392
2017;August;33;2017-08-16 00:00;36;165;179;344
2017;August;33;2017-08-16 00:00;37;229;192;421
2017;August;33;2017-08-16 00:00;38;207;172;379
2017;August;33;2017-08-16 00:00;39;185;204;389
2017;August;33;2017-08-16 00:00;40;187;204;391
2017;August;33;2017-08-16 00:00;41;216;216;432
2017;August;33;2017-08-16 00:00;42;222;244;466
2017;August;33;2017-08-16 00:00;43;225;273;498
2017;August;33;2017-08-16 00:00;44;212;219;431
2017;August;33;2017-08-16 00:00;45;224;248;472
2017;August;33;2017-08-16 00:00;46;211;213;424
2017;August;33;2017-08-16 00:00;47;212;225;437
2017;August;33;2017-08-16 00:00;48;202;200;402
2017;August;33;2017-08-16 00:00;49;209;221;430
2017;August;33;2017-08-16 00:00;50;237;227;464
2017;August;33;2017-08-16 00:00;51;189;221;410
2017;August;33;2017-08-16 00:00;52;198;220;418
2017;August;33;2017-08-16 00:00;53;188;221;409
2017;August;33;2017-08-16 00:00;54;181;217;398
2017;August;33;2017-08-16 00:00;55;187;187;374
2017;August;33;2017-08-16 00:00;56;152;165;317
2017;August;33;2017-08-16 00:00;57;154;152;306
2017;August;33;2017-08-16 00:00;58;157;170;327
2017;August;33;2017-08-16 00:00;59;156;155;311
2017;August;33;2017-08-16 00:00;60;149;159;308
2017;August;33;2017-08-16 00:00;61;148;154;302
2017;August;33;2017-08-16 00:00;62;136;128;264
2017;August;33;2017-08-16 00:00;63;134;139;273
2017;August;33;2017-08-16 00:00;64;143;139;282
2017;August;33;2017-08-16 00:00;65;142;156;298
2017;August;33;2017-08-16 00:00;66;145;140;285
2017;August;33;2017-08-16 00:00;67;145;155;300
2017;August;33;2017-08-16 00:00;68;151;161;312
2017;August;33;2017-08-16 00:00;69;176;167;343
2017;August;33;2017-08-16 00:00;70;163;160;323
2017;August;33;2017-08-16 00:00;71;182;152;334
2017;August;33;2017-08-16 00:00;72;183;175;358
2017;August;33;2017-08-16 00:00;73;154;162;316
2017;August;33;2017-08-16 00:00;74;156;167;323
2017;August;33;2017-08-16 00:00;75;140;136;276
2017;August;33;2017-08-16 00:00;76;114;104;218
2017;August;33;2017-08-16 00:00;77;84;126;210
2017;August;33;2017-08-16 00:00;78;87;93;180
2017;August;33;2017-08-16 00:00;79;99;79;178
2017;August;33;2017-08-16 00:00;80;80;75;155
2017;August;33;2017-08-16 00:00;81;90;67;157
2017;August;33;2017-08-16 00:00;82;65;64;129
2017;August;33;2017-08-16 00:00;83;74;47;121
2017;August;33;2017-08-16 00:00;84;58;48;106
2017;August;33;2017-08-16 00:00;85;34;40;74
2017;August;33;2017-08-16 00:00;86;46;31;77
2017;August;33;2017-08-16 00:00;87;47;29;76
2017;August;33;2017-08-16 00:00;88;36;25;61
2017;August;33;2017-08-16 00:00;89;31;19;50
2017;August;33;2017-08-16 00:00;90;31;12;43
2017;August;33;2017-08-16 00:00;91;23;11;34
2017;August;33;2017-08-16 00:00;92;20;9;29
2017;August;33;2017-08-16 00:00;93;12;9;21
2017;August;33;2017-08-16 00:00;94;12;7;19
2017;August;33;2017-08-16 00:00;95;15;3;18
2017;August;33;2017-08-16 00:00;96;6;4;10
2017;August;33;2017-08-16 00:00;97;4;2;6
2017;August;33;2017-08-16 00:00;98;0;1;1
2017;August;33;2017-08-16 00:00;99;2;2;4
2017;August;33;2017-08-16 00:00;100;1;0;1
2017;August;33;2017-08-16 00:00;105;1;0;1
2017;August;34;2017-08-23 00:00;0;112;117;229
2017;August;34;2017-08-23 00:00;1;165;193;358
2017;August;34;2017-08-23 00:00;2;181;199;380
2017;August;34;2017-08-23 00:00;3;181;216;397
2017;August;34;2017-08-23 00:00;4;194;216;410
2017;August;34;2017-08-23 00:00;5;188;195;383
2017;August;34;2017-08-23 00:00;6;216;230;446
2017;August;34;2017-08-23 00:00;7;215;234;449
2017;August;34;2017-08-23 00:00;8;202;210;412
2017;August;34;2017-08-23 00:00;9;194;196;390
2017;August;34;2017-08-23 00:00;10;183;202;385
2017;August;34;2017-08-23 00:00;11;225;198;423
2017;August;34;2017-08-23 00:00;12;182;209;391
2017;August;34;2017-08-23 00:00;13;184;199;383
2017;August;34;2017-08-23 00:00;14;178;186;364
2017;August;34;2017-08-23 00:00;15;173;221;394
2017;August;34;2017-08-23 00:00;16;142;183;325
2017;August;34;2017-08-23 00:00;17;178;201;379
2017;August;34;2017-08-23 00:00;18;175;186;361
2017;August;34;2017-08-23 00:00;19;158;173;331
2017;August;34;2017-08-23 00:00;20;157;193;350
2017;August;34;2017-08-23 00:00;21;163;172;335
2017;August;34;2017-08-23 00:00;22;150;185;335
2017;August;34;2017-08-23 00:00;23;160;179;339
2017;August;34;2017-08-23 00:00;24;178;192;370
2017;August;34;2017-08-23 00:00;25;174;195;369
2017;August;34;2017-08-23 00:00;26;171;226;397
2017;August;34;2017-08-23 00:00;27;193;200;393
2017;August;34;2017-08-23 00:00;28;155;183;338
2017;August;34;2017-08-23 00:00;29;172;184;356
2017;August;34;2017-08-23 00:00;30;179;187;366
2017;August;34;2017-08-23 00:00;31;157;179;336
2017;August;34;2017-08-23 00:00;32;180;195;375
2017;August;34;2017-08-23 00:00;33;187;177;364
2017;August;34;2017-08-23 00:00;34;209;173;382
2017;August;34;2017-08-23 00:00;35;202;189;391
2017;August;34;2017-08-23 00:00;36;167;179;346
2017;August;34;2017-08-23 00:00;37;228;192;420
2017;August;34;2017-08-23 00:00;38;206;172;378
2017;August;34;2017-08-23 00:00;39;185;204;389
2017;August;34;2017-08-23 00:00;40;188;203;391
2017;August;34;2017-08-23 00:00;41;216;216;432
2017;August;34;2017-08-23 00:00;42;221;245;466
2017;August;34;2017-08-23 00:00;43;225;274;499
2017;August;34;2017-08-23 00:00;44;212;219;431
2017;August;34;2017-08-23 00:00;45;223;248;471
2017;August;34;2017-08-23 00:00;46;211;211;422
2017;August;34;2017-08-23 00:00;47;211;224;435
2017;August;34;2017-08-23 00:00;48;202;200;402
2017;August;34;2017-08-23 00:00;49;209;221;430
2017;August;34;2017-08-23 00:00;50;236;228;464
2017;August;34;2017-08-23 00:00;51;188;222;410
2017;August;34;2017-08-23 00:00;52;198;220;418
2017;August;34;2017-08-23 00:00;53;188;221;409
2017;August;34;2017-08-23 00:00;54;179;217;396
2017;August;34;2017-08-23 00:00;55;187;187;374
2017;August;34;2017-08-23 00:00;56;151;165;316
2017;August;34;2017-08-23 00:00;57;154;152;306
2017;August;34;2017-08-23 00:00;58;157;170;327
2017;August;34;2017-08-23 00:00;59;156;155;311
2017;August;34;2017-08-23 00:00;60;149;158;307
2017;August;34;2017-08-23 00:00;61;148;154;302
2017;August;34;2017-08-23 00:00;62;136;128;264
2017;August;34;2017-08-23 00:00;63;134;139;273
2017;August;34;2017-08-23 00:00;64;143;139;282
2017;August;34;2017-08-23 00:00;65;141;156;297
2017;August;34;2017-08-23 00:00;66;145;139;284
2017;August;34;2017-08-23 00:00;67;145;155;300
2017;August;34;2017-08-23 00:00;68;151;161;312
2017;August;34;2017-08-23 00:00;69;176;167;343
2017;August;34;2017-08-23 00:00;70;162;160;322
2017;August;34;2017-08-23 00:00;71;181;152;333
2017;August;34;2017-08-23 00:00;72;182;175;357
2017;August;34;2017-08-23 00:00;73;154;162;316
2017;August;34;2017-08-23 00:00;74;156;167;323
2017;August;34;2017-08-23 00:00;75;140;136;276
2017;August;34;2017-08-23 00:00;76;114;104;218
2017;August;34;2017-08-23 00:00;77;84;125;209
2017;August;34;2017-08-23 00:00;78;87;93;180
2017;August;34;2017-08-23 00:00;79;99;78;177
2017;August;34;2017-08-23 00:00;80;80;75;155
2017;August;34;2017-08-23 00:00;81;90;67;157
2017;August;34;2017-08-23 00:00;82;65;64;129
2017;August;34;2017-08-23 00:00;83;74;47;121
2017;August;34;2017-08-23 00:00;84;58;48;106
2017;August;34;2017-08-23 00:00;85;34;40;74
2017;August;34;2017-08-23 00:00;86;46;31;77
2017;August;34;2017-08-23 00:00;87;47;29;76
2017;August;34;2017-08-23 00:00;88;36;25;61
2017;August;34;2017-08-23 00:00;89;31;19;50
2017;August;34;2017-08-23 00:00;90;31;11;42
2017;August;34;2017-08-23 00:00;91;23;11;34
2017;August;34;2017-08-23 00:00;92;20;9;29
2017;August;34;2017-08-23 00:00;93;12;9;21
2017;August;34;2017-08-23 00:00;94;12;7;19
2017;August;34;2017-08-23 00:00;95;15;3;18
2017;August;34;2017-08-23 00:00;96;6;4;10
2017;August;34;2017-08-23 00:00;97;4;2;6
2017;August;34;2017-08-23 00:00;98;0;1;1
2017;August;34;2017-08-23 00:00;99;2;1;3
2017;August;34;2017-08-23 00:00;100;1;0;1
2017;August;34;2017-08-23 00:00;105;1;0;1
2017;August;35;2017-08-30 00:00;0;117;118;235
2017;August;35;2017-08-30 00:00;1;165;193;358
2017;August;35;2017-08-30 00:00;2;181;200;381
2017;August;35;2017-08-30 00:00;3;181;216;397
2017;August;35;2017-08-30 00:00;4;194;216;410
2017;August;35;2017-08-30 00:00;5;189;195;384
2017;August;35;2017-08-30 00:00;6;216;230;446
2017;August;35;2017-08-30 00:00;7;215;233;448
2017;August;35;2017-08-30 00:00;8;202;210;412
2017;August;35;2017-08-30 00:00;9;194;196;390
2017;August;35;2017-08-30 00:00;10;184;202;386
2017;August;35;2017-08-30 00:00;11;225;198;423
2017;August;35;2017-08-30 00:00;12;183;209;392
2017;August;35;2017-08-30 00:00;13;185;200;385
2017;August;35;2017-08-30 00:00;14;178;185;363
2017;August;35;2017-08-30 00:00;15;173;220;393
2017;August;35;2017-08-30 00:00;16;142;183;325
2017;August;35;2017-08-30 00:00;17;178;201;379
2017;August;35;2017-08-30 00:00;18;174;186;360
2017;August;35;2017-08-30 00:00;19;157;174;331
2017;August;35;2017-08-30 00:00;20;158;193;351
2017;August;35;2017-08-30 00:00;21;161;174;335
2017;August;35;2017-08-30 00:00;22;146;185;331
2017;August;35;2017-08-30 00:00;23;159;179;338
2017;August;35;2017-08-30 00:00;24;179;192;371
2017;August;35;2017-08-30 00:00;25;176;195;371
2017;August;35;2017-08-30 00:00;26;171;225;396
2017;August;35;2017-08-30 00:00;27;192;198;390
2017;August;35;2017-08-30 00:00;28;152;182;334
2017;August;35;2017-08-30 00:00;29;173;185;358
2017;August;35;2017-08-30 00:00;30;180;186;366
2017;August;35;2017-08-30 00:00;31;159;179;338
2017;August;35;2017-08-30 00:00;32;181;194;375
2017;August;35;2017-08-30 00:00;33;187;176;363
2017;August;35;2017-08-30 00:00;34;209;174;383
2017;August;35;2017-08-30 00:00;35;202;189;391
2017;August;35;2017-08-30 00:00;36;167;180;347
2017;August;35;2017-08-30 00:00;37;228;192;420
2017;August;35;2017-08-30 00:00;38;209;172;381
2017;August;35;2017-08-30 00:00;39;186;204;390
2017;August;35;2017-08-30 00:00;40;188;203;391
2017;August;35;2017-08-30 00:00;41;216;216;432
2017;August;35;2017-08-30 00:00;42;221;245;466
2017;August;35;2017-08-30 00:00;43;225;275;500
2017;August;35;2017-08-30 00:00;44;212;219;431
2017;August;35;2017-08-30 00:00;45;223;248;471
2017;August;35;2017-08-30 00:00;46;211;213;424
2017;August;35;2017-08-30 00:00;47;211;223;434
2017;August;35;2017-08-30 00:00;48;202;201;403
2017;August;35;2017-08-30 00:00;49;209;221;430
2017;August;35;2017-08-30 00:00;50;236;228;464
2017;August;35;2017-08-30 00:00;51;188;222;410
2017;August;35;2017-08-30 00:00;52;198;220;418
2017;August;35;2017-08-30 00:00;53;188;221;409
2017;August;35;2017-08-30 00:00;54;179;217;396
2017;August;35;2017-08-30 00:00;55;186;187;373
2017;August;35;2017-08-30 00:00;56;151;165;316
2017;August;35;2017-08-30 00:00;57;154;152;306
2017;August;35;2017-08-30 00:00;58;157;170;327
2017;August;35;2017-08-30 00:00;59;156;155;311
2017;August;35;2017-08-30 00:00;60;150;158;308
2017;August;35;2017-08-30 00:00;61;147;154;301
2017;August;35;2017-08-30 00:00;62;136;128;264
2017;August;35;2017-08-30 00:00;63;134;139;273
2017;August;35;2017-08-30 00:00;64;143;139;282
2017;August;35;2017-08-30 00:00;65;141;156;297
2017;August;35;2017-08-30 00:00;66;145;139;284
2017;August;35;2017-08-30 00:00;67;145;155;300
2017;August;35;2017-08-30 00:00;68;150;161;311
2017;August;35;2017-08-30 00:00;69;176;166;342
2017;August;35;2017-08-30 00:00;70;162;160;322
2017;August;35;2017-08-30 00:00;71;181;152;333
2017;August;35;2017-08-30 00:00;72;182;174;356
2017;August;35;2017-08-30 00:00;73;153;162;315
2017;August;35;2017-08-30 00:00;74;156;167;323
2017;August;35;2017-08-30 00:00;75;140;136;276
2017;August;35;2017-08-30 00:00;76;114;104;218
2017;August;35;2017-08-30 00:00;77;84;125;209
2017;August;35;2017-08-30 00:00;78;87;92;179
2017;August;35;2017-08-30 00:00;79;99;78;177
2017;August;35;2017-08-30 00:00;80;80;75;155
2017;August;35;2017-08-30 00:00;81;90;67;157
2017;August;35;2017-08-30 00:00;82;64;64;128
2017;August;35;2017-08-30 00:00;83;74;47;121
2017;August;35;2017-08-30 00:00;84;58;48;106
2017;August;35;2017-08-30 00:00;85;34;39;73
2017;August;35;2017-08-30 00:00;86;46;31;77
2017;August;35;2017-08-30 00:00;87;47;29;76
2017;August;35;2017-08-30 00:00;88;36;25;61
2017;August;35;2017-08-30 00:00;89;31;19;50
2017;August;35;2017-08-30 00:00;90;31;11;42
2017;August;35;2017-08-30 00:00;91;23;11;34
2017;August;35;2017-08-30 00:00;92;20;9;29
2017;August;35;2017-08-30 00:00;93;12;9;21
2017;August;35;2017-08-30 00:00;94;12;7;19
2017;August;35;2017-08-30 00:00;95;15;3;18
2017;August;35;2017-08-30 00:00;96;6;4;10
2017;August;35;2017-08-30 00:00;97;4;2;6
2017;August;35;2017-08-30 00:00;98;0;1;1
2017;August;35;2017-08-30 00:00;99;2;1;3
2017;August;35;2017-08-30 00:00;100;1;0;1
2017;August;35;2017-08-30 00:00;105;1;0;1
2017;September;36;2017-09-05 00:00;0;121;120;241
2017;September;36;2017-09-05 00:00;1;167;193;360
2017;September;36;2017-09-05 00:00;2;181;200;381
2017;September;36;2017-09-05 00:00;3;180;216;396
2017;September;36;2017-09-05 00:00;4;195;216;411
2017;September;36;2017-09-05 00:00;5;190;195;385
2017;September;36;2017-09-05 00:00;6;217;230;447
2017;September;36;2017-09-05 00:00;7;215;235;450
2017;September;36;2017-09-05 00:00;8;203;210;413
2017;September;36;2017-09-05 00:00;9;194;197;391
2017;September;36;2017-09-05 00:00;10;184;202;386
2017;September;36;2017-09-05 00:00;11;225;198;423
2017;September;36;2017-09-05 00:00;12;183;209;392
2017;September;36;2017-09-05 00:00;13;185;199;384
2017;September;36;2017-09-05 00:00;14;177;185;362
2017;September;36;2017-09-05 00:00;15;173;220;393
2017;September;36;2017-09-05 00:00;16;142;186;328
2017;September;36;2017-09-05 00:00;17;178;201;379
2017;September;36;2017-09-05 00:00;18;173;186;359
2017;September;36;2017-09-05 00:00;19;157;175;332
2017;September;36;2017-09-05 00:00;20;161;193;354
2017;September;36;2017-09-05 00:00;21;161;174;335
2017;September;36;2017-09-05 00:00;22;144;182;326
2017;September;36;2017-09-05 00:00;23;161;179;340
2017;September;36;2017-09-05 00:00;24;178;190;368
2017;September;36;2017-09-05 00:00;25;173;193;366
2017;September;36;2017-09-05 00:00;26;170;225;395
2017;September;36;2017-09-05 00:00;27;191;199;390
2017;September;36;2017-09-05 00:00;28;153;181;334
2017;September;36;2017-09-05 00:00;29;175;185;360
2017;September;36;2017-09-05 00:00;30;181;187;368
2017;September;36;2017-09-05 00:00;31;161;179;340
2017;September;36;2017-09-05 00:00;32;183;196;379
2017;September;36;2017-09-05 00:00;33;187;176;363
2017;September;36;2017-09-05 00:00;34;209;174;383
2017;September;36;2017-09-05 00:00;35;202;189;391
2017;September;36;2017-09-05 00:00;36;168;180;348
2017;September;36;2017-09-05 00:00;37;229;195;424
2017;September;36;2017-09-05 00:00;38;210;172;382
2017;September;36;2017-09-05 00:00;39;186;205;391
2017;September;36;2017-09-05 00:00;40;189;204;393
2017;September;36;2017-09-05 00:00;41;215;215;430
2017;September;36;2017-09-05 00:00;42;221;244;465
2017;September;36;2017-09-05 00:00;43;225;275;500
2017;September;36;2017-09-05 00:00;44;211;218;429
2017;September;36;2017-09-05 00:00;45;223;249;472
2017;September;36;2017-09-05 00:00;46;212;212;424
2017;September;36;2017-09-05 00:00;47;211;222;433
2017;September;36;2017-09-05 00:00;48;202;200;402
2017;September;36;2017-09-05 00:00;49;210;221;431
2017;September;36;2017-09-05 00:00;50;236;227;463
2017;September;36;2017-09-05 00:00;51;189;222;411
2017;September;36;2017-09-05 00:00;52;198;221;419
2017;September;36;2017-09-05 00:00;53;188;222;410
2017;September;36;2017-09-05 00:00;54;178;218;396
2017;September;36;2017-09-05 00:00;55;186;187;373
2017;September;36;2017-09-05 00:00;56;151;166;317
2017;September;36;2017-09-05 00:00;57;154;152;306
2017;September;36;2017-09-05 00:00;58;157;170;327
2017;September;36;2017-09-05 00:00;59;155;155;310
2017;September;36;2017-09-05 00:00;60;150;157;307
2017;September;36;2017-09-05 00:00;61;147;154;301
2017;September;36;2017-09-05 00:00;62;136;128;264
2017;September;36;2017-09-05 00:00;63;134;139;273
2017;September;36;2017-09-05 00:00;64;143;138;281
2017;September;36;2017-09-05 00:00;65;141;156;297
2017;September;36;2017-09-05 00:00;66;145;139;284
2017;September;36;2017-09-05 00:00;67;145;155;300
2017;September;36;2017-09-05 00:00;68;150;161;311
2017;September;36;2017-09-05 00:00;69;175;166;341
2017;September;36;2017-09-05 00:00;70;162;160;322
2017;September;36;2017-09-05 00:00;71;181;152;333
2017;September;36;2017-09-05 00:00;72;182;173;355
2017;September;36;2017-09-05 00:00;73;153;162;315
2017;September;36;2017-09-05 00:00;74;154;167;321
2017;September;36;2017-09-05 00:00;75;139;136;275
2017;September;36;2017-09-05 00:00;76;112;104;216
2017;September;36;2017-09-05 00:00;77;83;125;208
2017;September;36;2017-09-05 00:00;78;87;92;179
2017;September;36;2017-09-05 00:00;79;99;78;177
2017;September;36;2017-09-05 00:00;80;80;75;155
2017;September;36;2017-09-05 00:00;81;89;67;156
2017;September;36;2017-09-05 00:00;82;64;64;128
2017;September;36;2017-09-05 00:00;83;74;46;120
2017;September;36;2017-09-05 00:00;84;58;48;106
2017;September;36;2017-09-05 00:00;85;34;39;73
2017;September;36;2017-09-05 00:00;86;46;31;77
2017;September;36;2017-09-05 00:00;87;47;29;76
2017;September;36;2017-09-05 00:00;88;36;25;61
2017;September;36;2017-09-05 00:00;89;30;19;49
2017;September;36;2017-09-05 00:00;90;31;11;42
2017;September;36;2017-09-05 00:00;91;23;11;34
2017;September;36;2017-09-05 00:00;92;20;9;29
2017;September;36;2017-09-05 00:00;93;12;9;21
2017;September;36;2017-09-05 00:00;94;12;7;19
2017;September;36;2017-09-05 00:00;95;15;3;18
2017;September;36;2017-09-05 00:00;96;6;4;10
2017;September;36;2017-09-05 00:00;97;4;2;6
2017;September;36;2017-09-05 00:00;98;0;1;1
2017;September;36;2017-09-05 00:00;99;2;1;3
2017;September;36;2017-09-05 00:00;100;1;0;1
2017;September;36;2017-09-05 00:00;105;1;0;1
2017;September;37;2017-09-12 00:00;0;126;126;252
2017;September;37;2017-09-12 00:00;1;168;193;361
2017;September;37;2017-09-12 00:00;2;180;200;380
2017;September;37;2017-09-12 00:00;3;180;216;396
2017;September;37;2017-09-12 00:00;4;195;216;411
2017;September;37;2017-09-12 00:00;5;189;195;384
2017;September;37;2017-09-12 00:00;6;216;230;446
2017;September;37;2017-09-12 00:00;7;215;235;450
2017;September;37;2017-09-12 00:00;8;203;210;413
2017;September;37;2017-09-12 00:00;9;194;197;391
2017;September;37;2017-09-12 00:00;10;184;202;386
2017;September;37;2017-09-12 00:00;11;225;198;423
2017;September;37;2017-09-12 00:00;12;183;209;392
2017;September;37;2017-09-12 00:00;13;185;199;384
2017;September;37;2017-09-12 00:00;14;177;186;363
2017;September;37;2017-09-12 00:00;15;173;221;394
2017;September;37;2017-09-12 00:00;16;142;186;328
2017;September;37;2017-09-12 00:00;17;178;201;379
2017;September;37;2017-09-12 00:00;18;174;186;360
2017;September;37;2017-09-12 00:00;19;157;177;334
2017;September;37;2017-09-12 00:00;20;161;194;355
2017;September;37;2017-09-12 00:00;21;161;172;333
2017;September;37;2017-09-12 00:00;22;143;182;325
2017;September;37;2017-09-12 00:00;23;160;179;339
2017;September;37;2017-09-12 00:00;24;179;192;371
2017;September;37;2017-09-12 00:00;25;173;193;366
2017;September;37;2017-09-12 00:00;26;172;226;398
2017;September;37;2017-09-12 00:00;27;189;197;386
2017;September;37;2017-09-12 00:00;28;154;181;335
2017;September;37;2017-09-12 00:00;29;176;186;362
2017;September;37;2017-09-12 00:00;30;178;186;364
2017;September;37;2017-09-12 00:00;31;164;179;343
2017;September;37;2017-09-12 00:00;32;183;195;378
2017;September;37;2017-09-12 00:00;33;187;177;364
2017;September;37;2017-09-12 00:00;34;209;175;384
2017;September;37;2017-09-12 00:00;35;202;190;392
2017;September;37;2017-09-12 00:00;36;168;180;348
2017;September;37;2017-09-12 00:00;37;229;195;424
2017;September;37;2017-09-12 00:00;38;210;171;381
2017;September;37;2017-09-12 00:00;39;186;205;391
2017;September;37;2017-09-12 00:00;40;189;204;393
2017;September;37;2017-09-12 00:00;41;215;216;431
2017;September;37;2017-09-12 00:00;42;221;243;464
2017;September;37;2017-09-12 00:00;43;225;275;500
2017;September;37;2017-09-12 00:00;44;210;218;428
2017;September;37;2017-09-12 00:00;45;223;251;474
2017;September;37;2017-09-12 00:00;46;212;212;424
2017;September;37;2017-09-12 00:00;47;211;222;433
2017;September;37;2017-09-12 00:00;48;202;199;401
2017;September;37;2017-09-12 00:00;49;210;221;431
2017;September;37;2017-09-12 00:00;50;236;227;463
2017;September;37;2017-09-12 00:00;51;189;223;412
2017;September;37;2017-09-12 00:00;52;199;222;421
2017;September;37;2017-09-12 00:00;53;188;222;410
2017;September;37;2017-09-12 00:00;54;178;218;396
2017;September;37;2017-09-12 00:00;55;185;187;372
2017;September;37;2017-09-12 00:00;56;151;167;318
2017;September;37;2017-09-12 00:00;57;154;152;306
2017;September;37;2017-09-12 00:00;58;157;170;327
2017;September;37;2017-09-12 00:00;59;155;155;310
2017;September;37;2017-09-12 00:00;60;150;157;307
2017;September;37;2017-09-12 00:00;61;147;154;301
2017;September;37;2017-09-12 00:00;62;136;127;263
2017;September;37;2017-09-12 00:00;63;134;139;273
2017;September;37;2017-09-12 00:00;64;143;138;281
2017;September;37;2017-09-12 00:00;65;141;155;296
2017;September;37;2017-09-12 00:00;66;145;139;284
2017;September;37;2017-09-12 00:00;67;145;156;301
2017;September;37;2017-09-12 00:00;68;149;161;310
2017;September;37;2017-09-12 00:00;69;175;166;341
2017;September;37;2017-09-12 00:00;70;162;160;322
2017;September;37;2017-09-12 00:00;71;181;152;333
2017;September;37;2017-09-12 00:00;72;182;173;355
2017;September;37;2017-09-12 00:00;73;153;162;315
2017;September;37;2017-09-12 00:00;74;153;167;320
2017;September;37;2017-09-12 00:00;75;139;136;275
2017;September;37;2017-09-12 00:00;76;112;104;216
2017;September;37;2017-09-12 00:00;77;83;125;208
2017;September;37;2017-09-12 00:00;78;87;92;179
2017;September;37;2017-09-12 00:00;79;98;78;176
2017;September;37;2017-09-12 00:00;80;80;75;155
2017;September;37;2017-09-12 00:00;81;89;67;156
2017;September;37;2017-09-12 00:00;82;63;64;127
2017;September;37;2017-09-12 00:00;83;74;46;120
2017;September;37;2017-09-12 00:00;84;58;48;106
2017;September;37;2017-09-12 00:00;85;34;39;73
2017;September;37;2017-09-12 00:00;86;46;31;77
2017;September;37;2017-09-12 00:00;87;47;29;76
2017;September;37;2017-09-12 00:00;88;35;25;60
2017;September;37;2017-09-12 00:00;89;30;19;49
2017;September;37;2017-09-12 00:00;90;31;11;42
2017;September;37;2017-09-12 00:00;91;23;11;34
2017;September;37;2017-09-12 00:00;92;20;8;28
2017;September;37;2017-09-12 00:00;93;12;9;21
2017;September;37;2017-09-12 00:00;94;12;7;19
2017;September;37;2017-09-12 00:00;95;14;3;17
2017;September;37;2017-09-12 00:00;96;6;4;10
2017;September;37;2017-09-12 00:00;97;4;2;6
2017;September;37;2017-09-12 00:00;98;0;1;1
2017;September;37;2017-09-12 00:00;99;2;1;3
2017;September;37;2017-09-12 00:00;105;1;0;1
2017;September;38;2017-09-19 00:00;0;126;126;252
2017;September;38;2017-09-19 00:00;1;168;193;361
2017;September;38;2017-09-19 00:00;2;180;200;380
2017;September;38;2017-09-19 00:00;3;180;216;396
2017;September;38;2017-09-19 00:00;4;195;216;411
2017;September;38;2017-09-19 00:00;5;189;195;384
2017;September;38;2017-09-19 00:00;6;216;230;446
2017;September;38;2017-09-19 00:00;7;215;235;450
2017;September;38;2017-09-19 00:00;8;203;210;413
2017;September;38;2017-09-19 00:00;9;194;197;391
2017;September;38;2017-09-19 00:00;10;184;202;386
2017;September;38;2017-09-19 00:00;11;225;198;423
2017;September;38;2017-09-19 00:00;12;183;209;392
2017;September;38;2017-09-19 00:00;13;185;199;384
2017;September;38;2017-09-19 00:00;14;177;186;363
2017;September;38;2017-09-19 00:00;15;173;221;394
2017;September;38;2017-09-19 00:00;16;142;186;328
2017;September;38;2017-09-19 00:00;17;178;201;379
2017;September;38;2017-09-19 00:00;18;174;186;360
2017;September;38;2017-09-19 00:00;19;157;177;334
2017;September;38;2017-09-19 00:00;20;161;194;355
2017;September;38;2017-09-19 00:00;21;161;172;333
2017;September;38;2017-09-19 00:00;22;143;182;325
2017;September;38;2017-09-19 00:00;23;160;179;339
2017;September;38;2017-09-19 00:00;24;179;192;371
2017;September;38;2017-09-19 00:00;25;173;193;366
2017;September;38;2017-09-19 00:00;26;172;226;398
2017;September;38;2017-09-19 00:00;27;189;197;386
2017;September;38;2017-09-19 00:00;28;154;181;335
2017;September;38;2017-09-19 00:00;29;176;186;362
2017;September;38;2017-09-19 00:00;30;178;186;364
2017;September;38;2017-09-19 00:00;31;164;179;343
2017;September;38;2017-09-19 00:00;32;183;195;378
2017;September;38;2017-09-19 00:00;33;187;177;364
2017;September;38;2017-09-19 00:00;34;209;175;384
2017;September;38;2017-09-19 00:00;35;202;190;392
2017;September;38;2017-09-19 00:00;36;168;180;348
2017;September;38;2017-09-19 00:00;37;229;195;424
2017;September;38;2017-09-19 00:00;38;210;171;381
2017;September;38;2017-09-19 00:00;39;186;205;391
2017;September;38;2017-09-19 00:00;40;189;204;393
2017;September;38;2017-09-19 00:00;41;215;216;431
2017;September;38;2017-09-19 00:00;42;221;243;464
2017;September;38;2017-09-19 00:00;43;225;275;500
2017;September;38;2017-09-19 00:00;44;210;218;428
2017;September;38;2017-09-19 00:00;45;223;251;474
2017;September;38;2017-09-19 00:00;46;212;212;424
2017;September;38;2017-09-19 00:00;47;211;222;433
2017;September;38;2017-09-19 00:00;48;202;199;401
2017;September;38;2017-09-19 00:00;49;210;221;431
2017;September;38;2017-09-19 00:00;50;236;227;463
2017;September;38;2017-09-19 00:00;51;189;223;412
2017;September;38;2017-09-19 00:00;52;199;222;421
2017;September;38;2017-09-19 00:00;53;188;222;410
2017;September;38;2017-09-19 00:00;54;178;218;396
2017;September;38;2017-09-19 00:00;55;185;187;372
2017;September;38;2017-09-19 00:00;56;151;167;318
2017;September;38;2017-09-19 00:00;57;154;152;306
2017;September;38;2017-09-19 00:00;58;157;170;327
2017;September;38;2017-09-19 00:00;59;155;155;310
2017;September;38;2017-09-19 00:00;60;150;157;307
2017;September;38;2017-09-19 00:00;61;147;154;301
2017;September;38;2017-09-19 00:00;62;136;127;263
2017;September;38;2017-09-19 00:00;63;134;139;273
2017;September;38;2017-09-19 00:00;64;143;138;281
2017;September;38;2017-09-19 00:00;65;141;155;296
2017;September;38;2017-09-19 00:00;66;145;139;284
2017;September;38;2017-09-19 00:00;67;145;156;301
2017;September;38;2017-09-19 00:00;68;149;161;310
2017;September;38;2017-09-19 00:00;69;175;166;341
2017;September;38;2017-09-19 00:00;70;162;160;322
2017;September;38;2017-09-19 00:00;71;181;152;333
2017;September;38;2017-09-19 00:00;72;182;173;355
2017;September;38;2017-09-19 00:00;73;153;162;315
2017;September;38;2017-09-19 00:00;74;153;167;320
2017;September;38;2017-09-19 00:00;75;139;136;275
2017;September;38;2017-09-19 00:00;76;112;104;216
2017;September;38;2017-09-19 00:00;77;83;125;208
2017;September;38;2017-09-19 00:00;78;87;92;179
2017;September;38;2017-09-19 00:00;79;98;78;176
2017;September;38;2017-09-19 00:00;80;80;75;155
2017;September;38;2017-09-19 00:00;81;89;67;156
2017;September;38;2017-09-19 00:00;82;63;64;127
2017;September;38;2017-09-19 00:00;83;74;46;120
2017;September;38;2017-09-19 00:00;84;58;48;106
2017;September;38;2017-09-19 00:00;85;34;39;73
2017;September;38;2017-09-19 00:00;86;46;31;77
2017;September;38;2017-09-19 00:00;87;47;29;76
2017;September;38;2017-09-19 00:00;88;35;25;60
2017;September;38;2017-09-19 00:00;89;30;19;49
2017;September;38;2017-09-19 00:00;90;31;11;42
2017;September;38;2017-09-19 00:00;91;23;11;34
2017;September;38;2017-09-19 00:00;92;20;8;28
2017;September;38;2017-09-19 00:00;93;12;9;21
2017;September;38;2017-09-19 00:00;94;12;7;19
2017;September;38;2017-09-19 00:00;95;14;3;17
2017;September;38;2017-09-19 00:00;96;6;4;10
2017;September;38;2017-09-19 00:00;97;4;2;6
2017;September;38;2017-09-19 00:00;98;0;1;1
2017;September;38;2017-09-19 00:00;99;2;1;3
2017;September;38;2017-09-19 00:00;105;1;0;1
2017;September;39;2017-09-26 00:00;0;135;133;268
2017;September;39;2017-09-26 00:00;1;167;193;360
2017;September;39;2017-09-26 00:00;2;180;200;380
2017;September;39;2017-09-26 00:00;3;180;215;395
2017;September;39;2017-09-26 00:00;4;195;216;411
2017;September;39;2017-09-26 00:00;5;189;196;385
2017;September;39;2017-09-26 00:00;6;216;231;447
2017;September;39;2017-09-26 00:00;7;215;235;450
2017;September;39;2017-09-26 00:00;8;203;210;413
2017;September;39;2017-09-26 00:00;9;195;197;392
2017;September;39;2017-09-26 00:00;10;184;202;386
2017;September;39;2017-09-26 00:00;11;225;198;423
2017;September;39;2017-09-26 00:00;12;184;211;395
2017;September;39;2017-09-26 00:00;13;185;200;385
2017;September;39;2017-09-26 00:00;14;177;186;363
2017;September;39;2017-09-26 00:00;15;173;220;393
2017;September;39;2017-09-26 00:00;16;142;186;328
2017;September;39;2017-09-26 00:00;17;178;200;378
2017;September;39;2017-09-26 00:00;18;175;187;362
2017;September;39;2017-09-26 00:00;19;157;175;332
2017;September;39;2017-09-26 00:00;20;158;193;351
2017;September;39;2017-09-26 00:00;21;160;171;331
2017;September;39;2017-09-26 00:00;22;143;181;324
2017;September;39;2017-09-26 00:00;23;157;179;336
2017;September;39;2017-09-26 00:00;24;179;195;374
2017;September;39;2017-09-26 00:00;25;169;190;359
2017;September;39;2017-09-26 00:00;26;173;226;399
2017;September;39;2017-09-26 00:00;27;188;197;385
2017;September;39;2017-09-26 00:00;28;153;183;336
2017;September;39;2017-09-26 00:00;29;176;184;360
2017;September;39;2017-09-26 00:00;30;179;184;363
2017;September;39;2017-09-26 00:00;31;166;180;346
2017;September;39;2017-09-26 00:00;32;184;195;379
2017;September;39;2017-09-26 00:00;33;188;177;365
2017;September;39;2017-09-26 00:00;34;209;175;384
2017;September;39;2017-09-26 00:00;35;202;192;394
2017;September;39;2017-09-26 00:00;36;167;180;347
2017;September;39;2017-09-26 00:00;37;228;195;423
2017;September;39;2017-09-26 00:00;38;210;172;382
2017;September;39;2017-09-26 00:00;39;187;206;393
2017;September;39;2017-09-26 00:00;40;189;204;393
2017;September;39;2017-09-26 00:00;41;216;217;433
2017;September;39;2017-09-26 00:00;42;221;243;464
2017;September;39;2017-09-26 00:00;43;225;276;501
2017;September;39;2017-09-26 00:00;44;210;218;428
2017;September;39;2017-09-26 00:00;45;223;250;473
2017;September;39;2017-09-26 00:00;46;213;212;425
2017;September;39;2017-09-26 00:00;47;212;223;435
2017;September;39;2017-09-26 00:00;48;200;199;399
2017;September;39;2017-09-26 00:00;49;209;221;430
2017;September;39;2017-09-26 00:00;50;236;227;463
2017;September;39;2017-09-26 00:00;51;189;223;412
2017;September;39;2017-09-26 00:00;52;199;221;420
2017;September;39;2017-09-26 00:00;53;188;222;410
2017;September;39;2017-09-26 00:00;54;178;218;396
2017;September;39;2017-09-26 00:00;55;186;187;373
2017;September;39;2017-09-26 00:00;56;151;167;318
2017;September;39;2017-09-26 00:00;57;154;152;306
2017;September;39;2017-09-26 00:00;58;155;169;324
2017;September;39;2017-09-26 00:00;59;155;155;310
2017;September;39;2017-09-26 00:00;60;150;157;307
2017;September;39;2017-09-26 00:00;61;148;154;302
2017;September;39;2017-09-26 00:00;62;136;127;263
2017;September;39;2017-09-26 00:00;63;134;138;272
2017;September;39;2017-09-26 00:00;64;143;138;281
2017;September;39;2017-09-26 00:00;65;141;155;296
2017;September;39;2017-09-26 00:00;66;145;139;284
2017;September;39;2017-09-26 00:00;67;145;156;301
2017;September;39;2017-09-26 00:00;68;149;161;310
2017;September;39;2017-09-26 00:00;69;175;166;341
2017;September;39;2017-09-26 00:00;70;162;160;322
2017;September;39;2017-09-26 00:00;71;181;152;333
2017;September;39;2017-09-26 00:00;72;181;172;353
2017;September;39;2017-09-26 00:00;73;153;162;315
2017;September;39;2017-09-26 00:00;74;153;167;320
2017;September;39;2017-09-26 00:00;75;139;136;275
2017;September;39;2017-09-26 00:00;76;112;104;216
2017;September;39;2017-09-26 00:00;77;83;125;208
2017;September;39;2017-09-26 00:00;78;87;92;179
2017;September;39;2017-09-26 00:00;79;97;78;175
2017;September;39;2017-09-26 00:00;80;80;75;155
2017;September;39;2017-09-26 00:00;81;89;67;156
2017;September;39;2017-09-26 00:00;82;63;64;127
2017;September;39;2017-09-26 00:00;83;74;46;120
2017;September;39;2017-09-26 00:00;84;58;48;106
2017;September;39;2017-09-26 00:00;85;34;39;73
2017;September;39;2017-09-26 00:00;86;46;31;77
2017;September;39;2017-09-26 00:00;87;47;29;76
2017;September;39;2017-09-26 00:00;88;35;25;60
2017;September;39;2017-09-26 00:00;89;30;19;49
2017;September;39;2017-09-26 00:00;90;31;11;42
2017;September;39;2017-09-26 00:00;91;23;11;34
2017;September;39;2017-09-26 00:00;92;20;8;28
2017;September;39;2017-09-26 00:00;93;12;9;21
2017;September;39;2017-09-26 00:00;94;12;6;18
2017;September;39;2017-09-26 00:00;95;14;3;17
2017;September;39;2017-09-26 00:00;96;6;4;10
2017;September;39;2017-09-26 00:00;97;4;2;6
2017;September;39;2017-09-26 00:00;98;0;1;1
2017;September;39;2017-09-26 00:00;99;2;1;3
2017;September;39;2017-09-26 00:00;105;1;0;1
2017;October;40;2017-10-03 00:00;0;136;139;275
2017;October;40;2017-10-03 00:00;1;168;194;362
2017;October;40;2017-10-03 00:00;2;181;201;382
2017;October;40;2017-10-03 00:00;3;181;220;401
2017;October;40;2017-10-03 00:00;4;195;216;411
2017;October;40;2017-10-03 00:00;5;191;197;388
2017;October;40;2017-10-03 00:00;6;217;233;450
2017;October;40;2017-10-03 00:00;7;217;235;452
2017;October;40;2017-10-03 00:00;8;203;211;414
2017;October;40;2017-10-03 00:00;9;195;197;392
2017;October;40;2017-10-03 00:00;10;184;202;386
2017;October;40;2017-10-03 00:00;11;225;198;423
2017;October;40;2017-10-03 00:00;12;184;212;396
2017;October;40;2017-10-03 00:00;13;185;201;386
2017;October;40;2017-10-03 00:00;14;177;186;363
2017;October;40;2017-10-03 00:00;15;173;220;393
2017;October;40;2017-10-03 00:00;16;141;187;328
2017;October;40;2017-10-03 00:00;17;178;201;379
2017;October;40;2017-10-03 00:00;18;175;187;362
2017;October;40;2017-10-03 00:00;19;155;174;329
2017;October;40;2017-10-03 00:00;20;156;194;350
2017;October;40;2017-10-03 00:00;21;156;168;324
2017;October;40;2017-10-03 00:00;22;144;181;325
2017;October;40;2017-10-03 00:00;23;157;179;336
2017;October;40;2017-10-03 00:00;24;175;196;371
2017;October;40;2017-10-03 00:00;25;169;189;358
2017;October;40;2017-10-03 00:00;26;174;228;402
2017;October;40;2017-10-03 00:00;27;189;196;385
2017;October;40;2017-10-03 00:00;28;156;184;340
2017;October;40;2017-10-03 00:00;29;175;180;355
2017;October;40;2017-10-03 00:00;30;178;185;363
2017;October;40;2017-10-03 00:00;31;167;181;348
2017;October;40;2017-10-03 00:00;32;186;196;382
2017;October;40;2017-10-03 00:00;33;189;179;368
2017;October;40;2017-10-03 00:00;34;210;179;389
2017;October;40;2017-10-03 00:00;35;202;193;395
2017;October;40;2017-10-03 00:00;36;168;182;350
2017;October;40;2017-10-03 00:00;37;230;195;425
2017;October;40;2017-10-03 00:00;38;210;172;382
2017;October;40;2017-10-03 00:00;39;187;206;393
2017;October;40;2017-10-03 00:00;40;190;204;394
2017;October;40;2017-10-03 00:00;41;217;217;434
2017;October;40;2017-10-03 00:00;42;221;245;466
2017;October;40;2017-10-03 00:00;43;226;279;505
2017;October;40;2017-10-03 00:00;44;210;218;428
2017;October;40;2017-10-03 00:00;45;223;250;473
2017;October;40;2017-10-03 00:00;46;213;213;426
2017;October;40;2017-10-03 00:00;47;212;222;434
2017;October;40;2017-10-03 00:00;48;200;199;399
2017;October;40;2017-10-03 00:00;49;210;221;431
2017;October;40;2017-10-03 00:00;50;236;228;464
2017;October;40;2017-10-03 00:00;51;187;223;410
2017;October;40;2017-10-03 00:00;52;199;222;421
2017;October;40;2017-10-03 00:00;53;188;222;410
2017;October;40;2017-10-03 00:00;54;179;218;397
2017;October;40;2017-10-03 00:00;55;186;187;373
2017;October;40;2017-10-03 00:00;56;151;167;318
2017;October;40;2017-10-03 00:00;57;153;152;305
2017;October;40;2017-10-03 00:00;58;155;168;323
2017;October;40;2017-10-03 00:00;59;155;153;308
2017;October;40;2017-10-03 00:00;60;148;157;305
2017;October;40;2017-10-03 00:00;61;148;154;302
2017;October;40;2017-10-03 00:00;62;136;126;262
2017;October;40;2017-10-03 00:00;63;134;138;272
2017;October;40;2017-10-03 00:00;64;144;138;282
2017;October;40;2017-10-03 00:00;65;141;155;296
2017;October;40;2017-10-03 00:00;66;146;138;284
2017;October;40;2017-10-03 00:00;67;145;156;301
2017;October;40;2017-10-03 00:00;68;149;161;310
2017;October;40;2017-10-03 00:00;69;175;165;340
2017;October;40;2017-10-03 00:00;70;162;160;322
2017;October;40;2017-10-03 00:00;71;182;152;334
2017;October;40;2017-10-03 00:00;72;181;172;353
2017;October;40;2017-10-03 00:00;73;153;162;315
2017;October;40;2017-10-03 00:00;74;153;167;320
2017;October;40;2017-10-03 00:00;75;140;136;276
2017;October;40;2017-10-03 00:00;76;112;104;216
2017;October;40;2017-10-03 00:00;77;83;125;208
2017;October;40;2017-10-03 00:00;78;88;93;181
2017;October;40;2017-10-03 00:00;79;97;78;175
2017;October;40;2017-10-03 00:00;80;80;75;155
2017;October;40;2017-10-03 00:00;81;89;67;156
2017;October;40;2017-10-03 00:00;82;63;63;126
2017;October;40;2017-10-03 00:00;83;73;46;119
2017;October;40;2017-10-03 00:00;84;58;47;105
2017;October;40;2017-10-03 00:00;85;34;40;74
2017;October;40;2017-10-03 00:00;86;46;31;77
2017;October;40;2017-10-03 00:00;87;47;29;76
2017;October;40;2017-10-03 00:00;88;35;25;60
2017;October;40;2017-10-03 00:00;89;30;19;49
2017;October;40;2017-10-03 00:00;90;31;11;42
2017;October;40;2017-10-03 00:00;91;23;11;34
2017;October;40;2017-10-03 00:00;92;20;8;28
2017;October;40;2017-10-03 00:00;93;12;9;21
2017;October;40;2017-10-03 00:00;94;12;6;18
2017;October;40;2017-10-03 00:00;95;13;3;16
2017;October;40;2017-10-03 00:00;96;5;4;9
2017;October;40;2017-10-03 00:00;97;4;2;6
2017;October;40;2017-10-03 00:00;98;0;1;1
2017;October;40;2017-10-03 00:00;99;2;1;3
2017;October;40;2017-10-03 00:00;105;1;0;1
2017;October;41;2017-10-10 00:00;0;143;141;284
2017;October;41;2017-10-10 00:00;1;169;194;363
2017;October;41;2017-10-10 00:00;2;181;201;382
2017;October;41;2017-10-10 00:00;3;181;220;401
2017;October;41;2017-10-10 00:00;4;196;216;412
2017;October;41;2017-10-10 00:00;5;191;198;389
2017;October;41;2017-10-10 00:00;6;217;234;451
2017;October;41;2017-10-10 00:00;7;217;234;451
2017;October;41;2017-10-10 00:00;8;203;211;414
2017;October;41;2017-10-10 00:00;9;195;197;392
2017;October;41;2017-10-10 00:00;10;184;202;386
2017;October;41;2017-10-10 00:00;11;225;198;423
2017;October;41;2017-10-10 00:00;12;184;213;397
2017;October;41;2017-10-10 00:00;13;185;202;387
2017;October;41;2017-10-10 00:00;14;177;186;363
2017;October;41;2017-10-10 00:00;15;173;220;393
2017;October;41;2017-10-10 00:00;16;142;187;329
2017;October;41;2017-10-10 00:00;17;178;202;380
2017;October;41;2017-10-10 00:00;18;175;187;362
2017;October;41;2017-10-10 00:00;19;155;174;329
2017;October;41;2017-10-10 00:00;20;153;195;348
2017;October;41;2017-10-10 00:00;21;156;168;324
2017;October;41;2017-10-10 00:00;22;144;183;327
2017;October;41;2017-10-10 00:00;23;159;178;337
2017;October;41;2017-10-10 00:00;24;174;198;372
2017;October;41;2017-10-10 00:00;25;171;189;360
2017;October;41;2017-10-10 00:00;26;173;228;401
2017;October;41;2017-10-10 00:00;27;188;195;383
2017;October;41;2017-10-10 00:00;28;157;185;342
2017;October;41;2017-10-10 00:00;29;178;179;357
2017;October;41;2017-10-10 00:00;30;178;187;365
2017;October;41;2017-10-10 00:00;31;167;183;350
2017;October;41;2017-10-10 00:00;32;187;196;383
2017;October;41;2017-10-10 00:00;33;188;180;368
2017;October;41;2017-10-10 00:00;34;210;179;389
2017;October;41;2017-10-10 00:00;35;202;193;395
2017;October;41;2017-10-10 00:00;36;168;182;350
2017;October;41;2017-10-10 00:00;37;231;195;426
2017;October;41;2017-10-10 00:00;38;210;174;384
2017;October;41;2017-10-10 00:00;39;187;206;393
2017;October;41;2017-10-10 00:00;40;190;204;394
2017;October;41;2017-10-10 00:00;41;217;216;433
2017;October;41;2017-10-10 00:00;42;221;245;466
2017;October;41;2017-10-10 00:00;43;226;279;505
2017;October;41;2017-10-10 00:00;44;210;219;429
2017;October;41;2017-10-10 00:00;45;223;250;473
2017;October;41;2017-10-10 00:00;46;214;213;427
2017;October;41;2017-10-10 00:00;47;212;222;434
2017;October;41;2017-10-10 00:00;48;200;199;399
2017;October;41;2017-10-10 00:00;49;210;221;431
2017;October;41;2017-10-10 00:00;50;236;228;464
2017;October;41;2017-10-10 00:00;51;187;223;410
2017;October;41;2017-10-10 00:00;52;199;222;421
2017;October;41;2017-10-10 00:00;53;188;222;410
2017;October;41;2017-10-10 00:00;54;179;218;397
2017;October;41;2017-10-10 00:00;55;186;188;374
2017;October;41;2017-10-10 00:00;56;151;167;318
2017;October;41;2017-10-10 00:00;57;154;152;306
2017;October;41;2017-10-10 00:00;58;155;168;323
2017;October;41;2017-10-10 00:00;59;155;153;308
2017;October;41;2017-10-10 00:00;60;148;157;305
2017;October;41;2017-10-10 00:00;61;148;154;302
2017;October;41;2017-10-10 00:00;62;136;126;262
2017;October;41;2017-10-10 00:00;63;134;138;272
2017;October;41;2017-10-10 00:00;64;144;138;282
2017;October;41;2017-10-10 00:00;65;141;155;296
2017;October;41;2017-10-10 00:00;66;146;138;284
2017;October;41;2017-10-10 00:00;67;145;156;301
2017;October;41;2017-10-10 00:00;68;149;161;310
2017;October;41;2017-10-10 00:00;69;176;165;341
2017;October;41;2017-10-10 00:00;70;162;160;322
2017;October;41;2017-10-10 00:00;71;183;153;336
2017;October;41;2017-10-10 00:00;72;181;172;353
2017;October;41;2017-10-10 00:00;73;153;161;314
2017;October;41;2017-10-10 00:00;74;153;167;320
2017;October;41;2017-10-10 00:00;75;140;136;276
2017;October;41;2017-10-10 00:00;76;112;104;216
2017;October;41;2017-10-10 00:00;77;83;125;208
2017;October;41;2017-10-10 00:00;78;88;92;180
2017;October;41;2017-10-10 00:00;79;97;78;175
2017;October;41;2017-10-10 00:00;80;79;75;154
2017;October;41;2017-10-10 00:00;81;89;67;156
2017;October;41;2017-10-10 00:00;82;63;63;126
2017;October;41;2017-10-10 00:00;83;73;47;120
2017;October;41;2017-10-10 00:00;84;58;47;105
2017;October;41;2017-10-10 00:00;85;34;40;74
2017;October;41;2017-10-10 00:00;86;46;31;77
2017;October;41;2017-10-10 00:00;87;47;29;76
2017;October;41;2017-10-10 00:00;88;35;25;60
2017;October;41;2017-10-10 00:00;89;30;17;47
2017;October;41;2017-10-10 00:00;90;31;11;42
2017;October;41;2017-10-10 00:00;91;24;11;35
2017;October;41;2017-10-10 00:00;92;20;8;28
2017;October;41;2017-10-10 00:00;93;12;9;21
2017;October;41;2017-10-10 00:00;94;12;6;18
2017;October;41;2017-10-10 00:00;95;13;3;16
2017;October;41;2017-10-10 00:00;96;5;4;9
2017;October;41;2017-10-10 00:00;97;4;2;6
2017;October;41;2017-10-10 00:00;98;0;1;1
2017;October;41;2017-10-10 00:00;99;2;1;3
2017;October;41;2017-10-10 00:00;105;1;0;1
2017;October;43;2017-10-24 00:00;0;150;149;299
2017;October;43;2017-10-24 00:00;1;169;193;362
2017;October;43;2017-10-24 00:00;2;181;201;382
2017;October;43;2017-10-24 00:00;3;181;220;401
2017;October;43;2017-10-24 00:00;4;198;216;414
2017;October;43;2017-10-24 00:00;5;191;199;390
2017;October;43;2017-10-24 00:00;6;218;234;452
2017;October;43;2017-10-24 00:00;7;217;233;450
2017;October;43;2017-10-24 00:00;8;203;212;415
2017;October;43;2017-10-24 00:00;9;195;197;392
2017;October;43;2017-10-24 00:00;10;185;202;387
2017;October;43;2017-10-24 00:00;11;226;198;424
2017;October;43;2017-10-24 00:00;12;183;212;395
2017;October;43;2017-10-24 00:00;13;185;202;387
2017;October;43;2017-10-24 00:00;14;179;187;366
2017;October;43;2017-10-24 00:00;15;173;220;393
2017;October;43;2017-10-24 00:00;16;142;187;329
2017;October;43;2017-10-24 00:00;17;179;200;379
2017;October;43;2017-10-24 00:00;18;175;187;362
2017;October;43;2017-10-24 00:00;19;156;174;330
2017;October;43;2017-10-24 00:00;20;151;191;342
2017;October;43;2017-10-24 00:00;21;155;168;323
2017;October;43;2017-10-24 00:00;22;144;182;326
2017;October;43;2017-10-24 00:00;23;159;178;337
2017;October;43;2017-10-24 00:00;24;176;198;374
2017;October;43;2017-10-24 00:00;25;172;190;362
2017;October;43;2017-10-24 00:00;26;174;227;401
2017;October;43;2017-10-24 00:00;27;186;192;378
2017;October;43;2017-10-24 00:00;28;159;190;349
2017;October;43;2017-10-24 00:00;29;178;179;357
2017;October;43;2017-10-24 00:00;30;179;186;365
2017;October;43;2017-10-24 00:00;31;169;185;354
2017;October;43;2017-10-24 00:00;32;186;196;382
2017;October;43;2017-10-24 00:00;33;187;180;367
2017;October;43;2017-10-24 00:00;34;212;178;390
2017;October;43;2017-10-24 00:00;35;202;195;397
2017;October;43;2017-10-24 00:00;36;167;182;349
2017;October;43;2017-10-24 00:00;37;231;195;426
2017;October;43;2017-10-24 00:00;38;209;173;382
2017;October;43;2017-10-24 00:00;39;188;206;394
2017;October;43;2017-10-24 00:00;40;190;205;395
2017;October;43;2017-10-24 00:00;41;217;215;432
2017;October;43;2017-10-24 00:00;42;221;245;466
2017;October;43;2017-10-24 00:00;43;226;279;505
2017;October;43;2017-10-24 00:00;44;210;219;429
2017;October;43;2017-10-24 00:00;45;222;249;471
2017;October;43;2017-10-24 00:00;46;214;213;427
2017;October;43;2017-10-24 00:00;47;212;221;433
2017;October;43;2017-10-24 00:00;48;200;199;399
2017;October;43;2017-10-24 00:00;49;210;221;431
2017;October;43;2017-10-24 00:00;50;236;228;464
2017;October;43;2017-10-24 00:00;51;188;223;411
2017;October;43;2017-10-24 00:00;52;199;222;421
2017;October;43;2017-10-24 00:00;53;188;222;410
2017;October;43;2017-10-24 00:00;54;180;219;399
2017;October;43;2017-10-24 00:00;55;186;188;374
2017;October;43;2017-10-24 00:00;56;151;167;318
2017;October;43;2017-10-24 00:00;57;154;152;306
2017;October;43;2017-10-24 00:00;58;155;168;323
2017;October;43;2017-10-24 00:00;59;155;153;308
2017;October;43;2017-10-24 00:00;60;148;157;305
2017;October;43;2017-10-24 00:00;61;148;155;303
2017;October;43;2017-10-24 00:00;62;136;126;262
2017;October;43;2017-10-24 00:00;63;134;138;272
2017;October;43;2017-10-24 00:00;64;144;138;282
2017;October;43;2017-10-24 00:00;65;142;155;297
2017;October;43;2017-10-24 00:00;66;146;138;284
2017;October;43;2017-10-24 00:00;67;144;157;301
2017;October;43;2017-10-24 00:00;68;148;160;308
2017;October;43;2017-10-24 00:00;69;176;165;341
2017;October;43;2017-10-24 00:00;70;162;159;321
2017;October;43;2017-10-24 00:00;71;183;153;336
2017;October;43;2017-10-24 00:00;72;181;172;353
2017;October;43;2017-10-24 00:00;73;152;161;313
2017;October;43;2017-10-24 00:00;74;153;166;319
2017;October;43;2017-10-24 00:00;75;139;136;275
2017;October;43;2017-10-24 00:00;76;112;104;216
2017;October;43;2017-10-24 00:00;77;83;125;208
2017;October;43;2017-10-24 00:00;78;88;92;180
2017;October;43;2017-10-24 00:00;79;97;78;175
2017;October;43;2017-10-24 00:00;80;79;74;153
2017;October;43;2017-10-24 00:00;81;89;67;156
2017;October;43;2017-10-24 00:00;82;63;63;126
2017;October;43;2017-10-24 00:00;83;72;47;119
2017;October;43;2017-10-24 00:00;84;58;47;105
2017;October;43;2017-10-24 00:00;85;34;40;74
2017;October;43;2017-10-24 00:00;86;46;31;77
2017;October;43;2017-10-24 00:00;87;46;29;75
2017;October;43;2017-10-24 00:00;88;35;24;59
2017;October;43;2017-10-24 00:00;89;30;16;46
2017;October;43;2017-10-24 00:00;90;31;11;42
2017;October;43;2017-10-24 00:00;91;24;11;35
2017;October;43;2017-10-24 00:00;92;20;8;28
2017;October;43;2017-10-24 00:00;93;12;9;21
2017;October;43;2017-10-24 00:00;94;12;6;18
2017;October;43;2017-10-24 00:00;95;13;3;16
2017;October;43;2017-10-24 00:00;96;5;4;9
2017;October;43;2017-10-24 00:00;97;4;2;6
2017;October;43;2017-10-24 00:00;98;0;1;1
2017;October;43;2017-10-24 00:00;99;2;1;3
2017;October;43;2017-10-24 00:00;105;1;0;1
2017;November;45;2017-11-07 00:00;0;157;152;309
2017;November;45;2017-11-07 00:00;1;170;192;362
2017;November;45;2017-11-07 00:00;2;183;199;382
2017;November;45;2017-11-07 00:00;3;183;221;404
2017;November;45;2017-11-07 00:00;4;200;216;416
2017;November;45;2017-11-07 00:00;5;192;200;392
2017;November;45;2017-11-07 00:00;6;220;235;455
2017;November;45;2017-11-07 00:00;7;218;233;451
2017;November;45;2017-11-07 00:00;8;204;214;418
2017;November;45;2017-11-07 00:00;9;197;197;394
2017;November;45;2017-11-07 00:00;10;186;203;389
2017;November;45;2017-11-07 00:00;11;226;198;424
2017;November;45;2017-11-07 00:00;12;183;212;395
2017;November;45;2017-11-07 00:00;13;186;202;388
2017;November;45;2017-11-07 00:00;14;179;188;367
2017;November;45;2017-11-07 00:00;15;174;220;394
2017;November;45;2017-11-07 00:00;16;142;185;327
2017;November;45;2017-11-07 00:00;17;180;200;380
2017;November;45;2017-11-07 00:00;18;176;187;363
2017;November;45;2017-11-07 00:00;19;154;169;323
2017;November;45;2017-11-07 00:00;20;146;188;334
2017;November;45;2017-11-07 00:00;21;155;167;322
2017;November;45;2017-11-07 00:00;22;141;181;322
2017;November;45;2017-11-07 00:00;23;159;178;337
2017;November;45;2017-11-07 00:00;24;177;198;375
2017;November;45;2017-11-07 00:00;25;171;189;360
2017;November;45;2017-11-07 00:00;26;173;228;401
2017;November;45;2017-11-07 00:00;27;191;192;383
2017;November;45;2017-11-07 00:00;28;157;189;346
2017;November;45;2017-11-07 00:00;29;179;180;359
2017;November;45;2017-11-07 00:00;30;181;188;369
2017;November;45;2017-11-07 00:00;31;171;187;358
2017;November;45;2017-11-07 00:00;32;190;192;382
2017;November;45;2017-11-07 00:00;33;187;186;373
2017;November;45;2017-11-07 00:00;34;212;180;392
2017;November;45;2017-11-07 00:00;35;203;195;398
2017;November;45;2017-11-07 00:00;36;169;184;353
2017;November;45;2017-11-07 00:00;37;232;195;427
2017;November;45;2017-11-07 00:00;38;208;174;382
2017;November;45;2017-11-07 00:00;39;186;207;393
2017;November;45;2017-11-07 00:00;40;191;205;396
2017;November;45;2017-11-07 00:00;41;218;215;433
2017;November;45;2017-11-07 00:00;42;221;244;465
2017;November;45;2017-11-07 00:00;43;226;278;504
2017;November;45;2017-11-07 00:00;44;210;220;430
2017;November;45;2017-11-07 00:00;45;222;251;473
2017;November;45;2017-11-07 00:00;46;214;213;427
2017;November;45;2017-11-07 00:00;47;213;222;435
2017;November;45;2017-11-07 00:00;48;199;200;399
2017;November;45;2017-11-07 00:00;49;210;221;431
2017;November;45;2017-11-07 00:00;50;236;228;464
2017;November;45;2017-11-07 00:00;51;188;223;411
2017;November;45;2017-11-07 00:00;52;199;221;420
2017;November;45;2017-11-07 00:00;53;188;222;410
2017;November;45;2017-11-07 00:00;54;181;219;400
2017;November;45;2017-11-07 00:00;55;187;187;374
2017;November;45;2017-11-07 00:00;56;151;168;319
2017;November;45;2017-11-07 00:00;57;154;152;306
2017;November;45;2017-11-07 00:00;58;156;168;324
2017;November;45;2017-11-07 00:00;59;155;152;307
2017;November;45;2017-11-07 00:00;60;149;157;306
2017;November;45;2017-11-07 00:00;61;149;155;304
2017;November;45;2017-11-07 00:00;62;136;126;262
2017;November;45;2017-11-07 00:00;63;134;137;271
2017;November;45;2017-11-07 00:00;64;144;137;281
2017;November;45;2017-11-07 00:00;65;141;155;296
2017;November;45;2017-11-07 00:00;66;146;138;284
2017;November;45;2017-11-07 00:00;67;144;157;301
2017;November;45;2017-11-07 00:00;68;147;160;307
2017;November;45;2017-11-07 00:00;69;176;165;341
2017;November;45;2017-11-07 00:00;70;162;157;319
2017;November;45;2017-11-07 00:00;71;183;151;334
2017;November;45;2017-11-07 00:00;72;181;172;353
2017;November;45;2017-11-07 00:00;73;152;161;313
2017;November;45;2017-11-07 00:00;74;153;166;319
2017;November;45;2017-11-07 00:00;75;139;136;275
2017;November;45;2017-11-07 00:00;76;111;104;215
2017;November;45;2017-11-07 00:00;77;83;125;208
2017;November;45;2017-11-07 00:00;78;88;92;180
2017;November;45;2017-11-07 00:00;79;97;78;175
2017;November;45;2017-11-07 00:00;80;79;74;153
2017;November;45;2017-11-07 00:00;81;89;66;155
2017;November;45;2017-11-07 00:00;82;63;63;126
2017;November;45;2017-11-07 00:00;83;72;47;119
2017;November;45;2017-11-07 00:00;84;57;47;104
2017;November;45;2017-11-07 00:00;85;34;39;73
2017;November;45;2017-11-07 00:00;86;46;31;77
2017;November;45;2017-11-07 00:00;87;46;28;74
2017;November;45;2017-11-07 00:00;88;35;24;59
2017;November;45;2017-11-07 00:00;89;29;16;45
2017;November;45;2017-11-07 00:00;90;30;11;41
2017;November;45;2017-11-07 00:00;91;24;11;35
2017;November;45;2017-11-07 00:00;92;20;8;28
2017;November;45;2017-11-07 00:00;93;11;8;19
2017;November;45;2017-11-07 00:00;94;12;6;18
2017;November;45;2017-11-07 00:00;95;13;3;16
2017;November;45;2017-11-07 00:00;96;5;4;9
2017;November;45;2017-11-07 00:00;97;4;2;6
2017;November;45;2017-11-07 00:00;98;0;1;1
2017;November;45;2017-11-07 00:00;99;2;1;3
2017;November;45;2017-11-07 00:00;105;1;0;1
2017;November;46;2017-11-14 00:00;0;159;159;318
2017;November;46;2017-11-14 00:00;1;170;192;362
2017;November;46;2017-11-14 00:00;2;183;200;383
2017;November;46;2017-11-14 00:00;3;183;222;405
2017;November;46;2017-11-14 00:00;4;200;217;417
2017;November;46;2017-11-14 00:00;5;192;201;393
2017;November;46;2017-11-14 00:00;6;221;236;457
2017;November;46;2017-11-14 00:00;7;218;233;451
2017;November;46;2017-11-14 00:00;8;204;214;418
2017;November;46;2017-11-14 00:00;9;198;197;395
2017;November;46;2017-11-14 00:00;10;186;203;389
2017;November;46;2017-11-14 00:00;11;226;198;424
2017;November;46;2017-11-14 00:00;12;183;212;395
2017;November;46;2017-11-14 00:00;13;187;202;389
2017;November;46;2017-11-14 00:00;14;178;188;366
2017;November;46;2017-11-14 00:00;15;174;220;394
2017;November;46;2017-11-14 00:00;16;142;185;327
2017;November;46;2017-11-14 00:00;17;180;200;380
2017;November;46;2017-11-14 00:00;18;176;187;363
2017;November;46;2017-11-14 00:00;19;154;169;323
2017;November;46;2017-11-14 00:00;20;146;188;334
2017;November;46;2017-11-14 00:00;21;155;167;322
2017;November;46;2017-11-14 00:00;22;142;180;322
2017;November;46;2017-11-14 00:00;23;160;178;338
2017;November;46;2017-11-14 00:00;24;179;198;377
2017;November;46;2017-11-14 00:00;25;173;188;361
2017;November;46;2017-11-14 00:00;26;174;227;401
2017;November;46;2017-11-14 00:00;27;193;194;387
2017;November;46;2017-11-14 00:00;28;159;190;349
2017;November;46;2017-11-14 00:00;29;178;181;359
2017;November;46;2017-11-14 00:00;30;182;189;371
2017;November;46;2017-11-14 00:00;31;172;188;360
2017;November;46;2017-11-14 00:00;32;190;194;384
2017;November;46;2017-11-14 00:00;33;188;188;376
2017;November;46;2017-11-14 00:00;34;212;181;393
2017;November;46;2017-11-14 00:00;35;203;196;399
2017;November;46;2017-11-14 00:00;36;169;184;353
2017;November;46;2017-11-14 00:00;37;232;195;427
2017;November;46;2017-11-14 00:00;38;209;174;383
2017;November;46;2017-11-14 00:00;39;186;207;393
2017;November;46;2017-11-14 00:00;40;192;205;397
2017;November;46;2017-11-14 00:00;41;219;215;434
2017;November;46;2017-11-14 00:00;42;221;244;465
2017;November;46;2017-11-14 00:00;43;227;277;504
2017;November;46;2017-11-14 00:00;44;210;220;430
2017;November;46;2017-11-14 00:00;45;222;251;473
2017;November;46;2017-11-14 00:00;46;214;213;427
2017;November;46;2017-11-14 00:00;47;213;222;435
2017;November;46;2017-11-14 00:00;48;199;199;398
2017;November;46;2017-11-14 00:00;49;210;221;431
2017;November;46;2017-11-14 00:00;50;235;228;463
2017;November;46;2017-11-14 00:00;51;188;223;411
2017;November;46;2017-11-14 00:00;52;198;221;419
2017;November;46;2017-11-14 00:00;53;187;221;408
2017;November;46;2017-11-14 00:00;54;181;219;400
2017;November;46;2017-11-14 00:00;55;187;188;375
2017;November;46;2017-11-14 00:00;56;151;168;319
2017;November;46;2017-11-14 00:00;57;154;151;305
2017;November;46;2017-11-14 00:00;58;156;168;324
2017;November;46;2017-11-14 00:00;59;155;152;307
2017;November;46;2017-11-14 00:00;60;149;158;307
2017;November;46;2017-11-14 00:00;61;149;155;304
2017;November;46;2017-11-14 00:00;62;136;126;262
2017;November;46;2017-11-14 00:00;63;134;137;271
2017;November;46;2017-11-14 00:00;64;144;137;281
2017;November;46;2017-11-14 00:00;65;141;155;296
2017;November;46;2017-11-14 00:00;66;146;138;284
2017;November;46;2017-11-14 00:00;67;144;157;301
2017;November;46;2017-11-14 00:00;68;147;160;307
2017;November;46;2017-11-14 00:00;69;176;165;341
2017;November;46;2017-11-14 00:00;70;162;157;319
2017;November;46;2017-11-14 00:00;71;183;151;334
2017;November;46;2017-11-14 00:00;72;181;172;353
2017;November;46;2017-11-14 00:00;73;152;161;313
2017;November;46;2017-11-14 00:00;74;153;166;319
2017;November;46;2017-11-14 00:00;75;139;136;275
2017;November;46;2017-11-14 00:00;76;111;104;215
2017;November;46;2017-11-14 00:00;77;83;125;208
2017;November;46;2017-11-14 00:00;78;88;92;180
2017;November;46;2017-11-14 00:00;79;97;78;175
2017;November;46;2017-11-14 00:00;80;79;74;153
2017;November;46;2017-11-14 00:00;81;89;66;155
2017;November;46;2017-11-14 00:00;82;63;63;126
2017;November;46;2017-11-14 00:00;83;72;47;119
2017;November;46;2017-11-14 00:00;84;57;46;103
2017;November;46;2017-11-14 00:00;85;33;39;72
2017;November;46;2017-11-14 00:00;86;45;30;75
2017;November;46;2017-11-14 00:00;87;46;28;74
2017;November;46;2017-11-14 00:00;88;35;24;59
2017;November;46;2017-11-14 00:00;89;30;16;46
2017;November;46;2017-11-14 00:00;90;30;11;41
2017;November;46;2017-11-14 00:00;91;23;11;34
2017;November;46;2017-11-14 00:00;92;20;8;28
2017;November;46;2017-11-14 00:00;93;11;8;19
2017;November;46;2017-11-14 00:00;94;12;6;18
2017;November;46;2017-11-14 00:00;95;13;3;16
2017;November;46;2017-11-14 00:00;96;5;4;9
2017;November;46;2017-11-14 00:00;97;4;2;6
2017;November;46;2017-11-14 00:00;98;0;1;1
2017;November;46;2017-11-14 00:00;99;2;1;3
2017;November;46;2017-11-14 00:00;105;1;0;1
2017;November;47;2017-11-21 00:00;0;164;164;328
2017;November;47;2017-11-21 00:00;1;171;193;364
2017;November;47;2017-11-21 00:00;2;184;200;384
2017;November;47;2017-11-21 00:00;3;183;222;405
2017;November;47;2017-11-21 00:00;4;200;218;418
2017;November;47;2017-11-21 00:00;5;192;202;394
2017;November;47;2017-11-21 00:00;6;221;237;458
2017;November;47;2017-11-21 00:00;7;218;234;452
2017;November;47;2017-11-21 00:00;8;205;214;419
2017;November;47;2017-11-21 00:00;9;198;197;395
2017;November;47;2017-11-21 00:00;10;186;204;390
2017;November;47;2017-11-21 00:00;11;226;198;424
2017;November;47;2017-11-21 00:00;12;183;212;395
2017;November;47;2017-11-21 00:00;13;187;202;389
2017;November;47;2017-11-21 00:00;14;178;188;366
2017;November;47;2017-11-21 00:00;15;174;220;394
2017;November;47;2017-11-21 00:00;16;142;186;328
2017;November;47;2017-11-21 00:00;17;180;201;381
2017;November;47;2017-11-21 00:00;18;176;188;364
2017;November;47;2017-11-21 00:00;19;154;168;322
2017;November;47;2017-11-21 00:00;20;146;188;334
2017;November;47;2017-11-21 00:00;21;155;166;321
2017;November;47;2017-11-21 00:00;22;141;181;322
2017;November;47;2017-11-21 00:00;23;159;178;337
2017;November;47;2017-11-21 00:00;24;180;198;378
2017;November;47;2017-11-21 00:00;25;172;189;361
2017;November;47;2017-11-21 00:00;26;175;227;402
2017;November;47;2017-11-21 00:00;27;192;193;385
2017;November;47;2017-11-21 00:00;28;159;191;350
2017;November;47;2017-11-21 00:00;29;178;181;359
2017;November;47;2017-11-21 00:00;30;182;188;370
2017;November;47;2017-11-21 00:00;31;173;189;362
2017;November;47;2017-11-21 00:00;32;190;195;385
2017;November;47;2017-11-21 00:00;33;188;187;375
2017;November;47;2017-11-21 00:00;34;213;180;393
2017;November;47;2017-11-21 00:00;35;203;196;399
2017;November;47;2017-11-21 00:00;36;169;186;355
2017;November;47;2017-11-21 00:00;37;233;195;428
2017;November;47;2017-11-21 00:00;38;209;174;383
2017;November;47;2017-11-21 00:00;39;186;207;393
2017;November;47;2017-11-21 00:00;40;192;206;398
2017;November;47;2017-11-21 00:00;41;219;216;435
2017;November;47;2017-11-21 00:00;42;222;244;466
2017;November;47;2017-11-21 00:00;43;227;277;504
2017;November;47;2017-11-21 00:00;44;210;221;431
2017;November;47;2017-11-21 00:00;45;222;252;474
2017;November;47;2017-11-21 00:00;46;214;214;428
2017;November;47;2017-11-21 00:00;47;213;224;437
2017;November;47;2017-11-21 00:00;48;199;198;397
2017;November;47;2017-11-21 00:00;49;211;221;432
2017;November;47;2017-11-21 00:00;50;235;228;463
2017;November;47;2017-11-21 00:00;51;188;223;411
2017;November;47;2017-11-21 00:00;52;198;221;419
2017;November;47;2017-11-21 00:00;53;187;221;408
2017;November;47;2017-11-21 00:00;54;181;219;400
2017;November;47;2017-11-21 00:00;55;187;188;375
2017;November;47;2017-11-21 00:00;56;151;168;319
2017;November;47;2017-11-21 00:00;57;154;151;305
2017;November;47;2017-11-21 00:00;58;157;167;324
2017;November;47;2017-11-21 00:00;59;155;152;307
2017;November;47;2017-11-21 00:00;60;149;158;307
2017;November;47;2017-11-21 00:00;61;149;155;304
2017;November;47;2017-11-21 00:00;62;136;126;262
2017;November;47;2017-11-21 00:00;63;134;137;271
2017;November;47;2017-11-21 00:00;64;144;137;281
2017;November;47;2017-11-21 00:00;65;141;155;296
2017;November;47;2017-11-21 00:00;66;146;138;284
2017;November;47;2017-11-21 00:00;67;144;158;302
2017;November;47;2017-11-21 00:00;68;147;160;307
2017;November;47;2017-11-21 00:00;69;176;165;341
2017;November;47;2017-11-21 00:00;70;162;157;319
2017;November;47;2017-11-21 00:00;71;183;151;334
2017;November;47;2017-11-21 00:00;72;181;172;353
2017;November;47;2017-11-21 00:00;73;152;161;313
2017;November;47;2017-11-21 00:00;74;153;166;319
2017;November;47;2017-11-21 00:00;75;139;136;275
2017;November;47;2017-11-21 00:00;76;111;104;215
2017;November;47;2017-11-21 00:00;77;83;125;208
2017;November;47;2017-11-21 00:00;78;88;92;180
2017;November;47;2017-11-21 00:00;79;97;78;175
2017;November;47;2017-11-21 00:00;80;79;74;153
2017;November;47;2017-11-21 00:00;81;89;66;155
2017;November;47;2017-11-21 00:00;82;63;63;126
2017;November;47;2017-11-21 00:00;83;72;47;119
2017;November;47;2017-11-21 00:00;84;57;46;103
2017;November;47;2017-11-21 00:00;85;33;39;72
2017;November;47;2017-11-21 00:00;86;45;30;75
2017;November;47;2017-11-21 00:00;87;46;28;74
2017;November;47;2017-11-21 00:00;88;34;24;58
2017;November;47;2017-11-21 00:00;89;30;16;46
2017;November;47;2017-11-21 00:00;90;30;10;40
2017;November;47;2017-11-21 00:00;91;23;11;34
2017;November;47;2017-11-21 00:00;92;20;8;28
2017;November;47;2017-11-21 00:00;93;11;8;19
2017;November;47;2017-11-21 00:00;94;12;6;18
2017;November;47;2017-11-21 00:00;95;13;3;16
2017;November;47;2017-11-21 00:00;96;5;4;9
2017;November;47;2017-11-21 00:00;97;3;2;5
2017;November;47;2017-11-21 00:00;98;0;1;1
2017;November;47;2017-11-21 00:00;99;2;1;3
2017;November;47;2017-11-21 00:00;105;1;0;1
2017;November;48;2017-11-28 00:00;0;169;171;340
2017;November;48;2017-11-28 00:00;1;172;193;365
2017;November;48;2017-11-28 00:00;2;187;202;389
2017;November;48;2017-11-28 00:00;3;183;223;406
2017;November;48;2017-11-28 00:00;4;200;219;419
2017;November;48;2017-11-28 00:00;5;193;202;395
2017;November;48;2017-11-28 00:00;6;221;238;459
2017;November;48;2017-11-28 00:00;7;218;234;452
2017;November;48;2017-11-28 00:00;8;206;214;420
2017;November;48;2017-11-28 00:00;9;198;197;395
2017;November;48;2017-11-28 00:00;10;187;204;391
2017;November;48;2017-11-28 00:00;11;226;198;424
2017;November;48;2017-11-28 00:00;12;183;212;395
2017;November;48;2017-11-28 00:00;13;187;203;390
2017;November;48;2017-11-28 00:00;14;178;188;366
2017;November;48;2017-11-28 00:00;15;175;220;395
2017;November;48;2017-11-28 00:00;16;142;185;327
2017;November;48;2017-11-28 00:00;17;180;202;382
2017;November;48;2017-11-28 00:00;18;176;188;364
2017;November;48;2017-11-28 00:00;19;154;168;322
2017;November;48;2017-11-28 00:00;20;145;189;334
2017;November;48;2017-11-28 00:00;21;155;167;322
2017;November;48;2017-11-28 00:00;22;141;180;321
2017;November;48;2017-11-28 00:00;23;161;178;339
2017;November;48;2017-11-28 00:00;24;180;201;381
2017;November;48;2017-11-28 00:00;25;172;191;363
2017;November;48;2017-11-28 00:00;26;176;228;404
2017;November;48;2017-11-28 00:00;27;192;193;385
2017;November;48;2017-11-28 00:00;28;159;193;352
2017;November;48;2017-11-28 00:00;29;179;181;360
2017;November;48;2017-11-28 00:00;30;184;188;372
2017;November;48;2017-11-28 00:00;31;173;189;362
2017;November;48;2017-11-28 00:00;32;189;196;385
2017;November;48;2017-11-28 00:00;33;190;189;379
2017;November;48;2017-11-28 00:00;34;214;181;395
2017;November;48;2017-11-28 00:00;35;203;196;399
2017;November;48;2017-11-28 00:00;36;170;187;357
2017;November;48;2017-11-28 00:00;37;233;196;429
2017;November;48;2017-11-28 00:00;38;209;174;383
2017;November;48;2017-11-28 00:00;39;187;206;393
2017;November;48;2017-11-28 00:00;40;193;206;399
2017;November;48;2017-11-28 00:00;41;219;216;435
2017;November;48;2017-11-28 00:00;42;223;244;467
2017;November;48;2017-11-28 00:00;43;226;277;503
2017;November;48;2017-11-28 00:00;44;211;221;432
2017;November;48;2017-11-28 00:00;45;223;252;475
2017;November;48;2017-11-28 00:00;46;214;215;429
2017;November;48;2017-11-28 00:00;47;214;224;438
2017;November;48;2017-11-28 00:00;48;199;198;397
2017;November;48;2017-11-28 00:00;49;211;221;432
2017;November;48;2017-11-28 00:00;50;236;228;464
2017;November;48;2017-11-28 00:00;51;188;222;410
2017;November;48;2017-11-28 00:00;52;199;221;420
2017;November;48;2017-11-28 00:00;53;187;221;408
2017;November;48;2017-11-28 00:00;54;180;219;399
2017;November;48;2017-11-28 00:00;55;187;189;376
2017;November;48;2017-11-28 00:00;56;151;168;319
2017;November;48;2017-11-28 00:00;57;154;152;306
2017;November;48;2017-11-28 00:00;58;157;168;325
2017;November;48;2017-11-28 00:00;59;153;152;305
2017;November;48;2017-11-28 00:00;60;149;158;307
2017;November;48;2017-11-28 00:00;61;149;155;304
2017;November;48;2017-11-28 00:00;62;136;126;262
2017;November;48;2017-11-28 00:00;63;134;137;271
2017;November;48;2017-11-28 00:00;64;144;136;280
2017;November;48;2017-11-28 00:00;65;141;155;296
2017;November;48;2017-11-28 00:00;66;146;138;284
2017;November;48;2017-11-28 00:00;67;144;158;302
2017;November;48;2017-11-28 00:00;68;147;160;307
2017;November;48;2017-11-28 00:00;69;176;165;341
2017;November;48;2017-11-28 00:00;70;162;157;319
2017;November;48;2017-11-28 00:00;71;183;151;334
2017;November;48;2017-11-28 00:00;72;181;172;353
2017;November;48;2017-11-28 00:00;73;152;160;312
2017;November;48;2017-11-28 00:00;74;153;166;319
2017;November;48;2017-11-28 00:00;75;139;136;275
2017;November;48;2017-11-28 00:00;76;111;104;215
2017;November;48;2017-11-28 00:00;77;83;125;208
2017;November;48;2017-11-28 00:00;78;88;92;180
2017;November;48;2017-11-28 00:00;79;97;78;175
2017;November;48;2017-11-28 00:00;80;79;74;153
2017;November;48;2017-11-28 00:00;81;89;66;155
2017;November;48;2017-11-28 00:00;82;63;62;125
2017;November;48;2017-11-28 00:00;83;72;47;119
2017;November;48;2017-11-28 00:00;84;57;46;103
2017;November;48;2017-11-28 00:00;85;33;39;72
2017;November;48;2017-11-28 00:00;86;45;30;75
2017;November;48;2017-11-28 00:00;87;46;28;74
2017;November;48;2017-11-28 00:00;88;34;24;58
2017;November;48;2017-11-28 00:00;89;30;16;46
2017;November;48;2017-11-28 00:00;90;29;10;39
2017;November;48;2017-11-28 00:00;91;23;11;34
2017;November;48;2017-11-28 00:00;92;20;8;28
2017;November;48;2017-11-28 00:00;93;11;8;19
2017;November;48;2017-11-28 00:00;94;12;6;18
2017;November;48;2017-11-28 00:00;95;13;3;16
2017;November;48;2017-11-28 00:00;96;5;4;9
2017;November;48;2017-11-28 00:00;97;3;2;5
2017;November;48;2017-11-28 00:00;98;0;1;1
2017;November;48;2017-11-28 00:00;99;2;1;3
2017;November;48;2017-11-28 00:00;105;1;0;1
2017;December;49;2017-12-05 00:00;0;173;175;348
2017;December;49;2017-12-05 00:00;1;172;194;366
2017;December;49;2017-12-05 00:00;2;187;203;390
2017;December;49;2017-12-05 00:00;3;182;224;406
2017;December;49;2017-12-05 00:00;4;199;219;418
2017;December;49;2017-12-05 00:00;5;193;201;394
2017;December;49;2017-12-05 00:00;6;222;240;462
2017;December;49;2017-12-05 00:00;7;218;233;451
2017;December;49;2017-12-05 00:00;8;206;215;421
2017;December;49;2017-12-05 00:00;9;197;198;395
2017;December;49;2017-12-05 00:00;10;186;204;390
2017;December;49;2017-12-05 00:00;11;226;198;424
2017;December;49;2017-12-05 00:00;12;183;212;395
2017;December;49;2017-12-05 00:00;13;187;203;390
2017;December;49;2017-12-05 00:00;14;179;188;367
2017;December;49;2017-12-05 00:00;15;175;220;395
2017;December;49;2017-12-05 00:00;16;142;185;327
2017;December;49;2017-12-05 00:00;17;180;203;383
2017;December;49;2017-12-05 00:00;18;176;188;364
2017;December;49;2017-12-05 00:00;19;154;167;321
2017;December;49;2017-12-05 00:00;20;147;189;336
2017;December;49;2017-12-05 00:00;21;154;167;321
2017;December;49;2017-12-05 00:00;22;140;175;315
2017;December;49;2017-12-05 00:00;23;161;180;341
2017;December;49;2017-12-05 00:00;24;181;202;383
2017;December;49;2017-12-05 00:00;25;172;189;361
2017;December;49;2017-12-05 00:00;26;178;228;406
2017;December;49;2017-12-05 00:00;27;192;195;387
2017;December;49;2017-12-05 00:00;28;160;190;350
2017;December;49;2017-12-05 00:00;29;178;184;362
2017;December;49;2017-12-05 00:00;30;183;188;371
2017;December;49;2017-12-05 00:00;31;174;188;362
2017;December;49;2017-12-05 00:00;32;187;196;383
2017;December;49;2017-12-05 00:00;33;190;191;381
2017;December;49;2017-12-05 00:00;34;214;181;395
2017;December;49;2017-12-05 00:00;35;203;194;397
2017;December;49;2017-12-05 00:00;36;171;188;359
2017;December;49;2017-12-05 00:00;37;233;197;430
2017;December;49;2017-12-05 00:00;38;208;175;383
2017;December;49;2017-12-05 00:00;39;187;207;394
2017;December;49;2017-12-05 00:00;40;193;206;399
2017;December;49;2017-12-05 00:00;41;219;217;436
2017;December;49;2017-12-05 00:00;42;223;245;468
2017;December;49;2017-12-05 00:00;43;226;276;502
2017;December;49;2017-12-05 00:00;44;211;221;432
2017;December;49;2017-12-05 00:00;45;223;252;475
2017;December;49;2017-12-05 00:00;46;213;215;428
2017;December;49;2017-12-05 00:00;47;213;224;437
2017;December;49;2017-12-05 00:00;48;199;198;397
2017;December;49;2017-12-05 00:00;49;211;221;432
2017;December;49;2017-12-05 00:00;50;236;228;464
2017;December;49;2017-12-05 00:00;51;188;223;411
2017;December;49;2017-12-05 00:00;52;200;221;421
2017;December;49;2017-12-05 00:00;53;186;221;407
2017;December;49;2017-12-05 00:00;54;180;218;398
2017;December;49;2017-12-05 00:00;55;187;189;376
2017;December;49;2017-12-05 00:00;56;151;168;319
2017;December;49;2017-12-05 00:00;57;156;152;308
2017;December;49;2017-12-05 00:00;58;157;168;325
2017;December;49;2017-12-05 00:00;59;154;152;306
2017;December;49;2017-12-05 00:00;60;150;158;308
2017;December;49;2017-12-05 00:00;61;149;155;304
2017;December;49;2017-12-05 00:00;62;136;125;261
2017;December;49;2017-12-05 00:00;63;134;137;271
2017;December;49;2017-12-05 00:00;64;144;136;280
2017;December;49;2017-12-05 00:00;65;140;155;295
2017;December;49;2017-12-05 00:00;66;145;138;283
2017;December;49;2017-12-05 00:00;67;144;159;303
2017;December;49;2017-12-05 00:00;68;147;160;307
2017;December;49;2017-12-05 00:00;69;175;165;340
2017;December;49;2017-12-05 00:00;70;162;157;319
2017;December;49;2017-12-05 00:00;71;182;151;333
2017;December;49;2017-12-05 00:00;72;181;172;353
2017;December;49;2017-12-05 00:00;73;152;161;313
2017;December;49;2017-12-05 00:00;74;153;166;319
2017;December;49;2017-12-05 00:00;75;139;135;274
2017;December;49;2017-12-05 00:00;76;111;104;215
2017;December;49;2017-12-05 00:00;77;83;125;208
2017;December;49;2017-12-05 00:00;78;88;92;180
2017;December;49;2017-12-05 00:00;79;97;78;175
2017;December;49;2017-12-05 00:00;80;79;74;153
2017;December;49;2017-12-05 00:00;81;89;66;155
2017;December;49;2017-12-05 00:00;82;63;62;125
2017;December;49;2017-12-05 00:00;83;72;47;119
2017;December;49;2017-12-05 00:00;84;56;46;102
2017;December;49;2017-12-05 00:00;85;33;39;72
2017;December;49;2017-12-05 00:00;86;44;30;74
2017;December;49;2017-12-05 00:00;87;46;28;74
2017;December;49;2017-12-05 00:00;88;34;24;58
2017;December;49;2017-12-05 00:00;89;30;16;46
2017;December;49;2017-12-05 00:00;90;29;10;39
2017;December;49;2017-12-05 00:00;91;23;11;34
2017;December;49;2017-12-05 00:00;92;20;8;28
2017;December;49;2017-12-05 00:00;93;11;8;19
2017;December;49;2017-12-05 00:00;94;12;6;18
2017;December;49;2017-12-05 00:00;95;13;3;16
2017;December;49;2017-12-05 00:00;96;5;4;9
2017;December;49;2017-12-05 00:00;97;3;2;5
2017;December;49;2017-12-05 00:00;98;0;1;1
2017;December;49;2017-12-05 00:00;99;2;1;3
2017;December;49;2017-12-05 00:00;105;1;0;1
2017;December;50;2017-12-12 00:00;0;175;177;352
2017;December;50;2017-12-12 00:00;1;172;196;368
2017;December;50;2017-12-12 00:00;2;188;203;391
2017;December;50;2017-12-12 00:00;3;183;223;406
2017;December;50;2017-12-12 00:00;4;200;220;420
2017;December;50;2017-12-12 00:00;5;193;201;394
2017;December;50;2017-12-12 00:00;6;222;240;462
2017;December;50;2017-12-12 00:00;7;218;235;453
2017;December;50;2017-12-12 00:00;8;206;215;421
2017;December;50;2017-12-12 00:00;9;199;198;397
2017;December;50;2017-12-12 00:00;10;187;204;391
2017;December;50;2017-12-12 00:00;11;226;198;424
2017;December;50;2017-12-12 00:00;12;183;212;395
2017;December;50;2017-12-12 00:00;13;187;203;390
2017;December;50;2017-12-12 00:00;14;178;188;366
2017;December;50;2017-12-12 00:00;15;175;219;394
2017;December;50;2017-12-12 00:00;16;142;185;327
2017;December;50;2017-12-12 00:00;17;181;203;384
2017;December;50;2017-12-12 00:00;18;176;188;364
2017;December;50;2017-12-12 00:00;19;154;167;321
2017;December;50;2017-12-12 00:00;20;148;189;337
2017;December;50;2017-12-12 00:00;21;153;167;320
2017;December;50;2017-12-12 00:00;22;141;174;315
2017;December;50;2017-12-12 00:00;23;161;181;342
2017;December;50;2017-12-12 00:00;24;183;201;384
2017;December;50;2017-12-12 00:00;25;172;188;360
2017;December;50;2017-12-12 00:00;26;180;228;408
2017;December;50;2017-12-12 00:00;27;191;194;385
2017;December;50;2017-12-12 00:00;28;160;189;349
2017;December;50;2017-12-12 00:00;29;179;185;364
2017;December;50;2017-12-12 00:00;30;183;189;372
2017;December;50;2017-12-12 00:00;31;174;188;362
2017;December;50;2017-12-12 00:00;32;188;196;384
2017;December;50;2017-12-12 00:00;33;191;192;383
2017;December;50;2017-12-12 00:00;34;215;184;399
2017;December;50;2017-12-12 00:00;35;203;194;397
2017;December;50;2017-12-12 00:00;36;172;188;360
2017;December;50;2017-12-12 00:00;37;232;199;431
2017;December;50;2017-12-12 00:00;38;208;175;383
2017;December;50;2017-12-12 00:00;39;188;207;395
2017;December;50;2017-12-12 00:00;40;193;205;398
2017;December;50;2017-12-12 00:00;41;219;217;436
2017;December;50;2017-12-12 00:00;42;224;245;469
2017;December;50;2017-12-12 00:00;43;226;276;502
2017;December;50;2017-12-12 00:00;44;211;218;429
2017;December;50;2017-12-12 00:00;45;223;252;475
2017;December;50;2017-12-12 00:00;46;214;215;429
2017;December;50;2017-12-12 00:00;47;213;224;437
2017;December;50;2017-12-12 00:00;48;199;198;397
2017;December;50;2017-12-12 00:00;49;211;221;432
2017;December;50;2017-12-12 00:00;50;236;227;463
2017;December;50;2017-12-12 00:00;51;188;223;411
2017;December;50;2017-12-12 00:00;52;200;221;421
2017;December;50;2017-12-12 00:00;53;186;221;407
2017;December;50;2017-12-12 00:00;54;180;218;398
2017;December;50;2017-12-12 00:00;55;186;189;375
2017;December;50;2017-12-12 00:00;56;151;168;319
2017;December;50;2017-12-12 00:00;57;156;152;308
2017;December;50;2017-12-12 00:00;58;157;167;324
2017;December;50;2017-12-12 00:00;59;155;152;307
2017;December;50;2017-12-12 00:00;60;150;158;308
2017;December;50;2017-12-12 00:00;61;149;155;304
2017;December;50;2017-12-12 00:00;62;136;125;261
2017;December;50;2017-12-12 00:00;63;134;137;271
2017;December;50;2017-12-12 00:00;64;144;136;280
2017;December;50;2017-12-12 00:00;65;140;155;295
2017;December;50;2017-12-12 00:00;66;145;138;283
2017;December;50;2017-12-12 00:00;67;144;159;303
2017;December;50;2017-12-12 00:00;68;148;160;308
2017;December;50;2017-12-12 00:00;69;175;165;340
2017;December;50;2017-12-12 00:00;70;162;157;319
2017;December;50;2017-12-12 00:00;71;182;151;333
2017;December;50;2017-12-12 00:00;72;181;172;353
2017;December;50;2017-12-12 00:00;73;151;161;312
2017;December;50;2017-12-12 00:00;74;153;166;319
2017;December;50;2017-12-12 00:00;75;139;135;274
2017;December;50;2017-12-12 00:00;76;111;103;214
2017;December;50;2017-12-12 00:00;77;83;125;208
2017;December;50;2017-12-12 00:00;78;88;90;178
2017;December;50;2017-12-12 00:00;79;97;78;175
2017;December;50;2017-12-12 00:00;80;79;74;153
2017;December;50;2017-12-12 00:00;81;89;66;155
2017;December;50;2017-12-12 00:00;82;63;62;125
2017;December;50;2017-12-12 00:00;83;72;48;120
2017;December;50;2017-12-12 00:00;84;55;46;101
2017;December;50;2017-12-12 00:00;85;33;38;71
2017;December;50;2017-12-12 00:00;86;44;30;74
2017;December;50;2017-12-12 00:00;87;46;28;74
2017;December;50;2017-12-12 00:00;88;34;24;58
2017;December;50;2017-12-12 00:00;89;30;16;46
2017;December;50;2017-12-12 00:00;90;29;10;39
2017;December;50;2017-12-12 00:00;91;22;11;33
2017;December;50;2017-12-12 00:00;92;20;7;27
2017;December;50;2017-12-12 00:00;93;11;8;19
2017;December;50;2017-12-12 00:00;94;12;6;18
2017;December;50;2017-12-12 00:00;95;13;3;16
2017;December;50;2017-12-12 00:00;96;5;4;9
2017;December;50;2017-12-12 00:00;97;3;2;5
2017;December;50;2017-12-12 00:00;98;0;1;1
2017;December;50;2017-12-12 00:00;99;2;1;3
2017;December;50;2017-12-12 00:00;105;1;0;1
2017;December;51;2017-12-19 00:00;0;181;179;360
2017;December;51;2017-12-19 00:00;1;174;196;370
2017;December;51;2017-12-19 00:00;2;189;204;393
2017;December;51;2017-12-19 00:00;3;183;224;407
2017;December;51;2017-12-19 00:00;4;200;221;421
2017;December;51;2017-12-19 00:00;5;193;204;397
2017;December;51;2017-12-19 00:00;6;222;240;462
2017;December;51;2017-12-19 00:00;7;218;235;453
2017;December;51;2017-12-19 00:00;8;206;217;423
2017;December;51;2017-12-19 00:00;9;199;198;397
2017;December;51;2017-12-19 00:00;10;187;204;391
2017;December;51;2017-12-19 00:00;11;227;197;424
2017;December;51;2017-12-19 00:00;12;183;212;395
2017;December;51;2017-12-19 00:00;13;187;203;390
2017;December;51;2017-12-19 00:00;14;178;188;366
2017;December;51;2017-12-19 00:00;15;175;219;394
2017;December;51;2017-12-19 00:00;16;141;186;327
2017;December;51;2017-12-19 00:00;17;181;203;384
2017;December;51;2017-12-19 00:00;18;176;188;364
2017;December;51;2017-12-19 00:00;19;154;168;322
2017;December;51;2017-12-19 00:00;20;146;189;335
2017;December;51;2017-12-19 00:00;21;153;167;320
2017;December;51;2017-12-19 00:00;22;143;173;316
2017;December;51;2017-12-19 00:00;23;163;180;343
2017;December;51;2017-12-19 00:00;24;182;203;385
2017;December;51;2017-12-19 00:00;25;173;189;362
2017;December;51;2017-12-19 00:00;26;181;229;410
2017;December;51;2017-12-19 00:00;27;191;195;386
2017;December;51;2017-12-19 00:00;28;160;190;350
2017;December;51;2017-12-19 00:00;29;180;185;365
2017;December;51;2017-12-19 00:00;30;184;189;373
2017;December;51;2017-12-19 00:00;31;174;189;363
2017;December;51;2017-12-19 00:00;32;189;196;385
2017;December;51;2017-12-19 00:00;33;192;192;384
2017;December;51;2017-12-19 00:00;34;214;184;398
2017;December;51;2017-12-19 00:00;35;204;194;398
2017;December;51;2017-12-19 00:00;36;172;188;360
2017;December;51;2017-12-19 00:00;37;232;200;432
2017;December;51;2017-12-19 00:00;38;208;176;384
2017;December;51;2017-12-19 00:00;39;189;207;396
2017;December;51;2017-12-19 00:00;40;194;205;399
2017;December;51;2017-12-19 00:00;41;218;217;435
2017;December;51;2017-12-19 00:00;42;224;244;468
2017;December;51;2017-12-19 00:00;43;227;277;504
2017;December;51;2017-12-19 00:00;44;211;217;428
2017;December;51;2017-12-19 00:00;45;223;251;474
2017;December;51;2017-12-19 00:00;46;214;215;429
2017;December;51;2017-12-19 00:00;47;214;224;438
2017;December;51;2017-12-19 00:00;48;199;199;398
2017;December;51;2017-12-19 00:00;49;210;221;431
2017;December;51;2017-12-19 00:00;50;236;227;463
2017;December;51;2017-12-19 00:00;51;188;223;411
2017;December;51;2017-12-19 00:00;52;200;222;422
2017;December;51;2017-12-19 00:00;53;186;222;408
2017;December;51;2017-12-19 00:00;54;180;217;397
2017;December;51;2017-12-19 00:00;55;186;189;375
2017;December;51;2017-12-19 00:00;56;151;168;319
2017;December;51;2017-12-19 00:00;57;156;152;308
2017;December;51;2017-12-19 00:00;58;157;167;324
2017;December;51;2017-12-19 00:00;59;156;152;308
2017;December;51;2017-12-19 00:00;60;150;158;308
2017;December;51;2017-12-19 00:00;61;149;155;304
2017;December;51;2017-12-19 00:00;62;136;125;261
2017;December;51;2017-12-19 00:00;63;134;138;272
2017;December;51;2017-12-19 00:00;64;144;136;280
2017;December;51;2017-12-19 00:00;65;139;156;295
2017;December;51;2017-12-19 00:00;66;145;137;282
2017;December;51;2017-12-19 00:00;67;144;159;303
2017;December;51;2017-12-19 00:00;68;147;160;307
2017;December;51;2017-12-19 00:00;69;175;165;340
2017;December;51;2017-12-19 00:00;70;162;157;319
2017;December;51;2017-12-19 00:00;71;182;151;333
2017;December;51;2017-12-19 00:00;72;181;172;353
2017;December;51;2017-12-19 00:00;73;151;161;312
2017;December;51;2017-12-19 00:00;74;153;166;319
2017;December;51;2017-12-19 00:00;75;139;135;274
2017;December;51;2017-12-19 00:00;76;111;103;214
2017;December;51;2017-12-19 00:00;77;83;124;207
2017;December;51;2017-12-19 00:00;78;88;90;178
2017;December;51;2017-12-19 00:00;79;97;78;175
2017;December;51;2017-12-19 00:00;80;79;74;153
2017;December;51;2017-12-19 00:00;81;89;66;155
2017;December;51;2017-12-19 00:00;82;63;62;125
2017;December;51;2017-12-19 00:00;83;72;48;120
2017;December;51;2017-12-19 00:00;84;55;46;101
2017;December;51;2017-12-19 00:00;85;33;38;71
2017;December;51;2017-12-19 00:00;86;44;30;74
2017;December;51;2017-12-19 00:00;87;46;28;74
2017;December;51;2017-12-19 00:00;88;34;24;58
2017;December;51;2017-12-19 00:00;89;30;16;46
2017;December;51;2017-12-19 00:00;90;29;10;39
2017;December;51;2017-12-19 00:00;91;22;11;33
2017;December;51;2017-12-19 00:00;92;20;7;27
2017;December;51;2017-12-19 00:00;93;11;8;19
2017;December;51;2017-12-19 00:00;94;12;6;18
2017;December;51;2017-12-19 00:00;95;13;3;16
2017;December;51;2017-12-19 00:00;96;5;4;9
2017;December;51;2017-12-19 00:00;97;3;2;5
2017;December;51;2017-12-19 00:00;98;0;1;1
2017;December;51;2017-12-19 00:00;99;2;1;3
2017;December;51;2017-12-19 00:00;105;1;0;1
2017;December;52;2017-12-26 00:00;0;185;186;371
2017;December;52;2017-12-26 00:00;1;174;196;370
2017;December;52;2017-12-26 00:00;2;189;204;393
2017;December;52;2017-12-26 00:00;3;183;224;407
2017;December;52;2017-12-26 00:00;4;200;221;421
2017;December;52;2017-12-26 00:00;5;193;204;397
2017;December;52;2017-12-26 00:00;6;222;240;462
2017;December;52;2017-12-26 00:00;7;218;235;453
2017;December;52;2017-12-26 00:00;8;207;217;424
2017;December;52;2017-12-26 00:00;9;200;197;397
2017;December;52;2017-12-26 00:00;10;187;204;391
2017;December;52;2017-12-26 00:00;11;227;197;424
2017;December;52;2017-12-26 00:00;12;183;212;395
2017;December;52;2017-12-26 00:00;13;187;203;390
2017;December;52;2017-12-26 00:00;14;177;188;365
2017;December;52;2017-12-26 00:00;15;175;219;394
2017;December;52;2017-12-26 00:00;16;141;186;327
2017;December;52;2017-12-26 00:00;17;181;204;385
2017;December;52;2017-12-26 00:00;18;176;188;364
2017;December;52;2017-12-26 00:00;19;154;168;322
2017;December;52;2017-12-26 00:00;20;146;189;335
2017;December;52;2017-12-26 00:00;21;152;168;320
2017;December;52;2017-12-26 00:00;22;143;173;316
2017;December;52;2017-12-26 00:00;23;164;180;344
2017;December;52;2017-12-26 00:00;24;183;203;386
2017;December;52;2017-12-26 00:00;25;173;188;361
2017;December;52;2017-12-26 00:00;26;182;229;411
2017;December;52;2017-12-26 00:00;27;191;195;386
2017;December;52;2017-12-26 00:00;28;161;190;351
2017;December;52;2017-12-26 00:00;29;180;185;365
2017;December;52;2017-12-26 00:00;30;186;188;374
2017;December;52;2017-12-26 00:00;31;174;189;363
2017;December;52;2017-12-26 00:00;32;189;197;386
2017;December;52;2017-12-26 00:00;33;192;193;385
2017;December;52;2017-12-26 00:00;34;214;185;399
2017;December;52;2017-12-26 00:00;35;204;194;398
2017;December;52;2017-12-26 00:00;36;172;188;360
2017;December;52;2017-12-26 00:00;37;232;200;432
2017;December;52;2017-12-26 00:00;38;208;176;384
2017;December;52;2017-12-26 00:00;39;189;206;395
2017;December;52;2017-12-26 00:00;40;194;206;400
2017;December;52;2017-12-26 00:00;41;218;218;436
2017;December;52;2017-12-26 00:00;42;224;244;468
2017;December;52;2017-12-26 00:00;43;227;276;503
2017;December;52;2017-12-26 00:00;44;211;217;428
2017;December;52;2017-12-26 00:00;45;223;251;474
2017;December;52;2017-12-26 00:00;46;214;215;429
2017;December;52;2017-12-26 00:00;47;213;223;436
2017;December;52;2017-12-26 00:00;48;199;199;398
2017;December;52;2017-12-26 00:00;49;210;221;431
2017;December;52;2017-12-26 00:00;50;235;227;462
2017;December;52;2017-12-26 00:00;51;188;223;411
2017;December;52;2017-12-26 00:00;52;200;222;422
2017;December;52;2017-12-26 00:00;53;187;222;409
2017;December;52;2017-12-26 00:00;54;180;217;397
2017;December;52;2017-12-26 00:00;55;186;189;375
2017;December;52;2017-12-26 00:00;56;151;168;319
2017;December;52;2017-12-26 00:00;57;156;152;308
2017;December;52;2017-12-26 00:00;58;157;167;324
2017;December;52;2017-12-26 00:00;59;156;152;308
2017;December;52;2017-12-26 00:00;60;150;158;308
2017;December;52;2017-12-26 00:00;61;149;155;304
2017;December;52;2017-12-26 00:00;62;136;125;261
2017;December;52;2017-12-26 00:00;63;134;138;272
2017;December;52;2017-12-26 00:00;64;144;136;280
2017;December;52;2017-12-26 00:00;65;138;156;294
2017;December;52;2017-12-26 00:00;66;145;138;283
2017;December;52;2017-12-26 00:00;67;143;159;302
2017;December;52;2017-12-26 00:00;68;147;160;307
2017;December;52;2017-12-26 00:00;69;175;165;340
2017;December;52;2017-12-26 00:00;70;162;157;319
2017;December;52;2017-12-26 00:00;71;182;150;332
2017;December;52;2017-12-26 00:00;72;181;172;353
2017;December;52;2017-12-26 00:00;73;151;161;312
2017;December;52;2017-12-26 00:00;74;153;166;319
2017;December;52;2017-12-26 00:00;75;139;135;274
2017;December;52;2017-12-26 00:00;76;112;103;215
2017;December;52;2017-12-26 00:00;77;83;124;207
2017;December;52;2017-12-26 00:00;78;88;89;177
2017;December;52;2017-12-26 00:00;79;97;78;175
2017;December;52;2017-12-26 00:00;80;79;73;152
2017;December;52;2017-12-26 00:00;81;89;66;155
2017;December;52;2017-12-26 00:00;82;63;62;125
2017;December;52;2017-12-26 00:00;83;71;49;120
2017;December;52;2017-12-26 00:00;84;55;46;101
2017;December;52;2017-12-26 00:00;85;33;37;70
2017;December;52;2017-12-26 00:00;86;44;30;74
2017;December;52;2017-12-26 00:00;87;46;28;74
2017;December;52;2017-12-26 00:00;88;34;24;58
2017;December;52;2017-12-26 00:00;89;30;16;46
2017;December;52;2017-12-26 00:00;90;29;10;39
2017;December;52;2017-12-26 00:00;91;22;11;33
2017;December;52;2017-12-26 00:00;92;20;6;26
2017;December;52;2017-12-26 00:00;93;11;8;19
2017;December;52;2017-12-26 00:00;94;12;6;18
2017;December;52;2017-12-26 00:00;95;13;3;16
2017;December;52;2017-12-26 00:00;96;5;4;9
2017;December;52;2017-12-26 00:00;97;3;2;5
2017;December;52;2017-12-26 00:00;98;0;1;1
2017;December;52;2017-12-26 00:00;99;1;1;2
2017;December;52;2017-12-26 00:00;105;1;0;1
2018;January;1;2018-01-02 00:00;1;188;189;377
2018;January;1;2018-01-02 00:00;2;173;196;369
2018;January;1;2018-01-02 00:00;3;189;204;393
2018;January;1;2018-01-02 00:00;4;182;223;405
2018;January;1;2018-01-02 00:00;5;200;221;421
2018;January;1;2018-01-02 00:00;6;193;203;396
2018;January;1;2018-01-02 00:00;7;222;240;462
2018;January;1;2018-01-02 00:00;8;219;235;454
2018;January;1;2018-01-02 00:00;9;207;217;424
2018;January;1;2018-01-02 00:00;10;199;198;397
2018;January;1;2018-01-02 00:00;11;187;204;391
2018;January;1;2018-01-02 00:00;12;227;198;425
2018;January;1;2018-01-02 00:00;13;183;212;395
2018;January;1;2018-01-02 00:00;14;187;203;390
2018;January;1;2018-01-02 00:00;15;177;188;365
2018;January;1;2018-01-02 00:00;16;175;219;394
2018;January;1;2018-01-02 00:00;17;140;186;326
2018;January;1;2018-01-02 00:00;18;181;204;385
2018;January;1;2018-01-02 00:00;19;176;188;364
2018;January;1;2018-01-02 00:00;20;154;168;322
2018;January;1;2018-01-02 00:00;21;145;189;334
2018;January;1;2018-01-02 00:00;22;153;169;322
2018;January;1;2018-01-02 00:00;23;141;171;312
2018;January;1;2018-01-02 00:00;24;166;179;345
2018;January;1;2018-01-02 00:00;25;182;203;385
2018;January;1;2018-01-02 00:00;26;173;189;362
2018;January;1;2018-01-02 00:00;27;181;231;412
2018;January;1;2018-01-02 00:00;28;192;195;387
2018;January;1;2018-01-02 00:00;29;160;191;351
2018;January;1;2018-01-02 00:00;30;180;185;365
2018;January;1;2018-01-02 00:00;31;186;187;373
2018;January;1;2018-01-02 00:00;32;174;188;362
2018;January;1;2018-01-02 00:00;33;188;197;385
2018;January;1;2018-01-02 00:00;34;192;192;384
2018;January;1;2018-01-02 00:00;35;213;184;397
2018;January;1;2018-01-02 00:00;36;205;194;399
2018;January;1;2018-01-02 00:00;37;172;187;359
2018;January;1;2018-01-02 00:00;38;232;200;432
2018;January;1;2018-01-02 00:00;39;208;175;383
2018;January;1;2018-01-02 00:00;40;189;207;396
2018;January;1;2018-01-02 00:00;41;194;205;399
2018;January;1;2018-01-02 00:00;42;219;219;438
2018;January;1;2018-01-02 00:00;43;224;244;468
2018;January;1;2018-01-02 00:00;44;227;276;503
2018;January;1;2018-01-02 00:00;45;211;218;429
2018;January;1;2018-01-02 00:00;46;223;251;474
2018;January;1;2018-01-02 00:00;47;214;215;429
2018;January;1;2018-01-02 00:00;48;212;223;435
2018;January;1;2018-01-02 00:00;49;199;199;398
2018;January;1;2018-01-02 00:00;50;209;221;430
2018;January;1;2018-01-02 00:00;51;235;227;462
2018;January;1;2018-01-02 00:00;52;188;223;411
2018;January;1;2018-01-02 00:00;53;200;222;422
2018;January;1;2018-01-02 00:00;54;187;222;409
2018;January;1;2018-01-02 00:00;55;180;217;397
2018;January;1;2018-01-02 00:00;56;186;188;374
2018;January;1;2018-01-02 00:00;57;151;167;318
2018;January;1;2018-01-02 00:00;58;156;152;308
2018;January;1;2018-01-02 00:00;59;157;167;324
2018;January;1;2018-01-02 00:00;60;156;152;308
2018;January;1;2018-01-02 00:00;61;150;158;308
2018;January;1;2018-01-02 00:00;62;150;156;306
2018;January;1;2018-01-02 00:00;63;136;125;261
2018;January;1;2018-01-02 00:00;64;133;138;271
2018;January;1;2018-01-02 00:00;65;145;136;281
2018;January;1;2018-01-02 00:00;66;138;156;294
2018;January;1;2018-01-02 00:00;67;144;138;282
2018;January;1;2018-01-02 00:00;68;142;159;301
2018;January;1;2018-01-02 00:00;69;147;160;307
2018;January;1;2018-01-02 00:00;70;175;164;339
2018;January;1;2018-01-02 00:00;71;162;157;319
2018;January;1;2018-01-02 00:00;72;182;150;332
2018;January;1;2018-01-02 00:00;73;181;172;353
2018;January;1;2018-01-02 00:00;74;151;161;312
2018;January;1;2018-01-02 00:00;75;153;166;319
2018;January;1;2018-01-02 00:00;76;139;135;274
2018;January;1;2018-01-02 00:00;77;112;103;215
2018;January;1;2018-01-02 00:00;78;83;124;207
2018;January;1;2018-01-02 00:00;79;88;89;177
2018;January;1;2018-01-02 00:00;80;97;78;175
2018;January;1;2018-01-02 00:00;81;79;73;152
2018;January;1;2018-01-02 00:00;82;89;66;155
2018;January;1;2018-01-02 00:00;83;63;62;125
2018;January;1;2018-01-02 00:00;84;71;49;120
2018;January;1;2018-01-02 00:00;85;55;46;101
2018;January;1;2018-01-02 00:00;86;33;37;70
2018;January;1;2018-01-02 00:00;87;43;30;73
2018;January;1;2018-01-02 00:00;88;46;27;73
2018;January;1;2018-01-02 00:00;89;34;23;57
2018;January;1;2018-01-02 00:00;90;30;16;46
2018;January;1;2018-01-02 00:00;91;29;10;39
2018;January;1;2018-01-02 00:00;92;21;11;32
2018;January;1;2018-01-02 00:00;93;20;6;26
2018;January;1;2018-01-02 00:00;94;11;8;19
2018;January;1;2018-01-02 00:00;95;12;6;18
2018;January;1;2018-01-02 00:00;96;13;3;16
2018;January;1;2018-01-02 00:00;97;5;4;9
2018;January;1;2018-01-02 00:00;98;3;2;5
2018;January;1;2018-01-02 00:00;99;0;1;1
2018;January;1;2018-01-02 00:00;100;1;1;2
2018;January;1;2018-01-02 00:00;106;1;0;1
2018;January;2;2018-01-09 00:00;0;4;1;5
2018;January;2;2018-01-09 00:00;1;189;190;379
2018;January;2;2018-01-09 00:00;2;174;198;372
2018;January;2;2018-01-09 00:00;3;190;205;395
2018;January;2;2018-01-09 00:00;4;182;225;407
2018;January;2;2018-01-09 00:00;5;202;221;423
2018;January;2;2018-01-09 00:00;6;196;203;399
2018;January;2;2018-01-09 00:00;7;223;240;463
2018;January;2;2018-01-09 00:00;8;219;235;454
2018;January;2;2018-01-09 00:00;9;207;218;425
2018;January;2;2018-01-09 00:00;10;200;198;398
2018;January;2;2018-01-09 00:00;11;187;205;392
2018;January;2;2018-01-09 00:00;12;227;198;425
2018;January;2;2018-01-09 00:00;13;183;212;395
2018;January;2;2018-01-09 00:00;14;187;204;391
2018;January;2;2018-01-09 00:00;15;177;188;365
2018;January;2;2018-01-09 00:00;16;175;219;394
2018;January;2;2018-01-09 00:00;17;139;186;325
2018;January;2;2018-01-09 00:00;18;181;204;385
2018;January;2;2018-01-09 00:00;19;177;188;365
2018;January;2;2018-01-09 00:00;20;154;168;322
2018;January;2;2018-01-09 00:00;21;144;189;333
2018;January;2;2018-01-09 00:00;22;155;169;324
2018;January;2;2018-01-09 00:00;23;141;171;312
2018;January;2;2018-01-09 00:00;24;167;181;348
2018;January;2;2018-01-09 00:00;25;182;204;386
2018;January;2;2018-01-09 00:00;26;173;190;363
2018;January;2;2018-01-09 00:00;27;180;231;411
2018;January;2;2018-01-09 00:00;28;192;196;388
2018;January;2;2018-01-09 00:00;29;162;190;352
2018;January;2;2018-01-09 00:00;30;182;185;367
2018;January;2;2018-01-09 00:00;31;187;188;375
2018;January;2;2018-01-09 00:00;32;173;188;361
2018;January;2;2018-01-09 00:00;33;188;200;388
2018;January;2;2018-01-09 00:00;34;192;192;384
2018;January;2;2018-01-09 00:00;35;213;184;397
2018;January;2;2018-01-09 00:00;36;205;194;399
2018;January;2;2018-01-09 00:00;37;171;187;358
2018;January;2;2018-01-09 00:00;38;232;201;433
2018;January;2;2018-01-09 00:00;39;209;176;385
2018;January;2;2018-01-09 00:00;40;189;208;397
2018;January;2;2018-01-09 00:00;41;194;205;399
2018;January;2;2018-01-09 00:00;42;219;219;438
2018;January;2;2018-01-09 00:00;43;223;245;468
2018;January;2;2018-01-09 00:00;44;227;277;504
2018;January;2;2018-01-09 00:00;45;211;218;429
2018;January;2;2018-01-09 00:00;46;222;251;473
2018;January;2;2018-01-09 00:00;47;214;215;429
2018;January;2;2018-01-09 00:00;48;212;222;434
2018;January;2;2018-01-09 00:00;49;199;198;397
2018;January;2;2018-01-09 00:00;50;209;220;429
2018;January;2;2018-01-09 00:00;51;235;227;462
2018;January;2;2018-01-09 00:00;52;188;223;411
2018;January;2;2018-01-09 00:00;53;200;222;422
2018;January;2;2018-01-09 00:00;54;187;223;410
2018;January;2;2018-01-09 00:00;55;180;216;396
2018;January;2;2018-01-09 00:00;56;187;188;375
2018;January;2;2018-01-09 00:00;57;151;167;318
2018;January;2;2018-01-09 00:00;58;156;152;308
2018;January;2;2018-01-09 00:00;59;157;165;322
2018;January;2;2018-01-09 00:00;60;156;153;309
2018;January;2;2018-01-09 00:00;61;150;158;308
2018;January;2;2018-01-09 00:00;62;150;156;306
2018;January;2;2018-01-09 00:00;63;136;125;261
2018;January;2;2018-01-09 00:00;64;133;138;271
2018;January;2;2018-01-09 00:00;65;146;136;282
2018;January;2;2018-01-09 00:00;66;138;156;294
2018;January;2;2018-01-09 00:00;67;144;138;282
2018;January;2;2018-01-09 00:00;68;142;159;301
2018;January;2;2018-01-09 00:00;69;147;160;307
2018;January;2;2018-01-09 00:00;70;175;164;339
2018;January;2;2018-01-09 00:00;71;162;157;319
2018;January;2;2018-01-09 00:00;72;182;150;332
2018;January;2;2018-01-09 00:00;73;181;172;353
2018;January;2;2018-01-09 00:00;74;151;160;311
2018;January;2;2018-01-09 00:00;75;153;166;319
2018;January;2;2018-01-09 00:00;76;139;135;274
2018;January;2;2018-01-09 00:00;77;112;103;215
2018;January;2;2018-01-09 00:00;78;83;124;207
2018;January;2;2018-01-09 00:00;79;88;89;177
2018;January;2;2018-01-09 00:00;80;95;78;173
2018;January;2;2018-01-09 00:00;81;79;73;152
2018;January;2;2018-01-09 00:00;82;89;66;155
2018;January;2;2018-01-09 00:00;83;63;62;125
2018;January;2;2018-01-09 00:00;84;71;49;120
2018;January;2;2018-01-09 00:00;85;55;46;101
2018;January;2;2018-01-09 00:00;86;33;37;70
2018;January;2;2018-01-09 00:00;87;43;30;73
2018;January;2;2018-01-09 00:00;88;46;27;73
2018;January;2;2018-01-09 00:00;89;34;23;57
2018;January;2;2018-01-09 00:00;90;30;16;46
2018;January;2;2018-01-09 00:00;91;29;9;38
2018;January;2;2018-01-09 00:00;92;21;11;32
2018;January;2;2018-01-09 00:00;93;20;6;26
2018;January;2;2018-01-09 00:00;94;11;8;19
2018;January;2;2018-01-09 00:00;95;12;6;18
2018;January;2;2018-01-09 00:00;96;13;3;16
2018;January;2;2018-01-09 00:00;97;5;4;9
2018;January;2;2018-01-09 00:00;98;3;2;5
2018;January;2;2018-01-09 00:00;99;0;1;1
2018;January;2;2018-01-09 00:00;100;1;1;2
2018;January;2;2018-01-09 00:00;106;1;0;1
2018;January;3;2018-01-16 00:00;0;6;7;13
2018;January;3;2018-01-16 00:00;1;189;192;381
2018;January;3;2018-01-16 00:00;2;175;197;372
2018;January;3;2018-01-16 00:00;3;189;206;395
2018;January;3;2018-01-16 00:00;4;182;226;408
2018;January;3;2018-01-16 00:00;5;201;222;423
2018;January;3;2018-01-16 00:00;6;195;204;399
2018;January;3;2018-01-16 00:00;7;223;240;463
2018;January;3;2018-01-16 00:00;8;219;235;454
2018;January;3;2018-01-16 00:00;9;208;218;426
2018;January;3;2018-01-16 00:00;10;201;198;399
2018;January;3;2018-01-16 00:00;11;187;205;392
2018;January;3;2018-01-16 00:00;12;226;198;424
2018;January;3;2018-01-16 00:00;13;183;211;394
2018;January;3;2018-01-16 00:00;14;186;204;390
2018;January;3;2018-01-16 00:00;15;178;187;365
2018;January;3;2018-01-16 00:00;16;175;220;395
2018;January;3;2018-01-16 00:00;17;139;186;325
2018;January;3;2018-01-16 00:00;18;181;203;384
2018;January;3;2018-01-16 00:00;19;176;187;363
2018;January;3;2018-01-16 00:00;20;154;168;322
2018;January;3;2018-01-16 00:00;21;144;190;334
2018;January;3;2018-01-16 00:00;22;155;171;326
2018;January;3;2018-01-16 00:00;23;142;175;317
2018;January;3;2018-01-16 00:00;24;168;180;348
2018;January;3;2018-01-16 00:00;25;180;203;383
2018;January;3;2018-01-16 00:00;26;172;188;360
2018;January;3;2018-01-16 00:00;27;181;232;413
2018;January;3;2018-01-16 00:00;28;193;197;390
2018;January;3;2018-01-16 00:00;29;163;191;354
2018;January;3;2018-01-16 00:00;30;182;184;366
2018;January;3;2018-01-16 00:00;31;187;187;374
2018;January;3;2018-01-16 00:00;32;174;188;362
2018;January;3;2018-01-16 00:00;33;189;201;390
2018;January;3;2018-01-16 00:00;34;191;192;383
2018;January;3;2018-01-16 00:00;35;215;182;397
2018;January;3;2018-01-16 00:00;36;205;194;399
2018;January;3;2018-01-16 00:00;37;171;188;359
2018;January;3;2018-01-16 00:00;38;231;202;433
2018;January;3;2018-01-16 00:00;39;208;176;384
2018;January;3;2018-01-16 00:00;40;190;208;398
2018;January;3;2018-01-16 00:00;41;195;208;403
2018;January;3;2018-01-16 00:00;42;219;219;438
2018;January;3;2018-01-16 00:00;43;222;244;466
2018;January;3;2018-01-16 00:00;44;227;278;505
2018;January;3;2018-01-16 00:00;45;212;217;429
2018;January;3;2018-01-16 00:00;46;222;251;473
2018;January;3;2018-01-16 00:00;47;214;216;430
2018;January;3;2018-01-16 00:00;48;212;223;435
2018;January;3;2018-01-16 00:00;49;198;198;396
2018;January;3;2018-01-16 00:00;50;209;220;429
2018;January;3;2018-01-16 00:00;51;235;227;462
2018;January;3;2018-01-16 00:00;52;188;223;411
2018;January;3;2018-01-16 00:00;53;199;222;421
2018;January;3;2018-01-16 00:00;54;188;223;411
2018;January;3;2018-01-16 00:00;55;180;215;395
2018;January;3;2018-01-16 00:00;56;187;188;375
2018;January;3;2018-01-16 00:00;57;151;167;318
2018;January;3;2018-01-16 00:00;58;157;152;309
2018;January;3;2018-01-16 00:00;59;157;165;322
2018;January;3;2018-01-16 00:00;60;156;153;309
2018;January;3;2018-01-16 00:00;61;150;158;308
2018;January;3;2018-01-16 00:00;62;150;158;308
2018;January;3;2018-01-16 00:00;63;136;124;260
2018;January;3;2018-01-16 00:00;64;133;138;271
2018;January;3;2018-01-16 00:00;65;146;136;282
2018;January;3;2018-01-16 00:00;66;138;157;295
2018;January;3;2018-01-16 00:00;67;144;138;282
2018;January;3;2018-01-16 00:00;68;142;159;301
2018;January;3;2018-01-16 00:00;69;147;160;307
2018;January;3;2018-01-16 00:00;70;175;164;339
2018;January;3;2018-01-16 00:00;71;162;157;319
2018;January;3;2018-01-16 00:00;72;182;150;332
2018;January;3;2018-01-16 00:00;73;181;172;353
2018;January;3;2018-01-16 00:00;74;151;160;311
2018;January;3;2018-01-16 00:00;75;153;167;320
2018;January;3;2018-01-16 00:00;76;139;135;274
2018;January;3;2018-01-16 00:00;77;111;103;214
2018;January;3;2018-01-16 00:00;78;83;124;207
2018;January;3;2018-01-16 00:00;79;88;89;177
2018;January;3;2018-01-16 00:00;80;95;78;173
2018;January;3;2018-01-16 00:00;81;79;73;152
2018;January;3;2018-01-16 00:00;82;89;66;155
2018;January;3;2018-01-16 00:00;83;63;62;125
2018;January;3;2018-01-16 00:00;84;70;47;117
2018;January;3;2018-01-16 00:00;85;55;46;101
2018;January;3;2018-01-16 00:00;86;33;37;70
2018;January;3;2018-01-16 00:00;87;43;29;72
2018;January;3;2018-01-16 00:00;88;45;27;72
2018;January;3;2018-01-16 00:00;89;34;23;57
2018;January;3;2018-01-16 00:00;90;30;16;46
2018;January;3;2018-01-16 00:00;91;29;9;38
2018;January;3;2018-01-16 00:00;92;21;11;32
2018;January;3;2018-01-16 00:00;93;20;6;26
2018;January;3;2018-01-16 00:00;94;11;8;19
2018;January;3;2018-01-16 00:00;95;12;6;18
2018;January;3;2018-01-16 00:00;96;13;3;16
2018;January;3;2018-01-16 00:00;97;5;4;9
2018;January;3;2018-01-16 00:00;98;3;2;5
2018;January;3;2018-01-16 00:00;99;0;1;1
2018;January;3;2018-01-16 00:00;100;1;1;2
2018;January;3;2018-01-16 00:00;106;1;0;1
2018;January;4;2018-01-23 00:00;0;8;11;19
2018;January;4;2018-01-23 00:00;1;190;192;382
2018;January;4;2018-01-23 00:00;2;175;197;372
2018;January;4;2018-01-23 00:00;3;189;206;395
2018;January;4;2018-01-23 00:00;4;182;226;408
2018;January;4;2018-01-23 00:00;5;200;221;421
2018;January;4;2018-01-23 00:00;6;195;204;399
2018;January;4;2018-01-23 00:00;7;223;240;463
2018;January;4;2018-01-23 00:00;8;219;235;454
2018;January;4;2018-01-23 00:00;9;208;218;426
2018;January;4;2018-01-23 00:00;10;201;198;399
2018;January;4;2018-01-23 00:00;11;187;205;392
2018;January;4;2018-01-23 00:00;12;226;198;424
2018;January;4;2018-01-23 00:00;13;183;211;394
2018;January;4;2018-01-23 00:00;14;186;204;390
2018;January;4;2018-01-23 00:00;15;179;187;366
2018;January;4;2018-01-23 00:00;16;175;221;396
2018;January;4;2018-01-23 00:00;17;139;186;325
2018;January;4;2018-01-23 00:00;18;181;203;384
2018;January;4;2018-01-23 00:00;19;176;187;363
2018;January;4;2018-01-23 00:00;20;155;167;322
2018;January;4;2018-01-23 00:00;21;144;190;334
2018;January;4;2018-01-23 00:00;22;154;172;326
2018;January;4;2018-01-23 00:00;23;142;176;318
2018;January;4;2018-01-23 00:00;24;167;182;349
2018;January;4;2018-01-23 00:00;25;180;204;384
2018;January;4;2018-01-23 00:00;26;173;187;360
2018;January;4;2018-01-23 00:00;27;181;230;411
2018;January;4;2018-01-23 00:00;28;193;197;390
2018;January;4;2018-01-23 00:00;29;163;194;357
2018;January;4;2018-01-23 00:00;30;181;183;364
2018;January;4;2018-01-23 00:00;31;187;188;375
2018;January;4;2018-01-23 00:00;32;174;188;362
2018;January;4;2018-01-23 00:00;33;187;201;388
2018;January;4;2018-01-23 00:00;34;190;192;382
2018;January;4;2018-01-23 00:00;35;214;182;396
2018;January;4;2018-01-23 00:00;36;207;193;400
2018;January;4;2018-01-23 00:00;37;171;189;360
2018;January;4;2018-01-23 00:00;38;231;201;432
2018;January;4;2018-01-23 00:00;39;208;178;386
2018;January;4;2018-01-23 00:00;40;190;208;398
2018;January;4;2018-01-23 00:00;41;195;208;403
2018;January;4;2018-01-23 00:00;42;219;219;438
2018;January;4;2018-01-23 00:00;43;222;244;466
2018;January;4;2018-01-23 00:00;44;228;278;506
2018;January;4;2018-01-23 00:00;45;211;217;428
2018;January;4;2018-01-23 00:00;46;222;252;474
2018;January;4;2018-01-23 00:00;47;214;216;430
2018;January;4;2018-01-23 00:00;48;212;223;435
2018;January;4;2018-01-23 00:00;49;200;198;398
2018;January;4;2018-01-23 00:00;50;209;219;428
2018;January;4;2018-01-23 00:00;51;235;226;461
2018;January;4;2018-01-23 00:00;52;188;223;411
2018;January;4;2018-01-23 00:00;53;199;222;421
2018;January;4;2018-01-23 00:00;54;188;223;411
2018;January;4;2018-01-23 00:00;55;180;215;395
2018;January;4;2018-01-23 00:00;56;187;188;375
2018;January;4;2018-01-23 00:00;57;151;167;318
2018;January;4;2018-01-23 00:00;58;157;152;309
2018;January;4;2018-01-23 00:00;59;157;165;322
2018;January;4;2018-01-23 00:00;60;156;153;309
2018;January;4;2018-01-23 00:00;61;150;158;308
2018;January;4;2018-01-23 00:00;62;150;158;308
2018;January;4;2018-01-23 00:00;63;136;123;259
2018;January;4;2018-01-23 00:00;64;133;137;270
2018;January;4;2018-01-23 00:00;65;146;136;282
2018;January;4;2018-01-23 00:00;66;138;157;295
2018;January;4;2018-01-23 00:00;67;144;138;282
2018;January;4;2018-01-23 00:00;68;142;159;301
2018;January;4;2018-01-23 00:00;69;147;160;307
2018;January;4;2018-01-23 00:00;70;175;164;339
2018;January;4;2018-01-23 00:00;71;162;157;319
2018;January;4;2018-01-23 00:00;72;182;150;332
2018;January;4;2018-01-23 00:00;73;181;172;353
2018;January;4;2018-01-23 00:00;74;151;160;311
2018;January;4;2018-01-23 00:00;75;153;166;319
2018;January;4;2018-01-23 00:00;76;139;135;274
2018;January;4;2018-01-23 00:00;77;111;103;214
2018;January;4;2018-01-23 00:00;78;83;124;207
2018;January;4;2018-01-23 00:00;79;88;89;177
2018;January;4;2018-01-23 00:00;80;94;78;172
2018;January;4;2018-01-23 00:00;81;79;73;152
2018;January;4;2018-01-23 00:00;82;89;66;155
2018;January;4;2018-01-23 00:00;83;62;62;124
2018;January;4;2018-01-23 00:00;84;70;47;117
2018;January;4;2018-01-23 00:00;85;55;46;101
2018;January;4;2018-01-23 00:00;86;32;37;69
2018;January;4;2018-01-23 00:00;87;43;29;72
2018;January;4;2018-01-23 00:00;88;45;27;72
2018;January;4;2018-01-23 00:00;89;34;23;57
2018;January;4;2018-01-23 00:00;90;30;16;46
2018;January;4;2018-01-23 00:00;91;29;9;38
2018;January;4;2018-01-23 00:00;92;21;11;32
2018;January;4;2018-01-23 00:00;93;20;6;26
2018;January;4;2018-01-23 00:00;94;11;8;19
2018;January;4;2018-01-23 00:00;95;12;6;18
2018;January;4;2018-01-23 00:00;96;13;3;16
2018;January;4;2018-01-23 00:00;97;5;4;9
2018;January;4;2018-01-23 00:00;98;3;2;5
2018;January;4;2018-01-23 00:00;99;0;1;1
2018;January;4;2018-01-23 00:00;100;1;1;2
2018;January;4;2018-01-23 00:00;106;1;0;1
2018;January;5;2018-01-30 00:00;0;12;16;28
2018;January;5;2018-01-30 00:00;1;190;193;383
2018;January;5;2018-01-30 00:00;2;175;198;373
2018;January;5;2018-01-30 00:00;3;189;206;395
2018;January;5;2018-01-30 00:00;4;181;227;408
2018;January;5;2018-01-30 00:00;5;201;222;423
2018;January;5;2018-01-30 00:00;6;194;205;399
2018;January;5;2018-01-30 00:00;7;223;241;464
2018;January;5;2018-01-30 00:00;8;219;236;455
2018;January;5;2018-01-30 00:00;9;208;218;426
2018;January;5;2018-01-30 00:00;10;201;199;400
2018;January;5;2018-01-30 00:00;11;188;205;393
2018;January;5;2018-01-30 00:00;12;226;199;425
2018;January;5;2018-01-30 00:00;13;183;211;394
2018;January;5;2018-01-30 00:00;14;186;204;390
2018;January;5;2018-01-30 00:00;15;179;187;366
2018;January;5;2018-01-30 00:00;16;175;221;396
2018;January;5;2018-01-30 00:00;17;139;186;325
2018;January;5;2018-01-30 00:00;18;181;203;384
2018;January;5;2018-01-30 00:00;19;176;187;363
2018;January;5;2018-01-30 00:00;20;156;167;323
2018;January;5;2018-01-30 00:00;21;143;190;333
2018;January;5;2018-01-30 00:00;22;155;173;328
2018;January;5;2018-01-30 00:00;23;141;177;318
2018;January;5;2018-01-30 00:00;24;168;182;350
2018;January;5;2018-01-30 00:00;25;180;203;383
2018;January;5;2018-01-30 00:00;26;174;186;360
2018;January;5;2018-01-30 00:00;27;183;231;414
2018;January;5;2018-01-30 00:00;28;193;196;389
2018;January;5;2018-01-30 00:00;29;164;192;356
2018;January;5;2018-01-30 00:00;30;181;182;363
2018;January;5;2018-01-30 00:00;31;188;188;376
2018;January;5;2018-01-30 00:00;32;174;189;363
2018;January;5;2018-01-30 00:00;33;187;201;388
2018;January;5;2018-01-30 00:00;34;188;192;380
2018;January;5;2018-01-30 00:00;35;215;184;399
2018;January;5;2018-01-30 00:00;36;208;194;402
2018;January;5;2018-01-30 00:00;37;171;189;360
2018;January;5;2018-01-30 00:00;38;232;201;433
2018;January;5;2018-01-30 00:00;39;208;178;386
2018;January;5;2018-01-30 00:00;40;190;208;398
2018;January;5;2018-01-30 00:00;41;195;208;403
2018;January;5;2018-01-30 00:00;42;219;218;437
2018;January;5;2018-01-30 00:00;43;222;244;466
2018;January;5;2018-01-30 00:00;44;228;278;506
2018;January;5;2018-01-30 00:00;45;211;218;429
2018;January;5;2018-01-30 00:00;46;223;252;475
2018;January;5;2018-01-30 00:00;47;215;216;431
2018;January;5;2018-01-30 00:00;48;212;222;434
2018;January;5;2018-01-30 00:00;49;200;198;398
2018;January;5;2018-01-30 00:00;50;209;219;428
2018;January;5;2018-01-30 00:00;51;235;227;462
2018;January;5;2018-01-30 00:00;52;188;223;411
2018;January;5;2018-01-30 00:00;53;199;221;420
2018;January;5;2018-01-30 00:00;54;188;223;411
2018;January;5;2018-01-30 00:00;55;180;215;395
2018;January;5;2018-01-30 00:00;56;187;188;375
2018;January;5;2018-01-30 00:00;57;151;168;319
2018;January;5;2018-01-30 00:00;58;157;152;309
2018;January;5;2018-01-30 00:00;59;157;165;322
2018;January;5;2018-01-30 00:00;60;156;153;309
2018;January;5;2018-01-30 00:00;61;149;158;307
2018;January;5;2018-01-30 00:00;62;150;156;306
2018;January;5;2018-01-30 00:00;63;136;122;258
2018;January;5;2018-01-30 00:00;64;133;137;270
2018;January;5;2018-01-30 00:00;65;146;136;282
2018;January;5;2018-01-30 00:00;66;138;157;295
2018;January;5;2018-01-30 00:00;67;144;138;282
2018;January;5;2018-01-30 00:00;68;142;159;301
2018;January;5;2018-01-30 00:00;69;147;160;307
2018;January;5;2018-01-30 00:00;70;175;164;339
2018;January;5;2018-01-30 00:00;71;162;157;319
2018;January;5;2018-01-30 00:00;72;182;149;331
2018;January;5;2018-01-30 00:00;73;180;171;351
2018;January;5;2018-01-30 00:00;74;151;160;311
2018;January;5;2018-01-30 00:00;75;153;166;319
2018;January;5;2018-01-30 00:00;76;139;135;274
2018;January;5;2018-01-30 00:00;77;111;101;212
2018;January;5;2018-01-30 00:00;78;83;124;207
2018;January;5;2018-01-30 00:00;79;88;88;176
2018;January;5;2018-01-30 00:00;80;94;78;172
2018;January;5;2018-01-30 00:00;81;79;73;152
2018;January;5;2018-01-30 00:00;82;89;65;154
2018;January;5;2018-01-30 00:00;83;62;62;124
2018;January;5;2018-01-30 00:00;84;70;47;117
2018;January;5;2018-01-30 00:00;85;55;46;101
2018;January;5;2018-01-30 00:00;86;32;37;69
2018;January;5;2018-01-30 00:00;87;43;29;72
2018;January;5;2018-01-30 00:00;88;45;26;71
2018;January;5;2018-01-30 00:00;89;34;23;57
2018;January;5;2018-01-30 00:00;90;30;16;46
2018;January;5;2018-01-30 00:00;91;29;9;38
2018;January;5;2018-01-30 00:00;92;21;11;32
2018;January;5;2018-01-30 00:00;93;19;6;25
2018;January;5;2018-01-30 00:00;94;11;8;19
2018;January;5;2018-01-30 00:00;95;11;6;17
2018;January;5;2018-01-30 00:00;96;13;3;16
2018;January;5;2018-01-30 00:00;97;4;4;8
2018;January;5;2018-01-30 00:00;98;3;2;5
2018;January;5;2018-01-30 00:00;99;0;1;1
2018;January;5;2018-01-30 00:00;100;1;1;2
2018;January;5;2018-01-30 00:00;106;1;0;1
2018;February;6;2018-02-06 00:00;0;15;20;35
2018;February;6;2018-02-06 00:00;1;190;194;384
2018;February;6;2018-02-06 00:00;2;176;198;374
2018;February;6;2018-02-06 00:00;3;189;206;395
2018;February;6;2018-02-06 00:00;4;181;227;408
2018;February;6;2018-02-06 00:00;5;201;222;423
2018;February;6;2018-02-06 00:00;6;194;205;399
2018;February;6;2018-02-06 00:00;7;223;241;464
2018;February;6;2018-02-06 00:00;8;219;236;455
2018;February;6;2018-02-06 00:00;9;207;218;425
2018;February;6;2018-02-06 00:00;10;201;199;400
2018;February;6;2018-02-06 00:00;11;188;205;393
2018;February;6;2018-02-06 00:00;12;226;199;425
2018;February;6;2018-02-06 00:00;13;184;211;395
2018;February;6;2018-02-06 00:00;14;186;204;390
2018;February;6;2018-02-06 00:00;15;179;187;366
2018;February;6;2018-02-06 00:00;16;175;221;396
2018;February;6;2018-02-06 00:00;17;140;186;326
2018;February;6;2018-02-06 00:00;18;181;203;384
2018;February;6;2018-02-06 00:00;19;178;189;367
2018;February;6;2018-02-06 00:00;20;156;167;323
2018;February;6;2018-02-06 00:00;21;144;191;335
2018;February;6;2018-02-06 00:00;22;157;173;330
2018;February;6;2018-02-06 00:00;23;141;176;317
2018;February;6;2018-02-06 00:00;24;170;181;351
2018;February;6;2018-02-06 00:00;25;182;203;385
2018;February;6;2018-02-06 00:00;26;177;187;364
2018;February;6;2018-02-06 00:00;27;182;231;413
2018;February;6;2018-02-06 00:00;28;193;198;391
2018;February;6;2018-02-06 00:00;29;166;192;358
2018;February;6;2018-02-06 00:00;30;182;182;364
2018;February;6;2018-02-06 00:00;31;191;189;380
2018;February;6;2018-02-06 00:00;32;174;188;362
2018;February;6;2018-02-06 00:00;33;187;202;389
2018;February;6;2018-02-06 00:00;34;189;193;382
2018;February;6;2018-02-06 00:00;35;215;184;399
2018;February;6;2018-02-06 00:00;36;208;194;402
2018;February;6;2018-02-06 00:00;37;171;189;360
2018;February;6;2018-02-06 00:00;38;232;203;435
2018;February;6;2018-02-06 00:00;39;208;178;386
2018;February;6;2018-02-06 00:00;40;191;208;399
2018;February;6;2018-02-06 00:00;41;195;208;403
2018;February;6;2018-02-06 00:00;42;219;218;437
2018;February;6;2018-02-06 00:00;43;222;244;466
2018;February;6;2018-02-06 00:00;44;228;278;506
2018;February;6;2018-02-06 00:00;45;212;219;431
2018;February;6;2018-02-06 00:00;46;223;252;475
2018;February;6;2018-02-06 00:00;47;215;216;431
2018;February;6;2018-02-06 00:00;48;212;222;434
2018;February;6;2018-02-06 00:00;49;200;198;398
2018;February;6;2018-02-06 00:00;50;208;219;427
2018;February;6;2018-02-06 00:00;51;235;227;462
2018;February;6;2018-02-06 00:00;52;188;224;412
2018;February;6;2018-02-06 00:00;53;199;221;420
2018;February;6;2018-02-06 00:00;54;188;223;411
2018;February;6;2018-02-06 00:00;55;181;215;396
2018;February;6;2018-02-06 00:00;56;189;188;377
2018;February;6;2018-02-06 00:00;57;151;169;320
2018;February;6;2018-02-06 00:00;58;158;152;310
2018;February;6;2018-02-06 00:00;59;157;165;322
2018;February;6;2018-02-06 00:00;60;155;152;307
2018;February;6;2018-02-06 00:00;61;149;158;307
2018;February;6;2018-02-06 00:00;62;150;156;306
2018;February;6;2018-02-06 00:00;63;135;121;256
2018;February;6;2018-02-06 00:00;64;133;137;270
2018;February;6;2018-02-06 00:00;65;146;136;282
2018;February;6;2018-02-06 00:00;66;138;157;295
2018;February;6;2018-02-06 00:00;67;144;138;282
2018;February;6;2018-02-06 00:00;68;142;159;301
2018;February;6;2018-02-06 00:00;69;147;160;307
2018;February;6;2018-02-06 00:00;70;175;165;340
2018;February;6;2018-02-06 00:00;71;162;157;319
2018;February;6;2018-02-06 00:00;72;182;149;331
2018;February;6;2018-02-06 00:00;73;180;171;351
2018;February;6;2018-02-06 00:00;74;150;160;310
2018;February;6;2018-02-06 00:00;75;153;165;318
2018;February;6;2018-02-06 00:00;76;139;135;274
2018;February;6;2018-02-06 00:00;77;110;101;211
2018;February;6;2018-02-06 00:00;78;83;124;207
2018;February;6;2018-02-06 00:00;79;87;88;175
2018;February;6;2018-02-06 00:00;80;94;78;172
2018;February;6;2018-02-06 00:00;81;79;73;152
2018;February;6;2018-02-06 00:00;82;89;65;154
2018;February;6;2018-02-06 00:00;83;63;63;126
2018;February;6;2018-02-06 00:00;84;70;47;117
2018;February;6;2018-02-06 00:00;85;55;46;101
2018;February;6;2018-02-06 00:00;86;32;37;69
2018;February;6;2018-02-06 00:00;87;43;29;72
2018;February;6;2018-02-06 00:00;88;45;26;71
2018;February;6;2018-02-06 00:00;89;34;23;57
2018;February;6;2018-02-06 00:00;90;30;16;46
2018;February;6;2018-02-06 00:00;91;29;9;38
2018;February;6;2018-02-06 00:00;92;21;11;32
2018;February;6;2018-02-06 00:00;93;19;6;25
2018;February;6;2018-02-06 00:00;94;10;8;18
2018;February;6;2018-02-06 00:00;95;9;6;15
2018;February;6;2018-02-06 00:00;96;13;3;16
2018;February;6;2018-02-06 00:00;97;4;4;8
2018;February;6;2018-02-06 00:00;98;3;2;5
2018;February;6;2018-02-06 00:00;99;0;1;1
2018;February;6;2018-02-06 00:00;100;1;1;2
2018;February;6;2018-02-06 00:00;106;1;0;1
2018;February;7;2018-02-13 00:00;0;20;23;43
2018;February;7;2018-02-13 00:00;1;191;194;385
2018;February;7;2018-02-13 00:00;2;177;199;376
2018;February;7;2018-02-13 00:00;3;189;205;394
2018;February;7;2018-02-13 00:00;4;181;227;408
2018;February;7;2018-02-13 00:00;5;202;222;424
2018;February;7;2018-02-13 00:00;6;194;206;400
2018;February;7;2018-02-13 00:00;7;223;241;464
2018;February;7;2018-02-13 00:00;8;219;236;455
2018;February;7;2018-02-13 00:00;9;208;218;426
2018;February;7;2018-02-13 00:00;10;201;199;400
2018;February;7;2018-02-13 00:00;11;188;205;393
2018;February;7;2018-02-13 00:00;12;227;199;426
2018;February;7;2018-02-13 00:00;13;184;211;395
2018;February;7;2018-02-13 00:00;14;186;204;390
2018;February;7;2018-02-13 00:00;15;180;186;366
2018;February;7;2018-02-13 00:00;16;175;221;396
2018;February;7;2018-02-13 00:00;17;140;185;325
2018;February;7;2018-02-13 00:00;18;183;202;385
2018;February;7;2018-02-13 00:00;19;180;189;369
2018;February;7;2018-02-13 00:00;20;156;167;323
2018;February;7;2018-02-13 00:00;21;144;191;335
2018;February;7;2018-02-13 00:00;22;156;173;329
2018;February;7;2018-02-13 00:00;23;141;174;315
2018;February;7;2018-02-13 00:00;24;170;181;351
2018;February;7;2018-02-13 00:00;25;183;203;386
2018;February;7;2018-02-13 00:00;26;177;186;363
2018;February;7;2018-02-13 00:00;27;183;230;413
2018;February;7;2018-02-13 00:00;28;194;199;393
2018;February;7;2018-02-13 00:00;29;166;192;358
2018;February;7;2018-02-13 00:00;30;182;181;363
2018;February;7;2018-02-13 00:00;31;190;189;379
2018;February;7;2018-02-13 00:00;32;176;189;365
2018;February;7;2018-02-13 00:00;33;187;201;388
2018;February;7;2018-02-13 00:00;34;190;195;385
2018;February;7;2018-02-13 00:00;35;215;184;399
2018;February;7;2018-02-13 00:00;36;207;194;401
2018;February;7;2018-02-13 00:00;37;172;189;361
2018;February;7;2018-02-13 00:00;38;232;206;438
2018;February;7;2018-02-13 00:00;39;207;178;385
2018;February;7;2018-02-13 00:00;40;191;208;399
2018;February;7;2018-02-13 00:00;41;195;208;403
2018;February;7;2018-02-13 00:00;42;220;218;438
2018;February;7;2018-02-13 00:00;43;222;244;466
2018;February;7;2018-02-13 00:00;44;228;278;506
2018;February;7;2018-02-13 00:00;45;212;219;431
2018;February;7;2018-02-13 00:00;46;223;252;475
2018;February;7;2018-02-13 00:00;47;215;216;431
2018;February;7;2018-02-13 00:00;48;212;223;435
2018;February;7;2018-02-13 00:00;49;200;198;398
2018;February;7;2018-02-13 00:00;50;208;220;428
2018;February;7;2018-02-13 00:00;51;235;227;462
2018;February;7;2018-02-13 00:00;52;188;224;412
2018;February;7;2018-02-13 00:00;53;199;221;420
2018;February;7;2018-02-13 00:00;54;187;223;410
2018;February;7;2018-02-13 00:00;55;182;214;396
2018;February;7;2018-02-13 00:00;56;189;188;377
2018;February;7;2018-02-13 00:00;57;150;169;319
2018;February;7;2018-02-13 00:00;58;157;152;309
2018;February;7;2018-02-13 00:00;59;157;165;322
2018;February;7;2018-02-13 00:00;60;154;152;306
2018;February;7;2018-02-13 00:00;61;149;158;307
2018;February;7;2018-02-13 00:00;62;150;156;306
2018;February;7;2018-02-13 00:00;63;135;121;256
2018;February;7;2018-02-13 00:00;64;133;138;271
2018;February;7;2018-02-13 00:00;65;146;136;282
2018;February;7;2018-02-13 00:00;66;138;157;295
2018;February;7;2018-02-13 00:00;67;144;138;282
2018;February;7;2018-02-13 00:00;68;142;159;301
2018;February;7;2018-02-13 00:00;69;147;160;307
2018;February;7;2018-02-13 00:00;70;175;165;340
2018;February;7;2018-02-13 00:00;71;162;157;319
2018;February;7;2018-02-13 00:00;72;180;149;329
2018;February;7;2018-02-13 00:00;73;180;171;351
2018;February;7;2018-02-13 00:00;74;150;160;310
2018;February;7;2018-02-13 00:00;75;153;165;318
2018;February;7;2018-02-13 00:00;76;139;135;274
2018;February;7;2018-02-13 00:00;77;109;101;210
2018;February;7;2018-02-13 00:00;78;83;124;207
2018;February;7;2018-02-13 00:00;79;87;88;175
2018;February;7;2018-02-13 00:00;80;94;78;172
2018;February;7;2018-02-13 00:00;81;79;72;151
2018;February;7;2018-02-13 00:00;82;89;65;154
2018;February;7;2018-02-13 00:00;83;63;63;126
2018;February;7;2018-02-13 00:00;84;70;47;117
2018;February;7;2018-02-13 00:00;85;55;46;101
2018;February;7;2018-02-13 00:00;86;32;37;69
2018;February;7;2018-02-13 00:00;87;43;28;71
2018;February;7;2018-02-13 00:00;88;45;25;70
2018;February;7;2018-02-13 00:00;89;34;23;57
2018;February;7;2018-02-13 00:00;90;30;15;45
2018;February;7;2018-02-13 00:00;91;29;9;38
2018;February;7;2018-02-13 00:00;92;21;11;32
2018;February;7;2018-02-13 00:00;93;19;6;25
2018;February;7;2018-02-13 00:00;94;10;8;18
2018;February;7;2018-02-13 00:00;95;9;6;15
2018;February;7;2018-02-13 00:00;96;13;3;16
2018;February;7;2018-02-13 00:00;97;4;4;8
2018;February;7;2018-02-13 00:00;98;3;2;5
2018;February;7;2018-02-13 00:00;99;0;1;1
2018;February;7;2018-02-13 00:00;100;1;1;2
2018;February;7;2018-02-13 00:00;106;1;0;1
2018;February;8;2018-02-22 00:00;0;20;23;43
2018;February;8;2018-02-22 00:00;1;191;194;385
2018;February;8;2018-02-22 00:00;2;177;199;376
2018;February;8;2018-02-22 00:00;3;189;205;394
2018;February;8;2018-02-22 00:00;4;181;227;408
2018;February;8;2018-02-22 00:00;5;202;222;424
2018;February;8;2018-02-22 00:00;6;194;206;400
2018;February;8;2018-02-22 00:00;7;223;241;464
2018;February;8;2018-02-22 00:00;8;219;236;455
2018;February;8;2018-02-22 00:00;9;208;218;426
2018;February;8;2018-02-22 00:00;10;201;199;400
2018;February;8;2018-02-22 00:00;11;188;205;393
2018;February;8;2018-02-22 00:00;12;227;199;426
2018;February;8;2018-02-22 00:00;13;184;211;395
2018;February;8;2018-02-22 00:00;14;186;204;390
2018;February;8;2018-02-22 00:00;15;180;186;366
2018;February;8;2018-02-22 00:00;16;175;221;396
2018;February;8;2018-02-22 00:00;17;140;185;325
2018;February;8;2018-02-22 00:00;18;183;202;385
2018;February;8;2018-02-22 00:00;19;180;189;369
2018;February;8;2018-02-22 00:00;20;156;167;323
2018;February;8;2018-02-22 00:00;21;144;191;335
2018;February;8;2018-02-22 00:00;22;156;173;329
2018;February;8;2018-02-22 00:00;23;141;174;315
2018;February;8;2018-02-22 00:00;24;170;181;351
2018;February;8;2018-02-22 00:00;25;183;203;386
2018;February;8;2018-02-22 00:00;26;177;186;363
2018;February;8;2018-02-22 00:00;27;183;230;413
2018;February;8;2018-02-22 00:00;28;194;199;393
2018;February;8;2018-02-22 00:00;29;166;192;358
2018;February;8;2018-02-22 00:00;30;182;181;363
2018;February;8;2018-02-22 00:00;31;190;189;379
2018;February;8;2018-02-22 00:00;32;176;189;365
2018;February;8;2018-02-22 00:00;33;187;201;388
2018;February;8;2018-02-22 00:00;34;190;195;385
2018;February;8;2018-02-22 00:00;35;215;184;399
2018;February;8;2018-02-22 00:00;36;207;194;401
2018;February;8;2018-02-22 00:00;37;172;189;361
2018;February;8;2018-02-22 00:00;38;232;206;438
2018;February;8;2018-02-22 00:00;39;207;178;385
2018;February;8;2018-02-22 00:00;40;191;208;399
2018;February;8;2018-02-22 00:00;41;195;208;403
2018;February;8;2018-02-22 00:00;42;220;218;438
2018;February;8;2018-02-22 00:00;43;222;244;466
2018;February;8;2018-02-22 00:00;44;228;278;506
2018;February;8;2018-02-22 00:00;45;212;219;431
2018;February;8;2018-02-22 00:00;46;223;252;475
2018;February;8;2018-02-22 00:00;47;215;216;431
2018;February;8;2018-02-22 00:00;48;212;223;435
2018;February;8;2018-02-22 00:00;49;200;198;398
2018;February;8;2018-02-22 00:00;50;208;220;428
2018;February;8;2018-02-22 00:00;51;235;227;462
2018;February;8;2018-02-22 00:00;52;188;224;412
2018;February;8;2018-02-22 00:00;53;199;221;420
2018;February;8;2018-02-22 00:00;54;187;223;410
2018;February;8;2018-02-22 00:00;55;182;214;396
2018;February;8;2018-02-22 00:00;56;189;188;377
2018;February;8;2018-02-22 00:00;57;150;169;319
2018;February;8;2018-02-22 00:00;58;157;152;309
2018;February;8;2018-02-22 00:00;59;157;165;322
2018;February;8;2018-02-22 00:00;60;154;152;306
2018;February;8;2018-02-22 00:00;61;149;158;307
2018;February;8;2018-02-22 00:00;62;150;156;306
2018;February;8;2018-02-22 00:00;63;135;121;256
2018;February;8;2018-02-22 00:00;64;133;138;271
2018;February;8;2018-02-22 00:00;65;146;136;282
2018;February;8;2018-02-22 00:00;66;138;157;295
2018;February;8;2018-02-22 00:00;67;144;138;282
2018;February;8;2018-02-22 00:00;68;142;159;301
2018;February;8;2018-02-22 00:00;69;147;160;307
2018;February;8;2018-02-22 00:00;70;175;165;340
2018;February;8;2018-02-22 00:00;71;162;157;319
2018;February;8;2018-02-22 00:00;72;180;149;329
2018;February;8;2018-02-22 00:00;73;180;171;351
2018;February;8;2018-02-22 00:00;74;150;160;310
2018;February;8;2018-02-22 00:00;75;153;165;318
2018;February;8;2018-02-22 00:00;76;139;135;274
2018;February;8;2018-02-22 00:00;77;109;101;210
2018;February;8;2018-02-22 00:00;78;83;124;207
2018;February;8;2018-02-22 00:00;79;87;88;175
2018;February;8;2018-02-22 00:00;80;94;78;172
2018;February;8;2018-02-22 00:00;81;79;72;151
2018;February;8;2018-02-22 00:00;82;89;65;154
2018;February;8;2018-02-22 00:00;83;63;63;126
2018;February;8;2018-02-22 00:00;84;70;47;117
2018;February;8;2018-02-22 00:00;85;55;46;101
2018;February;8;2018-02-22 00:00;86;32;37;69
2018;February;8;2018-02-22 00:00;87;43;28;71
2018;February;8;2018-02-22 00:00;88;45;25;70
2018;February;8;2018-02-22 00:00;89;34;23;57
2018;February;8;2018-02-22 00:00;90;30;15;45
2018;February;8;2018-02-22 00:00;91;29;9;38
2018;February;8;2018-02-22 00:00;92;21;11;32
2018;February;8;2018-02-22 00:00;93;19;6;25
2018;February;8;2018-02-22 00:00;94;10;8;18
2018;February;8;2018-02-22 00:00;95;9;6;15
2018;February;8;2018-02-22 00:00;96;13;3;16
2018;February;8;2018-02-22 00:00;97;4;4;8
2018;February;8;2018-02-22 00:00;98;3;2;5
2018;February;8;2018-02-22 00:00;99;0;1;1
2018;February;8;2018-02-22 00:00;100;1;1;2
2018;February;8;2018-02-22 00:00;106;1;0;1
2018;February;9;2018-02-27 00:00;0;20;23;43
2018;February;9;2018-02-27 00:00;1;191;194;385
2018;February;9;2018-02-27 00:00;2;177;199;376
2018;February;9;2018-02-27 00:00;3;189;205;394
2018;February;9;2018-02-27 00:00;4;181;227;408
2018;February;9;2018-02-27 00:00;5;202;222;424
2018;February;9;2018-02-27 00:00;6;194;206;400
2018;February;9;2018-02-27 00:00;7;223;241;464
2018;February;9;2018-02-27 00:00;8;219;236;455
2018;February;9;2018-02-27 00:00;9;208;218;426
2018;February;9;2018-02-27 00:00;10;201;199;400
2018;February;9;2018-02-27 00:00;11;188;205;393
2018;February;9;2018-02-27 00:00;12;226;199;425
2018;February;9;2018-02-27 00:00;13;184;211;395
2018;February;9;2018-02-27 00:00;14;186;203;389
2018;February;9;2018-02-27 00:00;15;180;186;366
2018;February;9;2018-02-27 00:00;16;175;221;396
2018;February;9;2018-02-27 00:00;17;140;185;325
2018;February;9;2018-02-27 00:00;18;183;202;385
2018;February;9;2018-02-27 00:00;19;180;189;369
2018;February;9;2018-02-27 00:00;20;156;167;323
2018;February;9;2018-02-27 00:00;21;144;191;335
2018;February;9;2018-02-27 00:00;22;156;173;329
2018;February;9;2018-02-27 00:00;23;141;174;315
2018;February;9;2018-02-27 00:00;24;170;181;351
2018;February;9;2018-02-27 00:00;25;183;203;386
2018;February;9;2018-02-27 00:00;26;177;186;363
2018;February;9;2018-02-27 00:00;27;183;230;413
2018;February;9;2018-02-27 00:00;28;194;199;393
2018;February;9;2018-02-27 00:00;29;166;192;358
2018;February;9;2018-02-27 00:00;30;182;181;363
2018;February;9;2018-02-27 00:00;31;190;189;379
2018;February;9;2018-02-27 00:00;32;176;189;365
2018;February;9;2018-02-27 00:00;33;187;201;388
2018;February;9;2018-02-27 00:00;34;190;195;385
2018;February;9;2018-02-27 00:00;35;215;184;399
2018;February;9;2018-02-27 00:00;36;207;194;401
2018;February;9;2018-02-27 00:00;37;172;189;361
2018;February;9;2018-02-27 00:00;38;232;206;438
2018;February;9;2018-02-27 00:00;39;207;178;385
2018;February;9;2018-02-27 00:00;40;191;208;399
2018;February;9;2018-02-27 00:00;41;195;208;403
2018;February;9;2018-02-27 00:00;42;220;218;438
2018;February;9;2018-02-27 00:00;43;222;244;466
2018;February;9;2018-02-27 00:00;44;228;278;506
2018;February;9;2018-02-27 00:00;45;212;219;431
2018;February;9;2018-02-27 00:00;46;223;252;475
2018;February;9;2018-02-27 00:00;47;215;216;431
2018;February;9;2018-02-27 00:00;48;212;223;435
2018;February;9;2018-02-27 00:00;49;200;198;398
2018;February;9;2018-02-27 00:00;50;208;220;428
2018;February;9;2018-02-27 00:00;51;235;227;462
2018;February;9;2018-02-27 00:00;52;188;224;412
2018;February;9;2018-02-27 00:00;53;199;221;420
2018;February;9;2018-02-27 00:00;54;187;223;410
2018;February;9;2018-02-27 00:00;55;182;214;396
2018;February;9;2018-02-27 00:00;56;189;188;377
2018;February;9;2018-02-27 00:00;57;150;169;319
2018;February;9;2018-02-27 00:00;58;157;152;309
2018;February;9;2018-02-27 00:00;59;157;165;322
2018;February;9;2018-02-27 00:00;60;154;152;306
2018;February;9;2018-02-27 00:00;61;149;158;307
2018;February;9;2018-02-27 00:00;62;150;156;306
2018;February;9;2018-02-27 00:00;63;135;121;256
2018;February;9;2018-02-27 00:00;64;133;138;271
2018;February;9;2018-02-27 00:00;65;146;136;282
2018;February;9;2018-02-27 00:00;66;138;157;295
2018;February;9;2018-02-27 00:00;67;144;138;282
2018;February;9;2018-02-27 00:00;68;142;159;301
2018;February;9;2018-02-27 00:00;69;147;160;307
2018;February;9;2018-02-27 00:00;70;175;165;340
2018;February;9;2018-02-27 00:00;71;162;157;319
2018;February;9;2018-02-27 00:00;72;180;149;329
2018;February;9;2018-02-27 00:00;73;180;171;351
2018;February;9;2018-02-27 00:00;74;150;160;310
2018;February;9;2018-02-27 00:00;75;153;165;318
2018;February;9;2018-02-27 00:00;76;139;135;274
2018;February;9;2018-02-27 00:00;77;109;101;210
2018;February;9;2018-02-27 00:00;78;83;124;207
2018;February;9;2018-02-27 00:00;79;87;88;175
2018;February;9;2018-02-27 00:00;80;94;78;172
2018;February;9;2018-02-27 00:00;81;79;72;151
2018;February;9;2018-02-27 00:00;82;89;65;154
2018;February;9;2018-02-27 00:00;83;63;63;126
2018;February;9;2018-02-27 00:00;84;70;47;117
2018;February;9;2018-02-27 00:00;85;55;46;101
2018;February;9;2018-02-27 00:00;86;32;37;69
2018;February;9;2018-02-27 00:00;87;43;28;71
2018;February;9;2018-02-27 00:00;88;45;25;70
2018;February;9;2018-02-27 00:00;89;34;23;57
2018;February;9;2018-02-27 00:00;90;30;15;45
2018;February;9;2018-02-27 00:00;91;29;9;38
2018;February;9;2018-02-27 00:00;92;21;11;32
2018;February;9;2018-02-27 00:00;93;19;6;25
2018;February;9;2018-02-27 00:00;94;10;8;18
2018;February;9;2018-02-27 00:00;95;9;6;15
2018;February;9;2018-02-27 00:00;96;13;3;16
2018;February;9;2018-02-27 00:00;97;4;4;8
2018;February;9;2018-02-27 00:00;98;3;2;5
2018;February;9;2018-02-27 00:00;99;0;1;1
2018;February;9;2018-02-27 00:00;100;1;1;2
2018;February;9;2018-02-27 00:00;106;1;0;1
2018;March;10;2018-03-06 00:00;0;29;33;62
2018;March;10;2018-03-06 00:00;1;192;194;386
2018;March;10;2018-03-06 00:00;2;176;200;376
2018;March;10;2018-03-06 00:00;3;191;205;396
2018;March;10;2018-03-06 00:00;4;181;227;408
2018;March;10;2018-03-06 00:00;5;204;224;428
2018;March;10;2018-03-06 00:00;6;194;204;398
2018;March;10;2018-03-06 00:00;7;223;241;464
2018;March;10;2018-03-06 00:00;8;220;236;456
2018;March;10;2018-03-06 00:00;9;207;219;426
2018;March;10;2018-03-06 00:00;10;201;199;400
2018;March;10;2018-03-06 00:00;11;187;206;393
2018;March;10;2018-03-06 00:00;12;227;199;426
2018;March;10;2018-03-06 00:00;13;185;211;396
2018;March;10;2018-03-06 00:00;14;185;203;388
2018;March;10;2018-03-06 00:00;15;178;184;362
2018;March;10;2018-03-06 00:00;16;176;222;398
2018;March;10;2018-03-06 00:00;17;139;185;324
2018;March;10;2018-03-06 00:00;18;182;201;383
2018;March;10;2018-03-06 00:00;19;179;188;367
2018;March;10;2018-03-06 00:00;20;159;169;328
2018;March;10;2018-03-06 00:00;21;143;192;335
2018;March;10;2018-03-06 00:00;22;153;170;323
2018;March;10;2018-03-06 00:00;23;140;178;318
2018;March;10;2018-03-06 00:00;24;171;184;355
2018;March;10;2018-03-06 00:00;25;182;201;383
2018;March;10;2018-03-06 00:00;26;175;185;360
2018;March;10;2018-03-06 00:00;27;185;228;413
2018;March;10;2018-03-06 00:00;28;192;197;389
2018;March;10;2018-03-06 00:00;29;166;192;358
2018;March;10;2018-03-06 00:00;30;184;178;362
2018;March;10;2018-03-06 00:00;31;192;189;381
2018;March;10;2018-03-06 00:00;32;178;189;367
2018;March;10;2018-03-06 00:00;33;188;206;394
2018;March;10;2018-03-06 00:00;34;192;196;388
2018;March;10;2018-03-06 00:00;35;216;187;403
2018;March;10;2018-03-06 00:00;36;205;194;399
2018;March;10;2018-03-06 00:00;37;174;189;363
2018;March;10;2018-03-06 00:00;38;230;207;437
2018;March;10;2018-03-06 00:00;39;207;177;384
2018;March;10;2018-03-06 00:00;40;192;208;400
2018;March;10;2018-03-06 00:00;41;195;206;401
2018;March;10;2018-03-06 00:00;42;220;219;439
2018;March;10;2018-03-06 00:00;43;222;244;466
2018;March;10;2018-03-06 00:00;44;228;279;507
2018;March;10;2018-03-06 00:00;45;213;219;432
2018;March;10;2018-03-06 00:00;46;224;251;475
2018;March;10;2018-03-06 00:00;47;215;216;431
2018;March;10;2018-03-06 00:00;48;211;222;433
2018;March;10;2018-03-06 00:00;49;199;197;396
2018;March;10;2018-03-06 00:00;50;208;221;429
2018;March;10;2018-03-06 00:00;51;235;226;461
2018;March;10;2018-03-06 00:00;52;187;224;411
2018;March;10;2018-03-06 00:00;53;199;221;420
2018;March;10;2018-03-06 00:00;54;187;223;410
2018;March;10;2018-03-06 00:00;55;182;213;395
2018;March;10;2018-03-06 00:00;56;188;187;375
2018;March;10;2018-03-06 00:00;57;150;169;319
2018;March;10;2018-03-06 00:00;58;156;153;309
2018;March;10;2018-03-06 00:00;59;157;166;323
2018;March;10;2018-03-06 00:00;60;154;152;306
2018;March;10;2018-03-06 00:00;61;149;158;307
2018;March;10;2018-03-06 00:00;62;150;156;306
2018;March;10;2018-03-06 00:00;63;135;120;255
2018;March;10;2018-03-06 00:00;64;133;137;270
2018;March;10;2018-03-06 00:00;65;145;136;281
2018;March;10;2018-03-06 00:00;66;137;156;293
2018;March;10;2018-03-06 00:00;67;144;137;281
2018;March;10;2018-03-06 00:00;68;141;158;299
2018;March;10;2018-03-06 00:00;69;147;160;307
2018;March;10;2018-03-06 00:00;70;175;166;341
2018;March;10;2018-03-06 00:00;71;162;157;319
2018;March;10;2018-03-06 00:00;72;180;149;329
2018;March;10;2018-03-06 00:00;73;182;171;353
2018;March;10;2018-03-06 00:00;74;150;160;310
2018;March;10;2018-03-06 00:00;75;153;165;318
2018;March;10;2018-03-06 00:00;76;140;135;275
2018;March;10;2018-03-06 00:00;77;108;101;209
2018;March;10;2018-03-06 00:00;78;82;124;206
2018;March;10;2018-03-06 00:00;79;86;88;174
2018;March;10;2018-03-06 00:00;80;94;78;172
2018;March;10;2018-03-06 00:00;81;79;71;150
2018;March;10;2018-03-06 00:00;82;89;65;154
2018;March;10;2018-03-06 00:00;83;61;63;124
2018;March;10;2018-03-06 00:00;84;68;47;115
2018;March;10;2018-03-06 00:00;85;54;46;100
2018;March;10;2018-03-06 00:00;86;31;37;68
2018;March;10;2018-03-06 00:00;87;43;28;71
2018;March;10;2018-03-06 00:00;88;44;24;68
2018;March;10;2018-03-06 00:00;89;34;23;57
2018;March;10;2018-03-06 00:00;90;29;15;44
2018;March;10;2018-03-06 00:00;91;29;9;38
2018;March;10;2018-03-06 00:00;92;21;11;32
2018;March;10;2018-03-06 00:00;93;19;6;25
2018;March;10;2018-03-06 00:00;94;11;8;19
2018;March;10;2018-03-06 00:00;95;9;6;15
2018;March;10;2018-03-06 00:00;96;12;2;14
2018;March;10;2018-03-06 00:00;97;4;4;8
2018;March;10;2018-03-06 00:00;98;3;2;5
2018;March;10;2018-03-06 00:00;99;0;1;1
2018;March;10;2018-03-06 00:00;100;1;1;2
2018;March;10;2018-03-06 00:00;106;1;0;1
2018;March;11;2018-03-13 00:00;0;31;35;66
2018;March;11;2018-03-13 00:00;1;192;194;386
2018;March;11;2018-03-13 00:00;2;176;201;377
2018;March;11;2018-03-13 00:00;3;191;205;396
2018;March;11;2018-03-13 00:00;4;181;228;409
2018;March;11;2018-03-13 00:00;5;204;224;428
2018;March;11;2018-03-13 00:00;6;194;204;398
2018;March;11;2018-03-13 00:00;7;223;241;464
2018;March;11;2018-03-13 00:00;8;220;236;456
2018;March;11;2018-03-13 00:00;9;207;219;426
2018;March;11;2018-03-13 00:00;10;201;200;401
2018;March;11;2018-03-13 00:00;11;187;207;394
2018;March;11;2018-03-13 00:00;12;227;199;426
2018;March;11;2018-03-13 00:00;13;185;211;396
2018;March;11;2018-03-13 00:00;14;185;203;388
2018;March;11;2018-03-13 00:00;15;178;184;362
2018;March;11;2018-03-13 00:00;16;176;222;398
2018;March;11;2018-03-13 00:00;17;139;185;324
2018;March;11;2018-03-13 00:00;18;182;201;383
2018;March;11;2018-03-13 00:00;19;180;188;368
2018;March;11;2018-03-13 00:00;20;159;170;329
2018;March;11;2018-03-13 00:00;21;143;192;335
2018;March;11;2018-03-13 00:00;22;153;170;323
2018;March;11;2018-03-13 00:00;23;140;179;319
2018;March;11;2018-03-13 00:00;24;171;184;355
2018;March;11;2018-03-13 00:00;25;181;200;381
2018;March;11;2018-03-13 00:00;26;174;185;359
2018;March;11;2018-03-13 00:00;27;185;227;412
2018;March;11;2018-03-13 00:00;28;193;198;391
2018;March;11;2018-03-13 00:00;29;168;192;360
2018;March;11;2018-03-13 00:00;30;184;179;363
2018;March;11;2018-03-13 00:00;31;193;189;382
2018;March;11;2018-03-13 00:00;32;178;189;367
2018;March;11;2018-03-13 00:00;33;189;206;395
2018;March;11;2018-03-13 00:00;34;192;197;389
2018;March;11;2018-03-13 00:00;35;218;187;405
2018;March;11;2018-03-13 00:00;36;205;194;399
2018;March;11;2018-03-13 00:00;37;174;189;363
2018;March;11;2018-03-13 00:00;38;230;207;437
2018;March;11;2018-03-13 00:00;39;207;178;385
2018;March;11;2018-03-13 00:00;40;192;208;400
2018;March;11;2018-03-13 00:00;41;196;206;402
2018;March;11;2018-03-13 00:00;42;220;220;440
2018;March;11;2018-03-13 00:00;43;222;244;466
2018;March;11;2018-03-13 00:00;44;228;279;507
2018;March;11;2018-03-13 00:00;45;213;220;433
2018;March;11;2018-03-13 00:00;46;224;251;475
2018;March;11;2018-03-13 00:00;47;215;216;431
2018;March;11;2018-03-13 00:00;48;211;222;433
2018;March;11;2018-03-13 00:00;49;199;197;396
2018;March;11;2018-03-13 00:00;50;208;221;429
2018;March;11;2018-03-13 00:00;51;235;226;461
2018;March;11;2018-03-13 00:00;52;187;224;411
2018;March;11;2018-03-13 00:00;53;199;221;420
2018;March;11;2018-03-13 00:00;54;187;222;409
2018;March;11;2018-03-13 00:00;55;182;213;395
2018;March;11;2018-03-13 00:00;56;188;187;375
2018;March;11;2018-03-13 00:00;57;150;168;318
2018;March;11;2018-03-13 00:00;58;156;153;309
2018;March;11;2018-03-13 00:00;59;157;166;323
2018;March;11;2018-03-13 00:00;60;154;152;306
2018;March;11;2018-03-13 00:00;61;149;158;307
2018;March;11;2018-03-13 00:00;62;151;156;307
2018;March;11;2018-03-13 00:00;63;135;120;255
2018;March;11;2018-03-13 00:00;64;133;137;270
2018;March;11;2018-03-13 00:00;65;145;136;281
2018;March;11;2018-03-13 00:00;66;137;156;293
2018;March;11;2018-03-13 00:00;67;144;137;281
2018;March;11;2018-03-13 00:00;68;141;158;299
2018;March;11;2018-03-13 00:00;69;147;160;307
2018;March;11;2018-03-13 00:00;70;174;166;340
2018;March;11;2018-03-13 00:00;71;161;157;318
2018;March;11;2018-03-13 00:00;72;180;149;329
2018;March;11;2018-03-13 00:00;73;182;171;353
2018;March;11;2018-03-13 00:00;74;150;160;310
2018;March;11;2018-03-13 00:00;75;152;165;317
2018;March;11;2018-03-13 00:00;76;140;135;275
2018;March;11;2018-03-13 00:00;77;108;101;209
2018;March;11;2018-03-13 00:00;78;82;124;206
2018;March;11;2018-03-13 00:00;79;86;88;174
2018;March;11;2018-03-13 00:00;80;94;78;172
2018;March;11;2018-03-13 00:00;81;79;71;150
2018;March;11;2018-03-13 00:00;82;89;65;154
2018;March;11;2018-03-13 00:00;83;60;63;123
2018;March;11;2018-03-13 00:00;84;68;47;115
2018;March;11;2018-03-13 00:00;85;54;46;100
2018;March;11;2018-03-13 00:00;86;31;37;68
2018;March;11;2018-03-13 00:00;87;43;28;71
2018;March;11;2018-03-13 00:00;88;44;24;68
2018;March;11;2018-03-13 00:00;89;33;23;56
2018;March;11;2018-03-13 00:00;90;28;15;43
2018;March;11;2018-03-13 00:00;91;29;9;38
2018;March;11;2018-03-13 00:00;92;21;11;32
2018;March;11;2018-03-13 00:00;93;19;6;25
2018;March;11;2018-03-13 00:00;94;11;8;19
2018;March;11;2018-03-13 00:00;95;9;6;15
2018;March;11;2018-03-13 00:00;96;12;2;14
2018;March;11;2018-03-13 00:00;97;4;4;8
2018;March;11;2018-03-13 00:00;98;2;2;4
2018;March;11;2018-03-13 00:00;99;0;1;1
2018;March;11;2018-03-13 00:00;100;1;1;2
2018;March;11;2018-03-13 00:00;106;1;0;1
2018;March;12;2018-03-20 00:00;0;37;39;76
2018;March;12;2018-03-20 00:00;1;192;194;386
2018;March;12;2018-03-20 00:00;2;177;202;379
2018;March;12;2018-03-20 00:00;3;192;206;398
2018;March;12;2018-03-20 00:00;4;181;229;410
2018;March;12;2018-03-20 00:00;5;204;224;428
2018;March;12;2018-03-20 00:00;6;194;204;398
2018;March;12;2018-03-20 00:00;7;223;241;464
2018;March;12;2018-03-20 00:00;8;220;236;456
2018;March;12;2018-03-20 00:00;9;208;219;427
2018;March;12;2018-03-20 00:00;10;201;200;401
2018;March;12;2018-03-20 00:00;11;187;207;394
2018;March;12;2018-03-20 00:00;12;227;199;426
2018;March;12;2018-03-20 00:00;13;185;211;396
2018;March;12;2018-03-20 00:00;14;184;203;387
2018;March;12;2018-03-20 00:00;15;179;184;363
2018;March;12;2018-03-20 00:00;16;176;221;397
2018;March;12;2018-03-20 00:00;17;139;185;324
2018;March;12;2018-03-20 00:00;18;181;201;382
2018;March;12;2018-03-20 00:00;19;181;189;370
2018;March;12;2018-03-20 00:00;20;158;170;328
2018;March;12;2018-03-20 00:00;21;144;192;336
2018;March;12;2018-03-20 00:00;22;151;170;321
2018;March;12;2018-03-20 00:00;23;142;178;320
2018;March;12;2018-03-20 00:00;24;171;181;352
2018;March;12;2018-03-20 00:00;25;179;200;379
2018;March;12;2018-03-20 00:00;26;174;184;358
2018;March;12;2018-03-20 00:00;27;184;227;411
2018;March;12;2018-03-20 00:00;28;193;198;391
2018;March;12;2018-03-20 00:00;29;169;193;362
2018;March;12;2018-03-20 00:00;30;181;179;360
2018;March;12;2018-03-20 00:00;31;193;189;382
2018;March;12;2018-03-20 00:00;32;179;189;368
2018;March;12;2018-03-20 00:00;33;190;207;397
2018;March;12;2018-03-20 00:00;34;192;197;389
2018;March;12;2018-03-20 00:00;35;218;187;405
2018;March;12;2018-03-20 00:00;36;206;193;399
2018;March;12;2018-03-20 00:00;37;174;189;363
2018;March;12;2018-03-20 00:00;38;230;208;438
2018;March;12;2018-03-20 00:00;39;208;179;387
2018;March;12;2018-03-20 00:00;40;192;208;400
2018;March;12;2018-03-20 00:00;41;196;206;402
2018;March;12;2018-03-20 00:00;42;220;220;440
2018;March;12;2018-03-20 00:00;43;222;244;466
2018;March;12;2018-03-20 00:00;44;228;279;507
2018;March;12;2018-03-20 00:00;45;213;220;433
2018;March;12;2018-03-20 00:00;46;224;251;475
2018;March;12;2018-03-20 00:00;47;215;216;431
2018;March;12;2018-03-20 00:00;48;211;222;433
2018;March;12;2018-03-20 00:00;49;199;197;396
2018;March;12;2018-03-20 00:00;50;208;221;429
2018;March;12;2018-03-20 00:00;51;235;226;461
2018;March;12;2018-03-20 00:00;52;187;224;411
2018;March;12;2018-03-20 00:00;53;199;221;420
2018;March;12;2018-03-20 00:00;54;188;222;410
2018;March;12;2018-03-20 00:00;55;182;213;395
2018;March;12;2018-03-20 00:00;56;190;187;377
2018;March;12;2018-03-20 00:00;57;150;168;318
2018;March;12;2018-03-20 00:00;58;156;154;310
2018;March;12;2018-03-20 00:00;59;157;166;323
2018;March;12;2018-03-20 00:00;60;154;152;306
2018;March;12;2018-03-20 00:00;61;149;158;307
2018;March;12;2018-03-20 00:00;62;151;156;307
2018;March;12;2018-03-20 00:00;63;135;120;255
2018;March;12;2018-03-20 00:00;64;133;137;270
2018;March;12;2018-03-20 00:00;65;145;135;280
2018;March;12;2018-03-20 00:00;66;137;156;293
2018;March;12;2018-03-20 00:00;67;144;137;281
2018;March;12;2018-03-20 00:00;68;141;158;299
2018;March;12;2018-03-20 00:00;69;147;160;307
2018;March;12;2018-03-20 00:00;70;174;166;340
2018;March;12;2018-03-20 00:00;71;161;157;318
2018;March;12;2018-03-20 00:00;72;180;149;329
2018;March;12;2018-03-20 00:00;73;182;171;353
2018;March;12;2018-03-20 00:00;74;150;160;310
2018;March;12;2018-03-20 00:00;75;153;165;318
2018;March;12;2018-03-20 00:00;76;140;135;275
2018;March;12;2018-03-20 00:00;77;108;101;209
2018;March;12;2018-03-20 00:00;78;82;124;206
2018;March;12;2018-03-20 00:00;79;86;88;174
2018;March;12;2018-03-20 00:00;80;94;78;172
2018;March;12;2018-03-20 00:00;81;79;71;150
2018;March;12;2018-03-20 00:00;82;89;65;154
2018;March;12;2018-03-20 00:00;83;60;63;123
2018;March;12;2018-03-20 00:00;84;67;47;114
2018;March;12;2018-03-20 00:00;85;54;46;100
2018;March;12;2018-03-20 00:00;86;31;37;68
2018;March;12;2018-03-20 00:00;87;43;28;71
2018;March;12;2018-03-20 00:00;88;43;24;67
2018;March;12;2018-03-20 00:00;89;33;23;56
2018;March;12;2018-03-20 00:00;90;28;15;43
2018;March;12;2018-03-20 00:00;91;29;9;38
2018;March;12;2018-03-20 00:00;92;21;11;32
2018;March;12;2018-03-20 00:00;93;19;6;25
2018;March;12;2018-03-20 00:00;94;11;8;19
2018;March;12;2018-03-20 00:00;95;9;6;15
2018;March;12;2018-03-20 00:00;96;12;2;14
2018;March;12;2018-03-20 00:00;97;4;4;8
2018;March;12;2018-03-20 00:00;98;2;2;4
2018;March;12;2018-03-20 00:00;99;0;1;1
2018;March;12;2018-03-20 00:00;100;1;1;2
2018;March;12;2018-03-20 00:00;106;1;0;1
2018;March;13;2018-03-27 00:00;0;41;40;81
2018;March;13;2018-03-27 00:00;1;192;194;386
2018;March;13;2018-03-27 00:00;2;178;204;382
2018;March;13;2018-03-27 00:00;3;192;206;398
2018;March;13;2018-03-27 00:00;4;181;228;409
2018;March;13;2018-03-27 00:00;5;204;225;429
2018;March;13;2018-03-27 00:00;6;194;204;398
2018;March;13;2018-03-27 00:00;7;223;241;464
2018;March;13;2018-03-27 00:00;8;220;236;456
2018;March;13;2018-03-27 00:00;9;208;219;427
2018;March;13;2018-03-27 00:00;10;201;200;401
2018;March;13;2018-03-27 00:00;11;187;207;394
2018;March;13;2018-03-27 00:00;12;227;199;426
2018;March;13;2018-03-27 00:00;13;185;212;397
2018;March;13;2018-03-27 00:00;14;184;203;387
2018;March;13;2018-03-27 00:00;15;180;185;365
2018;March;13;2018-03-27 00:00;16;176;221;397
2018;March;13;2018-03-27 00:00;17;140;185;325
2018;March;13;2018-03-27 00:00;18;182;201;383
2018;March;13;2018-03-27 00:00;19;180;189;369
2018;March;13;2018-03-27 00:00;20;158;170;328
2018;March;13;2018-03-27 00:00;21;144;192;336
2018;March;13;2018-03-27 00:00;22;151;168;319
2018;March;13;2018-03-27 00:00;23;144;178;322
2018;March;13;2018-03-27 00:00;24;171;180;351
2018;March;13;2018-03-27 00:00;25;178;199;377
2018;March;13;2018-03-27 00:00;26;175;184;359
2018;March;13;2018-03-27 00:00;27;183;228;411
2018;March;13;2018-03-27 00:00;28;192;198;390
2018;March;13;2018-03-27 00:00;29;170;194;364
2018;March;13;2018-03-27 00:00;30;181;180;361
2018;March;13;2018-03-27 00:00;31;194;188;382
2018;March;13;2018-03-27 00:00;32;180;189;369
2018;March;13;2018-03-27 00:00;33;190;207;397
2018;March;13;2018-03-27 00:00;34;192;199;391
2018;March;13;2018-03-27 00:00;35;218;187;405
2018;March;13;2018-03-27 00:00;36;206;193;399
2018;March;13;2018-03-27 00:00;37;174;190;364
2018;March;13;2018-03-27 00:00;38;230;207;437
2018;March;13;2018-03-27 00:00;39;209;179;388
2018;March;13;2018-03-27 00:00;40;192;207;399
2018;March;13;2018-03-27 00:00;41;195;206;401
2018;March;13;2018-03-27 00:00;42;221;221;442
2018;March;13;2018-03-27 00:00;43;223;245;468
2018;March;13;2018-03-27 00:00;44;230;280;510
2018;March;13;2018-03-27 00:00;45;213;221;434
2018;March;13;2018-03-27 00:00;46;224;251;475
2018;March;13;2018-03-27 00:00;47;216;215;431
2018;March;13;2018-03-27 00:00;48;210;223;433
2018;March;13;2018-03-27 00:00;49;198;197;395
2018;March;13;2018-03-27 00:00;50;207;221;428
2018;March;13;2018-03-27 00:00;51;235;226;461
2018;March;13;2018-03-27 00:00;52;187;224;411
2018;March;13;2018-03-27 00:00;53;199;222;421
2018;March;13;2018-03-27 00:00;54;188;222;410
2018;March;13;2018-03-27 00:00;55;183;213;396
2018;March;13;2018-03-27 00:00;56;190;187;377
2018;March;13;2018-03-27 00:00;57;150;168;318
2018;March;13;2018-03-27 00:00;58;156;154;310
2018;March;13;2018-03-27 00:00;59;157;166;323
2018;March;13;2018-03-27 00:00;60;154;152;306
2018;March;13;2018-03-27 00:00;61;149;158;307
2018;March;13;2018-03-27 00:00;62;151;156;307
2018;March;13;2018-03-27 00:00;63;135;120;255
2018;March;13;2018-03-27 00:00;64;133;137;270
2018;March;13;2018-03-27 00:00;65;145;135;280
2018;March;13;2018-03-27 00:00;66;137;156;293
2018;March;13;2018-03-27 00:00;67;144;137;281
2018;March;13;2018-03-27 00:00;68;141;157;298
2018;March;13;2018-03-27 00:00;69;147;160;307
2018;March;13;2018-03-27 00:00;70;174;166;340
2018;March;13;2018-03-27 00:00;71;161;157;318
2018;March;13;2018-03-27 00:00;72;180;149;329
2018;March;13;2018-03-27 00:00;73;182;171;353
2018;March;13;2018-03-27 00:00;74;150;160;310
2018;March;13;2018-03-27 00:00;75;152;165;317
2018;March;13;2018-03-27 00:00;76;140;135;275
2018;March;13;2018-03-27 00:00;77;108;101;209
2018;March;13;2018-03-27 00:00;78;82;124;206
2018;March;13;2018-03-27 00:00;79;86;88;174
2018;March;13;2018-03-27 00:00;80;94;78;172
2018;March;13;2018-03-27 00:00;81;79;71;150
2018;March;13;2018-03-27 00:00;82;90;65;155
2018;March;13;2018-03-27 00:00;83;60;63;123
2018;March;13;2018-03-27 00:00;84;67;47;114
2018;March;13;2018-03-27 00:00;85;54;46;100
2018;March;13;2018-03-27 00:00;86;31;37;68
2018;March;13;2018-03-27 00:00;87;43;28;71
2018;March;13;2018-03-27 00:00;88;43;24;67
2018;March;13;2018-03-27 00:00;89;33;23;56
2018;March;13;2018-03-27 00:00;90;28;15;43
2018;March;13;2018-03-27 00:00;91;29;9;38
2018;March;13;2018-03-27 00:00;92;21;11;32
2018;March;13;2018-03-27 00:00;93;19;6;25
2018;March;13;2018-03-27 00:00;94;11;8;19
2018;March;13;2018-03-27 00:00;95;9;6;15
2018;March;13;2018-03-27 00:00;96;12;2;14
2018;March;13;2018-03-27 00:00;97;4;4;8
2018;March;13;2018-03-27 00:00;98;2;2;4
2018;March;13;2018-03-27 00:00;99;0;1;1
2018;March;13;2018-03-27 00:00;100;1;1;2
2018;March;13;2018-03-27 00:00;106;1;0;1
2018;April;14;2018-04-03 00:00;0;46;45;91
2018;April;14;2018-04-03 00:00;1;193;194;387
2018;April;14;2018-04-03 00:00;2;179;204;383
2018;April;14;2018-04-03 00:00;3;193;206;399
2018;April;14;2018-04-03 00:00;4;180;228;408
2018;April;14;2018-04-03 00:00;5;205;225;430
2018;April;14;2018-04-03 00:00;6;193;203;396
2018;April;14;2018-04-03 00:00;7;223;241;464
2018;April;14;2018-04-03 00:00;8;220;235;455
2018;April;14;2018-04-03 00:00;9;208;219;427
2018;April;14;2018-04-03 00:00;10;202;200;402
2018;April;14;2018-04-03 00:00;11;186;207;393
2018;April;14;2018-04-03 00:00;12;227;199;426
2018;April;14;2018-04-03 00:00;13;185;212;397
2018;April;14;2018-04-03 00:00;14;183;203;386
2018;April;14;2018-04-03 00:00;15;180;185;365
2018;April;14;2018-04-03 00:00;16;177;222;399
2018;April;14;2018-04-03 00:00;17;140;185;325
2018;April;14;2018-04-03 00:00;18;182;201;383
2018;April;14;2018-04-03 00:00;19;179;189;368
2018;April;14;2018-04-03 00:00;20;158;170;328
2018;April;14;2018-04-03 00:00;21;144;191;335
2018;April;14;2018-04-03 00:00;22;151;169;320
2018;April;14;2018-04-03 00:00;23;143;178;321
2018;April;14;2018-04-03 00:00;24;171;180;351
2018;April;14;2018-04-03 00:00;25;176;197;373
2018;April;14;2018-04-03 00:00;26;174;184;358
2018;April;14;2018-04-03 00:00;27;184;226;410
2018;April;14;2018-04-03 00:00;28;193;197;390
2018;April;14;2018-04-03 00:00;29;170;194;364
2018;April;14;2018-04-03 00:00;30;184;181;365
2018;April;14;2018-04-03 00:00;31;194;190;384
2018;April;14;2018-04-03 00:00;32;179;190;369
2018;April;14;2018-04-03 00:00;33;190;208;398
2018;April;14;2018-04-03 00:00;34;192;199;391
2018;April;14;2018-04-03 00:00;35;219;187;406
2018;April;14;2018-04-03 00:00;36;206;193;399
2018;April;14;2018-04-03 00:00;37;173;190;363
2018;April;14;2018-04-03 00:00;38;231;207;438
2018;April;14;2018-04-03 00:00;39;209;178;387
2018;April;14;2018-04-03 00:00;40;192;207;399
2018;April;14;2018-04-03 00:00;41;194;207;401
2018;April;14;2018-04-03 00:00;42;221;221;442
2018;April;14;2018-04-03 00:00;43;223;245;468
2018;April;14;2018-04-03 00:00;44;230;280;510
2018;April;14;2018-04-03 00:00;45;213;221;434
2018;April;14;2018-04-03 00:00;46;224;252;476
2018;April;14;2018-04-03 00:00;47;216;216;432
2018;April;14;2018-04-03 00:00;48;210;223;433
2018;April;14;2018-04-03 00:00;49;200;197;397
2018;April;14;2018-04-03 00:00;50;207;221;428
2018;April;14;2018-04-03 00:00;51;236;226;462
2018;April;14;2018-04-03 00:00;52;188;224;412
2018;April;14;2018-04-03 00:00;53;198;222;420
2018;April;14;2018-04-03 00:00;54;188;223;411
2018;April;14;2018-04-03 00:00;55;183;213;396
2018;April;14;2018-04-03 00:00;56;190;187;377
2018;April;14;2018-04-03 00:00;57;150;168;318
2018;April;14;2018-04-03 00:00;58;156;154;310
2018;April;14;2018-04-03 00:00;59;157;166;323
2018;April;14;2018-04-03 00:00;60;154;152;306
2018;April;14;2018-04-03 00:00;61;149;158;307
2018;April;14;2018-04-03 00:00;62;151;157;308
2018;April;14;2018-04-03 00:00;63;135;120;255
2018;April;14;2018-04-03 00:00;64;133;137;270
2018;April;14;2018-04-03 00:00;65;145;135;280
2018;April;14;2018-04-03 00:00;66;137;156;293
2018;April;14;2018-04-03 00:00;67;144;137;281
2018;April;14;2018-04-03 00:00;68;141;157;298
2018;April;14;2018-04-03 00:00;69;147;160;307
2018;April;14;2018-04-03 00:00;70;174;166;340
2018;April;14;2018-04-03 00:00;71;161;157;318
2018;April;14;2018-04-03 00:00;72;180;150;330
2018;April;14;2018-04-03 00:00;73;182;171;353
2018;April;14;2018-04-03 00:00;74;150;160;310
2018;April;14;2018-04-03 00:00;75;152;165;317
2018;April;14;2018-04-03 00:00;76;140;135;275
2018;April;14;2018-04-03 00:00;77;107;101;208
2018;April;14;2018-04-03 00:00;78;82;124;206
2018;April;14;2018-04-03 00:00;79;86;88;174
2018;April;14;2018-04-03 00:00;80;94;77;171
2018;April;14;2018-04-03 00:00;81;79;71;150
2018;April;14;2018-04-03 00:00;82;90;65;155
2018;April;14;2018-04-03 00:00;83;60;63;123
2018;April;14;2018-04-03 00:00;84;67;47;114
2018;April;14;2018-04-03 00:00;85;54;46;100
2018;April;14;2018-04-03 00:00;86;31;37;68
2018;April;14;2018-04-03 00:00;87;43;28;71
2018;April;14;2018-04-03 00:00;88;43;24;67
2018;April;14;2018-04-03 00:00;89;33;23;56
2018;April;14;2018-04-03 00:00;90;28;15;43
2018;April;14;2018-04-03 00:00;91;29;9;38
2018;April;14;2018-04-03 00:00;92;21;11;32
2018;April;14;2018-04-03 00:00;93;19;6;25
2018;April;14;2018-04-03 00:00;94;11;8;19
2018;April;14;2018-04-03 00:00;95;8;6;14
2018;April;14;2018-04-03 00:00;96;12;2;14
2018;April;14;2018-04-03 00:00;97;4;4;8
2018;April;14;2018-04-03 00:00;98;2;2;4
2018;April;14;2018-04-03 00:00;99;0;1;1
2018;April;14;2018-04-03 00:00;100;1;1;2
2018;April;14;2018-04-03 00:00;106;1;0;1
2018;April;15;2018-04-11 00:00;0;51;46;97
2018;April;15;2018-04-11 00:00;1;195;196;391
2018;April;15;2018-04-11 00:00;2;178;203;381
2018;April;15;2018-04-11 00:00;3;192;205;397
2018;April;15;2018-04-11 00:00;4;181;229;410
2018;April;15;2018-04-11 00:00;5;205;224;429
2018;April;15;2018-04-11 00:00;6;193;203;396
2018;April;15;2018-04-11 00:00;7;223;241;464
2018;April;15;2018-04-11 00:00;8;220;235;455
2018;April;15;2018-04-11 00:00;9;208;219;427
2018;April;15;2018-04-11 00:00;10;202;199;401
2018;April;15;2018-04-11 00:00;11;186;207;393
2018;April;15;2018-04-11 00:00;12;227;199;426
2018;April;15;2018-04-11 00:00;13;185;212;397
2018;April;15;2018-04-11 00:00;14;183;203;386
2018;April;15;2018-04-11 00:00;15;180;185;365
2018;April;15;2018-04-11 00:00;16;177;221;398
2018;April;15;2018-04-11 00:00;17;140;185;325
2018;April;15;2018-04-11 00:00;18;182;201;383
2018;April;15;2018-04-11 00:00;19;179;190;369
2018;April;15;2018-04-11 00:00;20;158;171;329
2018;April;15;2018-04-11 00:00;21;143;189;332
2018;April;15;2018-04-11 00:00;22;150;169;319
2018;April;15;2018-04-11 00:00;23;143;178;321
2018;April;15;2018-04-11 00:00;24;170;179;349
2018;April;15;2018-04-11 00:00;25;175;195;370
2018;April;15;2018-04-11 00:00;26;176;184;360
2018;April;15;2018-04-11 00:00;27;185;227;412
2018;April;15;2018-04-11 00:00;28;192;197;389
2018;April;15;2018-04-11 00:00;29;170;194;364
2018;April;15;2018-04-11 00:00;30;183;183;366
2018;April;15;2018-04-11 00:00;31;196;192;388
2018;April;15;2018-04-11 00:00;32;179;188;367
2018;April;15;2018-04-11 00:00;33;190;208;398
2018;April;15;2018-04-11 00:00;34;192;199;391
2018;April;15;2018-04-11 00:00;35;219;187;406
2018;April;15;2018-04-11 00:00;36;205;193;398
2018;April;15;2018-04-11 00:00;37;174;191;365
2018;April;15;2018-04-11 00:00;38;231;206;437
2018;April;15;2018-04-11 00:00;39;209;178;387
2018;April;15;2018-04-11 00:00;40;192;208;400
2018;April;15;2018-04-11 00:00;41;194;206;400
2018;April;15;2018-04-11 00:00;42;221;221;442
2018;April;15;2018-04-11 00:00;43;223;245;468
2018;April;15;2018-04-11 00:00;44;230;279;509
2018;April;15;2018-04-11 00:00;45;213;222;435
2018;April;15;2018-04-11 00:00;46;225;253;478
2018;April;15;2018-04-11 00:00;47;216;216;432
2018;April;15;2018-04-11 00:00;48;210;224;434
2018;April;15;2018-04-11 00:00;49;199;198;397
2018;April;15;2018-04-11 00:00;50;207;221;428
2018;April;15;2018-04-11 00:00;51;236;226;462
2018;April;15;2018-04-11 00:00;52;188;224;412
2018;April;15;2018-04-11 00:00;53;199;222;421
2018;April;15;2018-04-11 00:00;54;188;223;411
2018;April;15;2018-04-11 00:00;55;184;214;398
2018;April;15;2018-04-11 00:00;56;190;188;378
2018;April;15;2018-04-11 00:00;57;150;167;317
2018;April;15;2018-04-11 00:00;58;156;154;310
2018;April;15;2018-04-11 00:00;59;157;166;323
2018;April;15;2018-04-11 00:00;60;154;152;306
2018;April;15;2018-04-11 00:00;61;149;158;307
2018;April;15;2018-04-11 00:00;62;151;157;308
2018;April;15;2018-04-11 00:00;63;135;120;255
2018;April;15;2018-04-11 00:00;64;133;137;270
2018;April;15;2018-04-11 00:00;65;145;135;280
2018;April;15;2018-04-11 00:00;66;137;156;293
2018;April;15;2018-04-11 00:00;67;144;137;281
2018;April;15;2018-04-11 00:00;68;141;156;297
2018;April;15;2018-04-11 00:00;69;147;160;307
2018;April;15;2018-04-11 00:00;70;174;166;340
2018;April;15;2018-04-11 00:00;71;161;157;318
2018;April;15;2018-04-11 00:00;72;180;150;330
2018;April;15;2018-04-11 00:00;73;182;171;353
2018;April;15;2018-04-11 00:00;74;151;160;311
2018;April;15;2018-04-11 00:00;75;152;165;317
2018;April;15;2018-04-11 00:00;76;140;134;274
2018;April;15;2018-04-11 00:00;77;107;101;208
2018;April;15;2018-04-11 00:00;78;82;125;207
2018;April;15;2018-04-11 00:00;79;86;88;174
2018;April;15;2018-04-11 00:00;80;94;77;171
2018;April;15;2018-04-11 00:00;81;79;71;150
2018;April;15;2018-04-11 00:00;82;90;65;155
2018;April;15;2018-04-11 00:00;83;60;63;123
2018;April;15;2018-04-11 00:00;84;67;46;113
2018;April;15;2018-04-11 00:00;85;54;45;99
2018;April;15;2018-04-11 00:00;86;31;37;68
2018;April;15;2018-04-11 00:00;87;43;28;71
2018;April;15;2018-04-11 00:00;88;43;24;67
2018;April;15;2018-04-11 00:00;89;32;23;55
2018;April;15;2018-04-11 00:00;90;28;15;43
2018;April;15;2018-04-11 00:00;91;29;9;38
2018;April;15;2018-04-11 00:00;92;21;11;32
2018;April;15;2018-04-11 00:00;93;19;6;25
2018;April;15;2018-04-11 00:00;94;12;8;20
2018;April;15;2018-04-11 00:00;95;8;6;14
2018;April;15;2018-04-11 00:00;96;12;2;14
2018;April;15;2018-04-11 00:00;97;4;4;8
2018;April;15;2018-04-11 00:00;98;2;2;4
2018;April;15;2018-04-11 00:00;99;0;1;1
2018;April;15;2018-04-11 00:00;100;1;1;2
2018;April;15;2018-04-11 00:00;106;1;0;1
2018;April;16;2018-04-20 00:00;0;55;50;105
2018;April;16;2018-04-20 00:00;1;196;196;392
2018;April;16;2018-04-20 00:00;2;178;206;384
2018;April;16;2018-04-20 00:00;3;192;205;397
2018;April;16;2018-04-20 00:00;4;182;230;412
2018;April;16;2018-04-20 00:00;5;206;224;430
2018;April;16;2018-04-20 00:00;6;193;203;396
2018;April;16;2018-04-20 00:00;7;223;241;464
2018;April;16;2018-04-20 00:00;8;220;234;454
2018;April;16;2018-04-20 00:00;9;210;219;429
2018;April;16;2018-04-20 00:00;10;203;200;403
2018;April;16;2018-04-20 00:00;11;186;207;393
2018;April;16;2018-04-20 00:00;12;227;199;426
2018;April;16;2018-04-20 00:00;13;186;212;398
2018;April;16;2018-04-20 00:00;14;183;203;386
2018;April;16;2018-04-20 00:00;15;179;185;364
2018;April;16;2018-04-20 00:00;16;177;222;399
2018;April;16;2018-04-20 00:00;17;140;183;323
2018;April;16;2018-04-20 00:00;18;182;200;382
2018;April;16;2018-04-20 00:00;19;181;189;370
2018;April;16;2018-04-20 00:00;20;158;169;327
2018;April;16;2018-04-20 00:00;21;143;188;331
2018;April;16;2018-04-20 00:00;22;150;169;319
2018;April;16;2018-04-20 00:00;23;142;178;320
2018;April;16;2018-04-20 00:00;24;168;179;347
2018;April;16;2018-04-20 00:00;25;174;197;371
2018;April;16;2018-04-20 00:00;26;177;184;361
2018;April;16;2018-04-20 00:00;27;184;227;411
2018;April;16;2018-04-20 00:00;28;193;197;390
2018;April;16;2018-04-20 00:00;29;170;195;365
2018;April;16;2018-04-20 00:00;30;184;183;367
2018;April;16;2018-04-20 00:00;31;196;193;389
2018;April;16;2018-04-20 00:00;32;179;188;367
2018;April;16;2018-04-20 00:00;33;191;207;398
2018;April;16;2018-04-20 00:00;34;192;198;390
2018;April;16;2018-04-20 00:00;35;220;188;408
2018;April;16;2018-04-20 00:00;36;206;194;400
2018;April;16;2018-04-20 00:00;37;174;191;365
2018;April;16;2018-04-20 00:00;38;231;206;437
2018;April;16;2018-04-20 00:00;39;209;178;387
2018;April;16;2018-04-20 00:00;40;192;207;399
2018;April;16;2018-04-20 00:00;41;194;206;400
2018;April;16;2018-04-20 00:00;42;221;221;442
2018;April;16;2018-04-20 00:00;43;223;246;469
2018;April;16;2018-04-20 00:00;44;230;279;509
2018;April;16;2018-04-20 00:00;45;212;222;434
2018;April;16;2018-04-20 00:00;46;224;253;477
2018;April;16;2018-04-20 00:00;47;216;216;432
2018;April;16;2018-04-20 00:00;48;210;226;436
2018;April;16;2018-04-20 00:00;49;199;198;397
2018;April;16;2018-04-20 00:00;50;208;221;429
2018;April;16;2018-04-20 00:00;51;236;226;462
2018;April;16;2018-04-20 00:00;52;188;224;412
2018;April;16;2018-04-20 00:00;53;198;222;420
2018;April;16;2018-04-20 00:00;54;188;221;409
2018;April;16;2018-04-20 00:00;55;184;213;397
2018;April;16;2018-04-20 00:00;56;190;188;378
2018;April;16;2018-04-20 00:00;57;150;167;317
2018;April;16;2018-04-20 00:00;58;156;154;310
2018;April;16;2018-04-20 00:00;59;158;165;323
2018;April;16;2018-04-20 00:00;60;154;154;308
2018;April;16;2018-04-20 00:00;61;148;158;306
2018;April;16;2018-04-20 00:00;62;151;156;307
2018;April;16;2018-04-20 00:00;63;135;120;255
2018;April;16;2018-04-20 00:00;64;133;137;270
2018;April;16;2018-04-20 00:00;65;145;134;279
2018;April;16;2018-04-20 00:00;66;137;156;293
2018;April;16;2018-04-20 00:00;67;144;137;281
2018;April;16;2018-04-20 00:00;68;141;156;297
2018;April;16;2018-04-20 00:00;69;147;160;307
2018;April;16;2018-04-20 00:00;70;174;166;340
2018;April;16;2018-04-20 00:00;71;161;157;318
2018;April;16;2018-04-20 00:00;72;180;150;330
2018;April;16;2018-04-20 00:00;73;182;171;353
2018;April;16;2018-04-20 00:00;74;151;160;311
2018;April;16;2018-04-20 00:00;75;152;165;317
2018;April;16;2018-04-20 00:00;76;139;134;273
2018;April;16;2018-04-20 00:00;77;107;101;208
2018;April;16;2018-04-20 00:00;78;82;126;208
2018;April;16;2018-04-20 00:00;79;85;88;173
2018;April;16;2018-04-20 00:00;80;94;77;171
2018;April;16;2018-04-20 00:00;81;79;71;150
2018;April;16;2018-04-20 00:00;82;90;65;155
2018;April;16;2018-04-20 00:00;83;60;63;123
2018;April;16;2018-04-20 00:00;84;67;46;113
2018;April;16;2018-04-20 00:00;85;54;45;99
2018;April;16;2018-04-20 00:00;86;31;37;68
2018;April;16;2018-04-20 00:00;87;43;28;71
2018;April;16;2018-04-20 00:00;88;42;24;66
2018;April;16;2018-04-20 00:00;89;32;23;55
2018;April;16;2018-04-20 00:00;90;28;15;43
2018;April;16;2018-04-20 00:00;91;29;9;38
2018;April;16;2018-04-20 00:00;92;21;11;32
2018;April;16;2018-04-20 00:00;93;19;6;25
2018;April;16;2018-04-20 00:00;94;12;7;19
2018;April;16;2018-04-20 00:00;95;8;6;14
2018;April;16;2018-04-20 00:00;96;12;2;14
2018;April;16;2018-04-20 00:00;97;4;4;8
2018;April;16;2018-04-20 00:00;98;2;2;4
2018;April;16;2018-04-20 00:00;99;0;1;1
2018;April;16;2018-04-20 00:00;100;1;1;2
2018;April;16;2018-04-20 00:00;106;1;0;1
2018;April;17;2018-04-24 00:00;0;61;55;116
2018;April;17;2018-04-24 00:00;1;196;196;392
2018;April;17;2018-04-24 00:00;2;178;206;384
2018;April;17;2018-04-24 00:00;3;191;205;396
2018;April;17;2018-04-24 00:00;4;182;230;412
2018;April;17;2018-04-24 00:00;5;206;225;431
2018;April;17;2018-04-24 00:00;6;194;204;398
2018;April;17;2018-04-24 00:00;7;223;241;464
2018;April;17;2018-04-24 00:00;8;221;233;454
2018;April;17;2018-04-24 00:00;9;210;219;429
2018;April;17;2018-04-24 00:00;10;203;200;403
2018;April;17;2018-04-24 00:00;11;186;207;393
2018;April;17;2018-04-24 00:00;12;227;199;426
2018;April;17;2018-04-24 00:00;13;186;212;398
2018;April;17;2018-04-24 00:00;14;184;203;387
2018;April;17;2018-04-24 00:00;15;179;185;364
2018;April;17;2018-04-24 00:00;16;177;221;398
2018;April;17;2018-04-24 00:00;17;140;182;322
2018;April;17;2018-04-24 00:00;18;182;200;382
2018;April;17;2018-04-24 00:00;19;181;190;371
2018;April;17;2018-04-24 00:00;20;157;169;326
2018;April;17;2018-04-24 00:00;21;143;189;332
2018;April;17;2018-04-24 00:00;22;149;169;318
2018;April;17;2018-04-24 00:00;23;141;178;319
2018;April;17;2018-04-24 00:00;24;169;177;346
2018;April;17;2018-04-24 00:00;25;175;195;370
2018;April;17;2018-04-24 00:00;26;176;185;361
2018;April;17;2018-04-24 00:00;27;184;228;412
2018;April;17;2018-04-24 00:00;28;193;197;390
2018;April;17;2018-04-24 00:00;29;171;195;366
2018;April;17;2018-04-24 00:00;30;184;183;367
2018;April;17;2018-04-24 00:00;31;197;192;389
2018;April;17;2018-04-24 00:00;32;180;189;369
2018;April;17;2018-04-24 00:00;33;191;207;398
2018;April;17;2018-04-24 00:00;34;192;198;390
2018;April;17;2018-04-24 00:00;35;219;188;407
2018;April;17;2018-04-24 00:00;36;206;195;401
2018;April;17;2018-04-24 00:00;37;174;191;365
2018;April;17;2018-04-24 00:00;38;231;206;437
2018;April;17;2018-04-24 00:00;39;209;178;387
2018;April;17;2018-04-24 00:00;40;192;207;399
2018;April;17;2018-04-24 00:00;41;194;206;400
2018;April;17;2018-04-24 00:00;42;221;221;442
2018;April;17;2018-04-24 00:00;43;223;247;470
2018;April;17;2018-04-24 00:00;44;230;279;509
2018;April;17;2018-04-24 00:00;45;212;222;434
2018;April;17;2018-04-24 00:00;46;224;253;477
2018;April;17;2018-04-24 00:00;47;215;216;431
2018;April;17;2018-04-24 00:00;48;210;226;436
2018;April;17;2018-04-24 00:00;49;199;198;397
2018;April;17;2018-04-24 00:00;50;208;221;429
2018;April;17;2018-04-24 00:00;51;236;226;462
2018;April;17;2018-04-24 00:00;52;187;224;411
2018;April;17;2018-04-24 00:00;53;198;222;420
2018;April;17;2018-04-24 00:00;54;188;222;410
2018;April;17;2018-04-24 00:00;55;184;213;397
2018;April;17;2018-04-24 00:00;56;190;188;378
2018;April;17;2018-04-24 00:00;57;150;167;317
2018;April;17;2018-04-24 00:00;58;156;154;310
2018;April;17;2018-04-24 00:00;59;158;165;323
2018;April;17;2018-04-24 00:00;60;154;154;308
2018;April;17;2018-04-24 00:00;61;148;158;306
2018;April;17;2018-04-24 00:00;62;151;156;307
2018;April;17;2018-04-24 00:00;63;135;120;255
2018;April;17;2018-04-24 00:00;64;133;137;270
2018;April;17;2018-04-24 00:00;65;145;134;279
2018;April;17;2018-04-24 00:00;66;137;156;293
2018;April;17;2018-04-24 00:00;67;144;137;281
2018;April;17;2018-04-24 00:00;68;141;156;297
2018;April;17;2018-04-24 00:00;69;147;160;307
2018;April;17;2018-04-24 00:00;70;174;165;339
2018;April;17;2018-04-24 00:00;71;161;157;318
2018;April;17;2018-04-24 00:00;72;179;150;329
2018;April;17;2018-04-24 00:00;73;182;171;353
2018;April;17;2018-04-24 00:00;74;151;160;311
2018;April;17;2018-04-24 00:00;75;152;165;317
2018;April;17;2018-04-24 00:00;76;139;134;273
2018;April;17;2018-04-24 00:00;77;107;101;208
2018;April;17;2018-04-24 00:00;78;82;126;208
2018;April;17;2018-04-24 00:00;79;85;88;173
2018;April;17;2018-04-24 00:00;80;94;77;171
2018;April;17;2018-04-24 00:00;81;79;71;150
2018;April;17;2018-04-24 00:00;82;90;65;155
2018;April;17;2018-04-24 00:00;83;60;63;123
2018;April;17;2018-04-24 00:00;84;66;46;112
2018;April;17;2018-04-24 00:00;85;54;45;99
2018;April;17;2018-04-24 00:00;86;31;37;68
2018;April;17;2018-04-24 00:00;87;43;28;71
2018;April;17;2018-04-24 00:00;88;42;24;66
2018;April;17;2018-04-24 00:00;89;32;23;55
2018;April;17;2018-04-24 00:00;90;28;15;43
2018;April;17;2018-04-24 00:00;91;29;9;38
2018;April;17;2018-04-24 00:00;92;19;11;30
2018;April;17;2018-04-24 00:00;93;19;6;25
2018;April;17;2018-04-24 00:00;94;12;7;19
2018;April;17;2018-04-24 00:00;95;8;6;14
2018;April;17;2018-04-24 00:00;96;12;2;14
2018;April;17;2018-04-24 00:00;97;4;4;8
2018;April;17;2018-04-24 00:00;98;2;2;4
2018;April;17;2018-04-24 00:00;99;0;1;1
2018;April;17;2018-04-24 00:00;100;1;1;2
2018;April;17;2018-04-24 00:00;106;1;0;1
2018;May;18;2018-05-02 00:00;0;67;61;128
2018;May;18;2018-05-02 00:00;1;195;196;391
2018;May;18;2018-05-02 00:00;2;177;206;383
2018;May;18;2018-05-02 00:00;3;191;205;396
2018;May;18;2018-05-02 00:00;4;183;230;413
2018;May;18;2018-05-02 00:00;5;207;225;432
2018;May;18;2018-05-02 00:00;6;194;204;398
2018;May;18;2018-05-02 00:00;7;223;241;464
2018;May;18;2018-05-02 00:00;8;221;234;455
2018;May;18;2018-05-02 00:00;9;210;219;429
2018;May;18;2018-05-02 00:00;10;203;200;403
2018;May;18;2018-05-02 00:00;11;187;207;394
2018;May;18;2018-05-02 00:00;12;227;199;426
2018;May;18;2018-05-02 00:00;13;186;211;397
2018;May;18;2018-05-02 00:00;14;184;203;387
2018;May;18;2018-05-02 00:00;15;179;186;365
2018;May;18;2018-05-02 00:00;16;177;220;397
2018;May;18;2018-05-02 00:00;17;140;183;323
2018;May;18;2018-05-02 00:00;18;182;201;383
2018;May;18;2018-05-02 00:00;19;181;190;371
2018;May;18;2018-05-02 00:00;20;157;171;328
2018;May;18;2018-05-02 00:00;21;142;190;332
2018;May;18;2018-05-02 00:00;22;147;168;315
2018;May;18;2018-05-02 00:00;23;146;179;325
2018;May;18;2018-05-02 00:00;24;170;179;349
2018;May;18;2018-05-02 00:00;25;176;195;371
2018;May;18;2018-05-02 00:00;26;175;186;361
2018;May;18;2018-05-02 00:00;27;183;230;413
2018;May;18;2018-05-02 00:00;28;194;196;390
2018;May;18;2018-05-02 00:00;29;169;196;365
2018;May;18;2018-05-02 00:00;30;183;183;366
2018;May;18;2018-05-02 00:00;31;195;191;386
2018;May;18;2018-05-02 00:00;32;180;188;368
2018;May;18;2018-05-02 00:00;33;192;208;400
2018;May;18;2018-05-02 00:00;34;192;199;391
2018;May;18;2018-05-02 00:00;35;218;188;406
2018;May;18;2018-05-02 00:00;36;206;195;401
2018;May;18;2018-05-02 00:00;37;174;192;366
2018;May;18;2018-05-02 00:00;38;232;206;438
2018;May;18;2018-05-02 00:00;39;208;179;387
2018;May;18;2018-05-02 00:00;40;192;207;399
2018;May;18;2018-05-02 00:00;41;194;206;400
2018;May;18;2018-05-02 00:00;42;222;221;443
2018;May;18;2018-05-02 00:00;43;223;246;469
2018;May;18;2018-05-02 00:00;44;229;278;507
2018;May;18;2018-05-02 00:00;45;212;221;433
2018;May;18;2018-05-02 00:00;46;224;253;477
2018;May;18;2018-05-02 00:00;47;215;217;432
2018;May;18;2018-05-02 00:00;48;210;225;435
2018;May;18;2018-05-02 00:00;49;199;198;397
2018;May;18;2018-05-02 00:00;50;208;220;428
2018;May;18;2018-05-02 00:00;51;236;226;462
2018;May;18;2018-05-02 00:00;52;187;223;410
2018;May;18;2018-05-02 00:00;53;199;222;421
2018;May;18;2018-05-02 00:00;54;188;222;410
2018;May;18;2018-05-02 00:00;55;184;212;396
2018;May;18;2018-05-02 00:00;56;190;189;379
2018;May;18;2018-05-02 00:00;57;150;167;317
2018;May;18;2018-05-02 00:00;58;156;154;310
2018;May;18;2018-05-02 00:00;59;158;165;323
2018;May;18;2018-05-02 00:00;60;154;154;308
2018;May;18;2018-05-02 00:00;61;148;158;306
2018;May;18;2018-05-02 00:00;62;151;157;308
2018;May;18;2018-05-02 00:00;63;135;120;255
2018;May;18;2018-05-02 00:00;64;134;137;271
2018;May;18;2018-05-02 00:00;65;145;135;280
2018;May;18;2018-05-02 00:00;66;137;155;292
2018;May;18;2018-05-02 00:00;67;144;137;281
2018;May;18;2018-05-02 00:00;68;141;156;297
2018;May;18;2018-05-02 00:00;69;148;161;309
2018;May;18;2018-05-02 00:00;70;174;165;339
2018;May;18;2018-05-02 00:00;71;161;157;318
2018;May;18;2018-05-02 00:00;72;179;149;328
2018;May;18;2018-05-02 00:00;73;182;171;353
2018;May;18;2018-05-02 00:00;74;151;160;311
2018;May;18;2018-05-02 00:00;75;152;165;317
2018;May;18;2018-05-02 00:00;76;139;134;273
2018;May;18;2018-05-02 00:00;77;107;101;208
2018;May;18;2018-05-02 00:00;78;82;126;208
2018;May;18;2018-05-02 00:00;79;85;88;173
2018;May;18;2018-05-02 00:00;80;94;77;171
2018;May;18;2018-05-02 00:00;81;79;71;150
2018;May;18;2018-05-02 00:00;82;90;65;155
2018;May;18;2018-05-02 00:00;83;59;63;122
2018;May;18;2018-05-02 00:00;84;66;46;112
2018;May;18;2018-05-02 00:00;85;54;45;99
2018;May;18;2018-05-02 00:00;86;31;37;68
2018;May;18;2018-05-02 00:00;87;43;28;71
2018;May;18;2018-05-02 00:00;88;42;24;66
2018;May;18;2018-05-02 00:00;89;32;23;55
2018;May;18;2018-05-02 00:00;90;28;15;43
2018;May;18;2018-05-02 00:00;91;29;9;38
2018;May;18;2018-05-02 00:00;92;19;11;30
2018;May;18;2018-05-02 00:00;93;19;6;25
2018;May;18;2018-05-02 00:00;94;12;7;19
2018;May;18;2018-05-02 00:00;95;8;6;14
2018;May;18;2018-05-02 00:00;96;12;2;14
2018;May;18;2018-05-02 00:00;97;4;4;8
2018;May;18;2018-05-02 00:00;98;2;2;4
2018;May;18;2018-05-02 00:00;99;0;1;1
2018;May;18;2018-05-02 00:00;100;1;1;2
2018;May;18;2018-05-02 00:00;106;1;0;1
2018;May;19;2018-05-08 00:00;0;70;70;140
2018;May;19;2018-05-08 00:00;1;198;196;394
2018;May;19;2018-05-08 00:00;2;179;206;385
2018;May;19;2018-05-08 00:00;3;191;204;395
2018;May;19;2018-05-08 00:00;4;184;231;415
2018;May;19;2018-05-08 00:00;5;207;226;433
2018;May;19;2018-05-08 00:00;6;195;203;398
2018;May;19;2018-05-08 00:00;7;224;241;465
2018;May;19;2018-05-08 00:00;8;222;235;457
2018;May;19;2018-05-08 00:00;9;209;219;428
2018;May;19;2018-05-08 00:00;10;203;200;403
2018;May;19;2018-05-08 00:00;11;187;206;393
2018;May;19;2018-05-08 00:00;12;227;199;426
2018;May;19;2018-05-08 00:00;13;187;211;398
2018;May;19;2018-05-08 00:00;14;184;203;387
2018;May;19;2018-05-08 00:00;15;179;186;365
2018;May;19;2018-05-08 00:00;16;177;220;397
2018;May;19;2018-05-08 00:00;17;140;183;323
2018;May;19;2018-05-08 00:00;18;182;200;382
2018;May;19;2018-05-08 00:00;19;182;189;371
2018;May;19;2018-05-08 00:00;20;157;172;329
2018;May;19;2018-05-08 00:00;21;141;189;330
2018;May;19;2018-05-08 00:00;22;148;169;317
2018;May;19;2018-05-08 00:00;23;149;179;328
2018;May;19;2018-05-08 00:00;24;169;180;349
2018;May;19;2018-05-08 00:00;25;178;197;375
2018;May;19;2018-05-08 00:00;26;175;186;361
2018;May;19;2018-05-08 00:00;27;184;231;415
2018;May;19;2018-05-08 00:00;28;195;198;393
2018;May;19;2018-05-08 00:00;29;171;195;366
2018;May;19;2018-05-08 00:00;30;182;184;366
2018;May;19;2018-05-08 00:00;31;195;191;386
2018;May;19;2018-05-08 00:00;32;182;189;371
2018;May;19;2018-05-08 00:00;33;192;209;401
2018;May;19;2018-05-08 00:00;34;193;200;393
2018;May;19;2018-05-08 00:00;35;216;187;403
2018;May;19;2018-05-08 00:00;36;206;198;404
2018;May;19;2018-05-08 00:00;37;173;192;365
2018;May;19;2018-05-08 00:00;38;232;206;438
2018;May;19;2018-05-08 00:00;39;208;179;387
2018;May;19;2018-05-08 00:00;40;193;207;400
2018;May;19;2018-05-08 00:00;41;195;206;401
2018;May;19;2018-05-08 00:00;42;222;220;442
2018;May;19;2018-05-08 00:00;43;225;246;471
2018;May;19;2018-05-08 00:00;44;230;278;508
2018;May;19;2018-05-08 00:00;45;211;223;434
2018;May;19;2018-05-08 00:00;46;225;253;478
2018;May;19;2018-05-08 00:00;47;215;217;432
2018;May;19;2018-05-08 00:00;48;209;226;435
2018;May;19;2018-05-08 00:00;49;199;198;397
2018;May;19;2018-05-08 00:00;50;208;220;428
2018;May;19;2018-05-08 00:00;51;236;227;463
2018;May;19;2018-05-08 00:00;52;187;223;410
2018;May;19;2018-05-08 00:00;53;199;222;421
2018;May;19;2018-05-08 00:00;54;188;222;410
2018;May;19;2018-05-08 00:00;55;184;212;396
2018;May;19;2018-05-08 00:00;56;190;189;379
2018;May;19;2018-05-08 00:00;57;150;168;318
2018;May;19;2018-05-08 00:00;58;156;154;310
2018;May;19;2018-05-08 00:00;59;157;165;322
2018;May;19;2018-05-08 00:00;60;154;154;308
2018;May;19;2018-05-08 00:00;61;148;158;306
2018;May;19;2018-05-08 00:00;62;151;157;308
2018;May;19;2018-05-08 00:00;63;134;120;254
2018;May;19;2018-05-08 00:00;64;134;137;271
2018;May;19;2018-05-08 00:00;65;145;135;280
2018;May;19;2018-05-08 00:00;66;137;155;292
2018;May;19;2018-05-08 00:00;67;144;137;281
2018;May;19;2018-05-08 00:00;68;141;156;297
2018;May;19;2018-05-08 00:00;69;148;161;309
2018;May;19;2018-05-08 00:00;70;174;164;338
2018;May;19;2018-05-08 00:00;71;161;157;318
2018;May;19;2018-05-08 00:00;72;180;149;329
2018;May;19;2018-05-08 00:00;73;182;171;353
2018;May;19;2018-05-08 00:00;74;151;160;311
2018;May;19;2018-05-08 00:00;75;152;165;317
2018;May;19;2018-05-08 00:00;76;139;133;272
2018;May;19;2018-05-08 00:00;77;107;100;207
2018;May;19;2018-05-08 00:00;78;82;126;208
2018;May;19;2018-05-08 00:00;79;85;88;173
2018;May;19;2018-05-08 00:00;80;94;77;171
2018;May;19;2018-05-08 00:00;81;79;71;150
2018;May;19;2018-05-08 00:00;82;89;65;154
2018;May;19;2018-05-08 00:00;83;59;63;122
2018;May;19;2018-05-08 00:00;84;66;46;112
2018;May;19;2018-05-08 00:00;85;54;45;99
2018;May;19;2018-05-08 00:00;86;31;37;68
2018;May;19;2018-05-08 00:00;87;43;27;70
2018;May;19;2018-05-08 00:00;88;42;24;66
2018;May;19;2018-05-08 00:00;89;32;23;55
2018;May;19;2018-05-08 00:00;90;28;15;43
2018;May;19;2018-05-08 00:00;91;29;9;38
2018;May;19;2018-05-08 00:00;92;19;11;30
2018;May;19;2018-05-08 00:00;93;19;6;25
2018;May;19;2018-05-08 00:00;94;12;7;19
2018;May;19;2018-05-08 00:00;95;8;6;14
2018;May;19;2018-05-08 00:00;96;12;2;14
2018;May;19;2018-05-08 00:00;97;4;4;8
2018;May;19;2018-05-08 00:00;98;2;2;4
2018;May;19;2018-05-08 00:00;99;0;1;1
2018;May;19;2018-05-08 00:00;100;1;1;2
2018;May;19;2018-05-08 00:00;106;1;0;1
2018;May;20;2018-05-15 00:00;0;74;74;148
2018;May;20;2018-05-15 00:00;1;198;196;394
2018;May;20;2018-05-15 00:00;2;180;206;386
2018;May;20;2018-05-15 00:00;3;191;204;395
2018;May;20;2018-05-15 00:00;4;184;232;416
2018;May;20;2018-05-15 00:00;5;207;226;433
2018;May;20;2018-05-15 00:00;6;195;204;399
2018;May;20;2018-05-15 00:00;7;224;240;464
2018;May;20;2018-05-15 00:00;8;222;235;457
2018;May;20;2018-05-15 00:00;9;210;219;429
2018;May;20;2018-05-15 00:00;10;203;200;403
2018;May;20;2018-05-15 00:00;11;187;206;393
2018;May;20;2018-05-15 00:00;12;227;199;426
2018;May;20;2018-05-15 00:00;13;187;211;398
2018;May;20;2018-05-15 00:00;14;184;203;387
2018;May;20;2018-05-15 00:00;15;179;186;365
2018;May;20;2018-05-15 00:00;16;177;220;397
2018;May;20;2018-05-15 00:00;17;140;183;323
2018;May;20;2018-05-15 00:00;18;182;201;383
2018;May;20;2018-05-15 00:00;19;182;189;371
2018;May;20;2018-05-15 00:00;20;157;173;330
2018;May;20;2018-05-15 00:00;21;141;190;331
2018;May;20;2018-05-15 00:00;22;147;168;315
2018;May;20;2018-05-15 00:00;23;150;179;329
2018;May;20;2018-05-15 00:00;24;172;181;353
2018;May;20;2018-05-15 00:00;25;178;197;375
2018;May;20;2018-05-15 00:00;26;174;182;356
2018;May;20;2018-05-15 00:00;27;185;232;417
2018;May;20;2018-05-15 00:00;28;193;200;393
2018;May;20;2018-05-15 00:00;29;170;195;365
2018;May;20;2018-05-15 00:00;30;182;185;367
2018;May;20;2018-05-15 00:00;31;196;190;386
2018;May;20;2018-05-15 00:00;32;182;189;371
2018;May;20;2018-05-15 00:00;33;193;209;402
2018;May;20;2018-05-15 00:00;34;193;200;393
2018;May;20;2018-05-15 00:00;35;216;187;403
2018;May;20;2018-05-15 00:00;36;207;199;406
2018;May;20;2018-05-15 00:00;37;174;193;367
2018;May;20;2018-05-15 00:00;38;232;206;438
2018;May;20;2018-05-15 00:00;39;208;181;389
2018;May;20;2018-05-15 00:00;40;194;207;401
2018;May;20;2018-05-15 00:00;41;195;206;401
2018;May;20;2018-05-15 00:00;42;222;221;443
2018;May;20;2018-05-15 00:00;43;225;245;470
2018;May;20;2018-05-15 00:00;44;230;280;510
2018;May;20;2018-05-15 00:00;45;211;223;434
2018;May;20;2018-05-15 00:00;46;225;254;479
2018;May;20;2018-05-15 00:00;47;215;217;432
2018;May;20;2018-05-15 00:00;48;208;227;435
2018;May;20;2018-05-15 00:00;49;199;198;397
2018;May;20;2018-05-15 00:00;50;208;220;428
2018;May;20;2018-05-15 00:00;51;236;227;463
2018;May;20;2018-05-15 00:00;52;187;223;410
2018;May;20;2018-05-15 00:00;53;199;222;421
2018;May;20;2018-05-15 00:00;54;188;222;410
2018;May;20;2018-05-15 00:00;55;184;212;396
2018;May;20;2018-05-15 00:00;56;190;189;379
2018;May;20;2018-05-15 00:00;57;150;168;318
2018;May;20;2018-05-15 00:00;58;156;154;310
2018;May;20;2018-05-15 00:00;59;157;165;322
2018;May;20;2018-05-15 00:00;60;154;154;308
2018;May;20;2018-05-15 00:00;61;148;158;306
2018;May;20;2018-05-15 00:00;62;151;157;308
2018;May;20;2018-05-15 00:00;63;134;120;254
2018;May;20;2018-05-15 00:00;64;134;137;271
2018;May;20;2018-05-15 00:00;65;145;136;281
2018;May;20;2018-05-15 00:00;66;137;155;292
2018;May;20;2018-05-15 00:00;67;144;137;281
2018;May;20;2018-05-15 00:00;68;141;156;297
2018;May;20;2018-05-15 00:00;69;148;161;309
2018;May;20;2018-05-15 00:00;70;174;164;338
2018;May;20;2018-05-15 00:00;71;161;157;318
2018;May;20;2018-05-15 00:00;72;180;149;329
2018;May;20;2018-05-15 00:00;73;182;171;353
2018;May;20;2018-05-15 00:00;74;151;160;311
2018;May;20;2018-05-15 00:00;75;152;164;316
2018;May;20;2018-05-15 00:00;76;139;133;272
2018;May;20;2018-05-15 00:00;77;107;100;207
2018;May;20;2018-05-15 00:00;78;82;126;208
2018;May;20;2018-05-15 00:00;79;85;88;173
2018;May;20;2018-05-15 00:00;80;93;77;170
2018;May;20;2018-05-15 00:00;81;79;71;150
2018;May;20;2018-05-15 00:00;82;89;65;154
2018;May;20;2018-05-15 00:00;83;59;63;122
2018;May;20;2018-05-15 00:00;84;66;46;112
2018;May;20;2018-05-15 00:00;85;54;44;98
2018;May;20;2018-05-15 00:00;86;31;37;68
2018;May;20;2018-05-15 00:00;87;43;27;70
2018;May;20;2018-05-15 00:00;88;42;24;66
2018;May;20;2018-05-15 00:00;89;32;23;55
2018;May;20;2018-05-15 00:00;90;27;15;42
2018;May;20;2018-05-15 00:00;91;29;9;38
2018;May;20;2018-05-15 00:00;92;19;10;29
2018;May;20;2018-05-15 00:00;93;19;6;25
2018;May;20;2018-05-15 00:00;94;12;7;19
2018;May;20;2018-05-15 00:00;95;8;6;14
2018;May;20;2018-05-15 00:00;96;12;2;14
2018;May;20;2018-05-15 00:00;97;4;4;8
2018;May;20;2018-05-15 00:00;98;2;2;4
2018;May;20;2018-05-15 00:00;99;0;1;1
2018;May;20;2018-05-15 00:00;100;1;1;2
2018;May;20;2018-05-15 00:00;106;1;0;1
2018;May;21;2018-05-22 00:00;0;79;84;163
2018;May;21;2018-05-22 00:00;1;197;197;394
2018;May;21;2018-05-22 00:00;2;180;205;385
2018;May;21;2018-05-22 00:00;3;193;204;397
2018;May;21;2018-05-22 00:00;4;184;233;417
2018;May;21;2018-05-22 00:00;5;207;226;433
2018;May;21;2018-05-22 00:00;6;196;204;400
2018;May;21;2018-05-22 00:00;7;223;240;463
2018;May;21;2018-05-22 00:00;8;222;235;457
2018;May;21;2018-05-22 00:00;9;210;219;429
2018;May;21;2018-05-22 00:00;10;203;200;403
2018;May;21;2018-05-22 00:00;11;187;206;393
2018;May;21;2018-05-22 00:00;12;227;199;426
2018;May;21;2018-05-22 00:00;13;186;211;397
2018;May;21;2018-05-22 00:00;14;185;203;388
2018;May;21;2018-05-22 00:00;15;179;186;365
2018;May;21;2018-05-22 00:00;16;177;220;397
2018;May;21;2018-05-22 00:00;17;140;183;323
2018;May;21;2018-05-22 00:00;18;182;201;383
2018;May;21;2018-05-22 00:00;19;182;189;371
2018;May;21;2018-05-22 00:00;20;156;173;329
2018;May;21;2018-05-22 00:00;21;142;190;332
2018;May;21;2018-05-22 00:00;22;148;169;317
2018;May;21;2018-05-22 00:00;23;150;180;330
2018;May;21;2018-05-22 00:00;24;170;181;351
2018;May;21;2018-05-22 00:00;25;179;197;376
2018;May;21;2018-05-22 00:00;26;176;182;358
2018;May;21;2018-05-22 00:00;27;184;235;419
2018;May;21;2018-05-22 00:00;28;192;200;392
2018;May;21;2018-05-22 00:00;29;170;195;365
2018;May;21;2018-05-22 00:00;30;183;185;368
2018;May;21;2018-05-22 00:00;31;195;191;386
2018;May;21;2018-05-22 00:00;32;181;190;371
2018;May;21;2018-05-22 00:00;33;193;208;401
2018;May;21;2018-05-22 00:00;34;193;201;394
2018;May;21;2018-05-22 00:00;35;216;186;402
2018;May;21;2018-05-22 00:00;36;207;199;406
2018;May;21;2018-05-22 00:00;37;174;193;367
2018;May;21;2018-05-22 00:00;38;232;206;438
2018;May;21;2018-05-22 00:00;39;208;181;389
2018;May;21;2018-05-22 00:00;40;194;208;402
2018;May;21;2018-05-22 00:00;41;194;206;400
2018;May;21;2018-05-22 00:00;42;223;221;444
2018;May;21;2018-05-22 00:00;43;225;245;470
2018;May;21;2018-05-22 00:00;44;230;280;510
2018;May;21;2018-05-22 00:00;45;211;223;434
2018;May;21;2018-05-22 00:00;46;225;254;479
2018;May;21;2018-05-22 00:00;47;215;217;432
2018;May;21;2018-05-22 00:00;48;208;227;435
2018;May;21;2018-05-22 00:00;49;199;198;397
2018;May;21;2018-05-22 00:00;50;208;221;429
2018;May;21;2018-05-22 00:00;51;236;227;463
2018;May;21;2018-05-22 00:00;52;187;223;410
2018;May;21;2018-05-22 00:00;53;199;222;421
2018;May;21;2018-05-22 00:00;54;188;221;409
2018;May;21;2018-05-22 00:00;55;184;212;396
2018;May;21;2018-05-22 00:00;56;190;189;379
2018;May;21;2018-05-22 00:00;57;150;168;318
2018;May;21;2018-05-22 00:00;58;156;154;310
2018;May;21;2018-05-22 00:00;59;157;165;322
2018;May;21;2018-05-22 00:00;60;154;154;308
2018;May;21;2018-05-22 00:00;61;149;158;307
2018;May;21;2018-05-22 00:00;62;152;158;310
2018;May;21;2018-05-22 00:00;63;134;120;254
2018;May;21;2018-05-22 00:00;64;133;137;270
2018;May;21;2018-05-22 00:00;65;145;136;281
2018;May;21;2018-05-22 00:00;66;137;155;292
2018;May;21;2018-05-22 00:00;67;144;137;281
2018;May;21;2018-05-22 00:00;68;141;156;297
2018;May;21;2018-05-22 00:00;69;148;161;309
2018;May;21;2018-05-22 00:00;70;174;163;337
2018;May;21;2018-05-22 00:00;71;160;157;317
2018;May;21;2018-05-22 00:00;72;180;148;328
2018;May;21;2018-05-22 00:00;73;182;171;353
2018;May;21;2018-05-22 00:00;74;151;160;311
2018;May;21;2018-05-22 00:00;75;152;164;316
2018;May;21;2018-05-22 00:00;76;139;133;272
2018;May;21;2018-05-22 00:00;77;107;101;208
2018;May;21;2018-05-22 00:00;78;82;125;207
2018;May;21;2018-05-22 00:00;79;85;88;173
2018;May;21;2018-05-22 00:00;80;93;77;170
2018;May;21;2018-05-22 00:00;81;79;71;150
2018;May;21;2018-05-22 00:00;82;89;65;154
2018;May;21;2018-05-22 00:00;83;58;63;121
2018;May;21;2018-05-22 00:00;84;66;46;112
2018;May;21;2018-05-22 00:00;85;54;44;98
2018;May;21;2018-05-22 00:00;86;31;37;68
2018;May;21;2018-05-22 00:00;87;43;27;70
2018;May;21;2018-05-22 00:00;88;42;24;66
2018;May;21;2018-05-22 00:00;89;32;23;55
2018;May;21;2018-05-22 00:00;90;26;15;41
2018;May;21;2018-05-22 00:00;91;29;9;38
2018;May;21;2018-05-22 00:00;92;19;10;29
2018;May;21;2018-05-22 00:00;93;19;6;25
2018;May;21;2018-05-22 00:00;94;12;7;19
2018;May;21;2018-05-22 00:00;95;8;6;14
2018;May;21;2018-05-22 00:00;96;11;2;13
2018;May;21;2018-05-22 00:00;97;3;4;7
2018;May;21;2018-05-22 00:00;98;2;2;4
2018;May;21;2018-05-22 00:00;99;0;1;1
2018;May;21;2018-05-22 00:00;100;1;1;2
2018;May;21;2018-05-22 00:00;106;1;0;1
2018;May;22;2018-05-29 00:00;0;79;92;171
2018;May;22;2018-05-29 00:00;1;197;197;394
2018;May;22;2018-05-29 00:00;2;180;205;385
2018;May;22;2018-05-29 00:00;3;193;204;397
2018;May;22;2018-05-29 00:00;4;184;233;417
2018;May;22;2018-05-29 00:00;5;206;226;432
2018;May;22;2018-05-29 00:00;6;196;204;400
2018;May;22;2018-05-29 00:00;7;223;240;463
2018;May;22;2018-05-29 00:00;8;222;235;457
2018;May;22;2018-05-29 00:00;9;210;220;430
2018;May;22;2018-05-29 00:00;10;203;200;403
2018;May;22;2018-05-29 00:00;11;188;206;394
2018;May;22;2018-05-29 00:00;12;227;199;426
2018;May;22;2018-05-29 00:00;13;187;211;398
2018;May;22;2018-05-29 00:00;14;185;203;388
2018;May;22;2018-05-29 00:00;15;179;186;365
2018;May;22;2018-05-29 00:00;16;178;220;398
2018;May;22;2018-05-29 00:00;17;140;183;323
2018;May;22;2018-05-29 00:00;18;182;201;383
2018;May;22;2018-05-29 00:00;19;182;189;371
2018;May;22;2018-05-29 00:00;20;156;173;329
2018;May;22;2018-05-29 00:00;21;142;190;332
2018;May;22;2018-05-29 00:00;22;148;168;316
2018;May;22;2018-05-29 00:00;23;150;180;330
2018;May;22;2018-05-29 00:00;24;169;181;350
2018;May;22;2018-05-29 00:00;25;178;196;374
2018;May;22;2018-05-29 00:00;26;177;182;359
2018;May;22;2018-05-29 00:00;27;185;234;419
2018;May;22;2018-05-29 00:00;28;192;202;394
2018;May;22;2018-05-29 00:00;29;169;195;364
2018;May;22;2018-05-29 00:00;30;183;184;367
2018;May;22;2018-05-29 00:00;31;194;191;385
2018;May;22;2018-05-29 00:00;32;181;189;370
2018;May;22;2018-05-29 00:00;33;194;208;402
2018;May;22;2018-05-29 00:00;34;193;201;394
2018;May;22;2018-05-29 00:00;35;216;185;401
2018;May;22;2018-05-29 00:00;36;207;199;406
2018;May;22;2018-05-29 00:00;37;174;193;367
2018;May;22;2018-05-29 00:00;38;232;206;438
2018;May;22;2018-05-29 00:00;39;208;181;389
2018;May;22;2018-05-29 00:00;40;195;207;402
2018;May;22;2018-05-29 00:00;41;194;206;400
2018;May;22;2018-05-29 00:00;42;223;221;444
2018;May;22;2018-05-29 00:00;43;225;246;471
2018;May;22;2018-05-29 00:00;44;230;281;511
2018;May;22;2018-05-29 00:00;45;211;223;434
2018;May;22;2018-05-29 00:00;46;225;254;479
2018;May;22;2018-05-29 00:00;47;215;217;432
2018;May;22;2018-05-29 00:00;48;208;227;435
2018;May;22;2018-05-29 00:00;49;200;198;398
2018;May;22;2018-05-29 00:00;50;208;221;429
2018;May;22;2018-05-29 00:00;51;236;227;463
2018;May;22;2018-05-29 00:00;52;188;223;411
2018;May;22;2018-05-29 00:00;53;199;222;421
2018;May;22;2018-05-29 00:00;54;188;221;409
2018;May;22;2018-05-29 00:00;55;183;212;395
2018;May;22;2018-05-29 00:00;56;190;189;379
2018;May;22;2018-05-29 00:00;57;150;168;318
2018;May;22;2018-05-29 00:00;58;156;154;310
2018;May;22;2018-05-29 00:00;59;156;165;321
2018;May;22;2018-05-29 00:00;60;154;154;308
2018;May;22;2018-05-29 00:00;61;149;158;307
2018;May;22;2018-05-29 00:00;62;153;158;311
2018;May;22;2018-05-29 00:00;63;134;119;253
2018;May;22;2018-05-29 00:00;64;133;137;270
2018;May;22;2018-05-29 00:00;65;145;136;281
2018;May;22;2018-05-29 00:00;66;137;155;292
2018;May;22;2018-05-29 00:00;67;144;137;281
2018;May;22;2018-05-29 00:00;68;141;156;297
2018;May;22;2018-05-29 00:00;69;148;161;309
2018;May;22;2018-05-29 00:00;70;174;163;337
2018;May;22;2018-05-29 00:00;71;160;157;317
2018;May;22;2018-05-29 00:00;72;181;148;329
2018;May;22;2018-05-29 00:00;73;182;171;353
2018;May;22;2018-05-29 00:00;74;151;160;311
2018;May;22;2018-05-29 00:00;75;152;164;316
2018;May;22;2018-05-29 00:00;76;139;133;272
2018;May;22;2018-05-29 00:00;77;107;101;208
2018;May;22;2018-05-29 00:00;78;82;125;207
2018;May;22;2018-05-29 00:00;79;85;88;173
2018;May;22;2018-05-29 00:00;80;93;77;170
2018;May;22;2018-05-29 00:00;81;79;70;149
2018;May;22;2018-05-29 00:00;82;89;65;154
2018;May;22;2018-05-29 00:00;83;57;63;120
2018;May;22;2018-05-29 00:00;84;66;46;112
2018;May;22;2018-05-29 00:00;85;54;44;98
2018;May;22;2018-05-29 00:00;86;31;37;68
2018;May;22;2018-05-29 00:00;87;43;27;70
2018;May;22;2018-05-29 00:00;88;42;23;65
2018;May;22;2018-05-29 00:00;89;32;23;55
2018;May;22;2018-05-29 00:00;90;26;15;41
2018;May;22;2018-05-29 00:00;91;29;9;38
2018;May;22;2018-05-29 00:00;92;19;10;29
2018;May;22;2018-05-29 00:00;93;19;6;25
2018;May;22;2018-05-29 00:00;94;12;7;19
2018;May;22;2018-05-29 00:00;95;8;5;13
2018;May;22;2018-05-29 00:00;96;11;2;13
2018;May;22;2018-05-29 00:00;97;3;4;7
2018;May;22;2018-05-29 00:00;98;2;2;4
2018;May;22;2018-05-29 00:00;99;0;1;1
2018;May;22;2018-05-29 00:00;100;1;1;2
2018;May;22;2018-05-29 00:00;106;1;0;1
2018;June;23;2018-06-05 00:00;0;82;93;175
2018;June;23;2018-06-05 00:00;1;198;197;395
2018;June;23;2018-06-05 00:00;2;180;206;386
2018;June;23;2018-06-05 00:00;3;191;204;395
2018;June;23;2018-06-05 00:00;4;184;231;415
2018;June;23;2018-06-05 00:00;5;206;226;432
2018;June;23;2018-06-05 00:00;6;194;203;397
2018;June;23;2018-06-05 00:00;7;222;240;462
2018;June;23;2018-06-05 00:00;8;222;234;456
2018;June;23;2018-06-05 00:00;9;210;220;430
2018;June;23;2018-06-05 00:00;10;203;200;403
2018;June;23;2018-06-05 00:00;11;189;204;393
2018;June;23;2018-06-05 00:00;12;227;198;425
2018;June;23;2018-06-05 00:00;13;187;211;398
2018;June;23;2018-06-05 00:00;14;185;203;388
2018;June;23;2018-06-05 00:00;15;179;183;362
2018;June;23;2018-06-05 00:00;16;179;220;399
2018;June;23;2018-06-05 00:00;17;140;183;323
2018;June;23;2018-06-05 00:00;18;182;200;382
2018;June;23;2018-06-05 00:00;19;181;189;370
2018;June;23;2018-06-05 00:00;20;155;174;329
2018;June;23;2018-06-05 00:00;21;142;190;332
2018;June;23;2018-06-05 00:00;22;149;169;318
2018;June;23;2018-06-05 00:00;23;150;182;332
2018;June;23;2018-06-05 00:00;24;173;180;353
2018;June;23;2018-06-05 00:00;25;180;198;378
2018;June;23;2018-06-05 00:00;26;180;181;361
2018;June;23;2018-06-05 00:00;27;185;234;419
2018;June;23;2018-06-05 00:00;28;191;202;393
2018;June;23;2018-06-05 00:00;29;167;196;363
2018;June;23;2018-06-05 00:00;30;183;183;366
2018;June;23;2018-06-05 00:00;31;194;192;386
2018;June;23;2018-06-05 00:00;32;179;189;368
2018;June;23;2018-06-05 00:00;33;192;210;402
2018;June;23;2018-06-05 00:00;34;194;201;395
2018;June;23;2018-06-05 00:00;35;217;185;402
2018;June;23;2018-06-05 00:00;36;206;199;405
2018;June;23;2018-06-05 00:00;37;174;193;367
2018;June;23;2018-06-05 00:00;38;233;206;439
2018;June;23;2018-06-05 00:00;39;208;178;386
2018;June;23;2018-06-05 00:00;40;195;208;403
2018;June;23;2018-06-05 00:00;41;194;206;400
2018;June;23;2018-06-05 00:00;42;223;221;444
2018;June;23;2018-06-05 00:00;43;225;245;470
2018;June;23;2018-06-05 00:00;44;231;281;512
2018;June;23;2018-06-05 00:00;45;211;223;434
2018;June;23;2018-06-05 00:00;46;224;254;478
2018;June;23;2018-06-05 00:00;47;215;216;431
2018;June;23;2018-06-05 00:00;48;208;227;435
2018;June;23;2018-06-05 00:00;49;200;198;398
2018;June;23;2018-06-05 00:00;50;207;221;428
2018;June;23;2018-06-05 00:00;51;236;227;463
2018;June;23;2018-06-05 00:00;52;187;223;410
2018;June;23;2018-06-05 00:00;53;199;222;421
2018;June;23;2018-06-05 00:00;54;188;221;409
2018;June;23;2018-06-05 00:00;55;183;212;395
2018;June;23;2018-06-05 00:00;56;189;188;377
2018;June;23;2018-06-05 00:00;57;151;168;319
2018;June;23;2018-06-05 00:00;58;156;154;310
2018;June;23;2018-06-05 00:00;59;156;165;321
2018;June;23;2018-06-05 00:00;60;154;154;308
2018;June;23;2018-06-05 00:00;61;149;157;306
2018;June;23;2018-06-05 00:00;62;153;158;311
2018;June;23;2018-06-05 00:00;63;134;119;253
2018;June;23;2018-06-05 00:00;64;133;137;270
2018;June;23;2018-06-05 00:00;65;145;136;281
2018;June;23;2018-06-05 00:00;66;136;155;291
2018;June;23;2018-06-05 00:00;67;144;137;281
2018;June;23;2018-06-05 00:00;68;141;156;297
2018;June;23;2018-06-05 00:00;69;149;161;310
2018;June;23;2018-06-05 00:00;70;174;163;337
2018;June;23;2018-06-05 00:00;71;160;157;317
2018;June;23;2018-06-05 00:00;72;181;148;329
2018;June;23;2018-06-05 00:00;73;182;171;353
2018;June;23;2018-06-05 00:00;74;151;160;311
2018;June;23;2018-06-05 00:00;75;152;164;316
2018;June;23;2018-06-05 00:00;76;139;133;272
2018;June;23;2018-06-05 00:00;77;107;101;208
2018;June;23;2018-06-05 00:00;78;82;125;207
2018;June;23;2018-06-05 00:00;79;85;88;173
2018;June;23;2018-06-05 00:00;80;93;77;170
2018;June;23;2018-06-05 00:00;81;79;70;149
2018;June;23;2018-06-05 00:00;82;89;65;154
2018;June;23;2018-06-05 00:00;83;57;63;120
2018;June;23;2018-06-05 00:00;84;66;46;112
2018;June;23;2018-06-05 00:00;85;54;44;98
2018;June;23;2018-06-05 00:00;86;31;37;68
2018;June;23;2018-06-05 00:00;87;43;26;69
2018;June;23;2018-06-05 00:00;88;42;23;65
2018;June;23;2018-06-05 00:00;89;32;23;55
2018;June;23;2018-06-05 00:00;90;26;15;41
2018;June;23;2018-06-05 00:00;91;29;9;38
2018;June;23;2018-06-05 00:00;92;19;10;29
2018;June;23;2018-06-05 00:00;93;19;6;25
2018;June;23;2018-06-05 00:00;94;12;7;19
2018;June;23;2018-06-05 00:00;95;8;5;13
2018;June;23;2018-06-05 00:00;96;11;2;13
2018;June;23;2018-06-05 00:00;97;3;4;7
2018;June;23;2018-06-05 00:00;98;2;2;4
2018;June;23;2018-06-05 00:00;99;0;1;1
2018;June;23;2018-06-05 00:00;100;1;1;2
2018;June;23;2018-06-05 00:00;106;1;0;1
2018;June;24;2018-06-13 00:00;0;88;97;185
2018;June;24;2018-06-13 00:00;1;199;197;396
2018;June;24;2018-06-13 00:00;2;180;207;387
2018;June;24;2018-06-13 00:00;3;193;205;398
2018;June;24;2018-06-13 00:00;4;184;231;415
2018;June;24;2018-06-13 00:00;5;207;227;434
2018;June;24;2018-06-13 00:00;6;194;203;397
2018;June;24;2018-06-13 00:00;7;222;240;462
2018;June;24;2018-06-13 00:00;8;222;234;456
2018;June;24;2018-06-13 00:00;9;210;220;430
2018;June;24;2018-06-13 00:00;10;203;200;403
2018;June;24;2018-06-13 00:00;11;190;204;394
2018;June;24;2018-06-13 00:00;12;227;199;426
2018;June;24;2018-06-13 00:00;13;188;211;399
2018;June;24;2018-06-13 00:00;14;185;203;388
2018;June;24;2018-06-13 00:00;15;179;183;362
2018;June;24;2018-06-13 00:00;16;179;221;400
2018;June;24;2018-06-13 00:00;17;140;183;323
2018;June;24;2018-06-13 00:00;18;183;200;383
2018;June;24;2018-06-13 00:00;19;181;189;370
2018;June;24;2018-06-13 00:00;20;154;174;328
2018;June;24;2018-06-13 00:00;21;144;189;333
2018;June;24;2018-06-13 00:00;22;149;169;318
2018;June;24;2018-06-13 00:00;23;150;181;331
2018;June;24;2018-06-13 00:00;24;171;180;351
2018;June;24;2018-06-13 00:00;25;180;200;380
2018;June;24;2018-06-13 00:00;26;181;181;362
2018;June;24;2018-06-13 00:00;27;187;234;421
2018;June;24;2018-06-13 00:00;28;193;205;398
2018;June;24;2018-06-13 00:00;29;170;196;366
2018;June;24;2018-06-13 00:00;30;183;186;369
2018;June;24;2018-06-13 00:00;31;199;193;392
2018;June;24;2018-06-13 00:00;32;177;189;366
2018;June;24;2018-06-13 00:00;33;192;211;403
2018;June;24;2018-06-13 00:00;34;194;201;395
2018;June;24;2018-06-13 00:00;35;217;186;403
2018;June;24;2018-06-13 00:00;36;206;200;406
2018;June;24;2018-06-13 00:00;37;175;193;368
2018;June;24;2018-06-13 00:00;38;233;207;440
2018;June;24;2018-06-13 00:00;39;208;178;386
2018;June;24;2018-06-13 00:00;40;194;209;403
2018;June;24;2018-06-13 00:00;41;194;206;400
2018;June;24;2018-06-13 00:00;42;223;223;446
2018;June;24;2018-06-13 00:00;43;226;245;471
2018;June;24;2018-06-13 00:00;44;231;281;512
2018;June;24;2018-06-13 00:00;45;211;223;434
2018;June;24;2018-06-13 00:00;46;225;254;479
2018;June;24;2018-06-13 00:00;47;215;216;431
2018;June;24;2018-06-13 00:00;48;208;227;435
2018;June;24;2018-06-13 00:00;49;199;198;397
2018;June;24;2018-06-13 00:00;50;207;220;427
2018;June;24;2018-06-13 00:00;51;237;227;464
2018;June;24;2018-06-13 00:00;52;187;223;410
2018;June;24;2018-06-13 00:00;53;199;222;421
2018;June;24;2018-06-13 00:00;54;187;221;408
2018;June;24;2018-06-13 00:00;55;183;213;396
2018;June;24;2018-06-13 00:00;56;189;188;377
2018;June;24;2018-06-13 00:00;57;151;168;319
2018;June;24;2018-06-13 00:00;58;156;154;310
2018;June;24;2018-06-13 00:00;59;156;164;320
2018;June;24;2018-06-13 00:00;60;154;154;308
2018;June;24;2018-06-13 00:00;61;148;156;304
2018;June;24;2018-06-13 00:00;62;153;158;311
2018;June;24;2018-06-13 00:00;63;134;119;253
2018;June;24;2018-06-13 00:00;64;133;137;270
2018;June;24;2018-06-13 00:00;65;145;136;281
2018;June;24;2018-06-13 00:00;66;136;155;291
2018;June;24;2018-06-13 00:00;67;144;137;281
2018;June;24;2018-06-13 00:00;68;141;156;297
2018;June;24;2018-06-13 00:00;69;149;161;310
2018;June;24;2018-06-13 00:00;70;175;163;338
2018;June;24;2018-06-13 00:00;71;160;157;317
2018;June;24;2018-06-13 00:00;72;181;148;329
2018;June;24;2018-06-13 00:00;73;182;171;353
2018;June;24;2018-06-13 00:00;74;151;160;311
2018;June;24;2018-06-13 00:00;75;152;164;316
2018;June;24;2018-06-13 00:00;76;139;133;272
2018;June;24;2018-06-13 00:00;77;107;101;208
2018;June;24;2018-06-13 00:00;78;82;125;207
2018;June;24;2018-06-13 00:00;79;85;88;173
2018;June;24;2018-06-13 00:00;80;93;77;170
2018;June;24;2018-06-13 00:00;81;79;70;149
2018;June;24;2018-06-13 00:00;82;89;65;154
2018;June;24;2018-06-13 00:00;83;56;63;119
2018;June;24;2018-06-13 00:00;84;66;46;112
2018;June;24;2018-06-13 00:00;85;54;44;98
2018;June;24;2018-06-13 00:00;86;31;36;67
2018;June;24;2018-06-13 00:00;87;43;26;69
2018;June;24;2018-06-13 00:00;88;42;23;65
2018;June;24;2018-06-13 00:00;89;32;23;55
2018;June;24;2018-06-13 00:00;90;26;15;41
2018;June;24;2018-06-13 00:00;91;29;9;38
2018;June;24;2018-06-13 00:00;92;19;10;29
2018;June;24;2018-06-13 00:00;93;19;6;25
2018;June;24;2018-06-13 00:00;94;12;7;19
2018;June;24;2018-06-13 00:00;95;8;5;13
2018;June;24;2018-06-13 00:00;96;11;2;13
2018;June;24;2018-06-13 00:00;97;3;4;7
2018;June;24;2018-06-13 00:00;98;2;2;4
2018;June;24;2018-06-13 00:00;99;0;1;1
2018;June;24;2018-06-13 00:00;100;1;1;2
2018;June;24;2018-06-13 00:00;106;1;0;1
2018;June;25;2018-06-19 00:00;0;97;101;198
2018;June;25;2018-06-19 00:00;1;199;198;397
2018;June;25;2018-06-19 00:00;2;181;208;389
2018;June;25;2018-06-19 00:00;3;192;206;398
2018;June;25;2018-06-19 00:00;4;184;230;414
2018;June;25;2018-06-19 00:00;5;207;227;434
2018;June;25;2018-06-19 00:00;6;193;201;394
2018;June;25;2018-06-19 00:00;7;222;239;461
2018;June;25;2018-06-19 00:00;8;221;234;455
2018;June;25;2018-06-19 00:00;9;211;221;432
2018;June;25;2018-06-19 00:00;10;203;200;403
2018;June;25;2018-06-19 00:00;11;191;204;395
2018;June;25;2018-06-19 00:00;12;227;199;426
2018;June;25;2018-06-19 00:00;13;188;212;400
2018;June;25;2018-06-19 00:00;14;185;203;388
2018;June;25;2018-06-19 00:00;15;178;182;360
2018;June;25;2018-06-19 00:00;16;180;221;401
2018;June;25;2018-06-19 00:00;17;141;183;324
2018;June;25;2018-06-19 00:00;18;183;200;383
2018;June;25;2018-06-19 00:00;19;180;189;369
2018;June;25;2018-06-19 00:00;20;154;174;328
2018;June;25;2018-06-19 00:00;21;144;189;333
2018;June;25;2018-06-19 00:00;22;149;169;318
2018;June;25;2018-06-19 00:00;23;145;181;326
2018;June;25;2018-06-19 00:00;24;172;181;353
2018;June;25;2018-06-19 00:00;25;181;200;381
2018;June;25;2018-06-19 00:00;26;183;180;363
2018;June;25;2018-06-19 00:00;27;187;233;420
2018;June;25;2018-06-19 00:00;28;195;204;399
2018;June;25;2018-06-19 00:00;29;170;195;365
2018;June;25;2018-06-19 00:00;30;184;187;371
2018;June;25;2018-06-19 00:00;31;200;193;393
2018;June;25;2018-06-19 00:00;32;176;188;364
2018;June;25;2018-06-19 00:00;33;194;210;404
2018;June;25;2018-06-19 00:00;34;194;204;398
2018;June;25;2018-06-19 00:00;35;218;187;405
2018;June;25;2018-06-19 00:00;36;208;200;408
2018;June;25;2018-06-19 00:00;37;176;192;368
2018;June;25;2018-06-19 00:00;38;233;208;441
2018;June;25;2018-06-19 00:00;39;208;178;386
2018;June;25;2018-06-19 00:00;40;194;209;403
2018;June;25;2018-06-19 00:00;41;194;206;400
2018;June;25;2018-06-19 00:00;42;223;224;447
2018;June;25;2018-06-19 00:00;43;226;245;471
2018;June;25;2018-06-19 00:00;44;231;281;512
2018;June;25;2018-06-19 00:00;45;211;224;435
2018;June;25;2018-06-19 00:00;46;224;255;479
2018;June;25;2018-06-19 00:00;47;215;216;431
2018;June;25;2018-06-19 00:00;48;208;227;435
2018;June;25;2018-06-19 00:00;49;198;197;395
2018;June;25;2018-06-19 00:00;50;208;219;427
2018;June;25;2018-06-19 00:00;51;237;227;464
2018;June;25;2018-06-19 00:00;52;187;223;410
2018;June;25;2018-06-19 00:00;53;199;223;422
2018;June;25;2018-06-19 00:00;54;187;221;408
2018;June;25;2018-06-19 00:00;55;182;212;394
2018;June;25;2018-06-19 00:00;56;189;186;375
2018;June;25;2018-06-19 00:00;57;151;168;319
2018;June;25;2018-06-19 00:00;58;156;154;310
2018;June;25;2018-06-19 00:00;59;156;164;320
2018;June;25;2018-06-19 00:00;60;154;154;308
2018;June;25;2018-06-19 00:00;61;147;156;303
2018;June;25;2018-06-19 00:00;62;152;158;310
2018;June;25;2018-06-19 00:00;63;134;118;252
2018;June;25;2018-06-19 00:00;64;133;137;270
2018;June;25;2018-06-19 00:00;65;145;136;281
2018;June;25;2018-06-19 00:00;66;136;154;290
2018;June;25;2018-06-19 00:00;67;144;136;280
2018;June;25;2018-06-19 00:00;68;141;156;297
2018;June;25;2018-06-19 00:00;69;149;161;310
2018;June;25;2018-06-19 00:00;70;175;163;338
2018;June;25;2018-06-19 00:00;71;160;156;316
2018;June;25;2018-06-19 00:00;72;181;148;329
2018;June;25;2018-06-19 00:00;73;182;171;353
2018;June;25;2018-06-19 00:00;74;152;160;312
2018;June;25;2018-06-19 00:00;75;152;164;316
2018;June;25;2018-06-19 00:00;76;138;133;271
2018;June;25;2018-06-19 00:00;77;106;101;207
2018;June;25;2018-06-19 00:00;78;82;125;207
2018;June;25;2018-06-19 00:00;79;85;88;173
2018;June;25;2018-06-19 00:00;80;93;77;170
2018;June;25;2018-06-19 00:00;81;79;70;149
2018;June;25;2018-06-19 00:00;82;89;65;154
2018;June;25;2018-06-19 00:00;83;56;63;119
2018;June;25;2018-06-19 00:00;84;66;46;112
2018;June;25;2018-06-19 00:00;85;54;44;98
2018;June;25;2018-06-19 00:00;86;31;36;67
2018;June;25;2018-06-19 00:00;87;42;26;68
2018;June;25;2018-06-19 00:00;88;42;23;65
2018;June;25;2018-06-19 00:00;89;32;23;55
2018;June;25;2018-06-19 00:00;90;26;15;41
2018;June;25;2018-06-19 00:00;91;29;9;38
2018;June;25;2018-06-19 00:00;92;19;10;29
2018;June;25;2018-06-19 00:00;93;19;6;25
2018;June;25;2018-06-19 00:00;94;12;7;19
2018;June;25;2018-06-19 00:00;95;8;5;13
2018;June;25;2018-06-19 00:00;96;11;2;13
2018;June;25;2018-06-19 00:00;97;3;4;7
2018;June;25;2018-06-19 00:00;98;2;2;4
2018;June;25;2018-06-19 00:00;99;0;1;1
2018;June;25;2018-06-19 00:00;100;1;1;2
2018;June;25;2018-06-19 00:00;106;1;0;1
2018;June;26;2018-06-26 00:00;0;100;104;204
2018;June;26;2018-06-26 00:00;1;199;198;397
2018;June;26;2018-06-26 00:00;2;181;208;389
2018;June;26;2018-06-26 00:00;3;191;207;398
2018;June;26;2018-06-26 00:00;4;184;230;414
2018;June;26;2018-06-26 00:00;5;207;227;434
2018;June;26;2018-06-26 00:00;6;193;202;395
2018;June;26;2018-06-26 00:00;7;222;239;461
2018;June;26;2018-06-26 00:00;8;221;234;455
2018;June;26;2018-06-26 00:00;9;211;221;432
2018;June;26;2018-06-26 00:00;10;202;200;402
2018;June;26;2018-06-26 00:00;11;191;204;395
2018;June;26;2018-06-26 00:00;12;227;199;426
2018;June;26;2018-06-26 00:00;13;188;212;400
2018;June;26;2018-06-26 00:00;14;186;203;389
2018;June;26;2018-06-26 00:00;15;178;182;360
2018;June;26;2018-06-26 00:00;16;181;221;402
2018;June;26;2018-06-26 00:00;17;141;183;324
2018;June;26;2018-06-26 00:00;18;182;200;382
2018;June;26;2018-06-26 00:00;19;178;189;367
2018;June;26;2018-06-26 00:00;20;155;173;328
2018;June;26;2018-06-26 00:00;21;144;189;333
2018;June;26;2018-06-26 00:00;22;149;168;317
2018;June;26;2018-06-26 00:00;23;146;182;328
2018;June;26;2018-06-26 00:00;24;174;182;356
2018;June;26;2018-06-26 00:00;25;180;202;382
2018;June;26;2018-06-26 00:00;26;181;182;363
2018;June;26;2018-06-26 00:00;27;187;235;422
2018;June;26;2018-06-26 00:00;28;196;205;401
2018;June;26;2018-06-26 00:00;29;171;196;367
2018;June;26;2018-06-26 00:00;30;186;187;373
2018;June;26;2018-06-26 00:00;31;201;193;394
2018;June;26;2018-06-26 00:00;32;176;187;363
2018;June;26;2018-06-26 00:00;33;195;211;406
2018;June;26;2018-06-26 00:00;34;193;204;397
2018;June;26;2018-06-26 00:00;35;216;188;404
2018;June;26;2018-06-26 00:00;36;208;200;408
2018;June;26;2018-06-26 00:00;37;176;191;367
2018;June;26;2018-06-26 00:00;38;234;208;442
2018;June;26;2018-06-26 00:00;39;208;178;386
2018;June;26;2018-06-26 00:00;40;194;208;402
2018;June;26;2018-06-26 00:00;41;194;206;400
2018;June;26;2018-06-26 00:00;42;223;222;445
2018;June;26;2018-06-26 00:00;43;226;246;472
2018;June;26;2018-06-26 00:00;44;231;279;510
2018;June;26;2018-06-26 00:00;45;211;223;434
2018;June;26;2018-06-26 00:00;46;223;255;478
2018;June;26;2018-06-26 00:00;47;215;216;431
2018;June;26;2018-06-26 00:00;48;207;227;434
2018;June;26;2018-06-26 00:00;49;198;196;394
2018;June;26;2018-06-26 00:00;50;208;219;427
2018;June;26;2018-06-26 00:00;51;237;227;464
2018;June;26;2018-06-26 00:00;52;187;223;410
2018;June;26;2018-06-26 00:00;53;199;223;422
2018;June;26;2018-06-26 00:00;54;187;221;408
2018;June;26;2018-06-26 00:00;55;182;212;394
2018;June;26;2018-06-26 00:00;56;189;186;375
2018;June;26;2018-06-26 00:00;57;151;168;319
2018;June;26;2018-06-26 00:00;58;156;154;310
2018;June;26;2018-06-26 00:00;59;156;164;320
2018;June;26;2018-06-26 00:00;60;154;154;308
2018;June;26;2018-06-26 00:00;61;147;156;303
2018;June;26;2018-06-26 00:00;62;151;158;309
2018;June;26;2018-06-26 00:00;63;134;118;252
2018;June;26;2018-06-26 00:00;64;133;137;270
2018;June;26;2018-06-26 00:00;65;145;136;281
2018;June;26;2018-06-26 00:00;66;136;154;290
2018;June;26;2018-06-26 00:00;67;144;136;280
2018;June;26;2018-06-26 00:00;68;141;156;297
2018;June;26;2018-06-26 00:00;69;148;161;309
2018;June;26;2018-06-26 00:00;70;175;163;338
2018;June;26;2018-06-26 00:00;71;160;156;316
2018;June;26;2018-06-26 00:00;72;181;148;329
2018;June;26;2018-06-26 00:00;73;182;172;354
2018;June;26;2018-06-26 00:00;74;152;160;312
2018;June;26;2018-06-26 00:00;75;152;164;316
2018;June;26;2018-06-26 00:00;76;138;133;271
2018;June;26;2018-06-26 00:00;77;106;101;207
2018;June;26;2018-06-26 00:00;78;82;125;207
2018;June;26;2018-06-26 00:00;79;85;88;173
2018;June;26;2018-06-26 00:00;80;93;77;170
2018;June;26;2018-06-26 00:00;81;79;70;149
2018;June;26;2018-06-26 00:00;82;90;65;155
2018;June;26;2018-06-26 00:00;83;56;63;119
2018;June;26;2018-06-26 00:00;84;64;46;110
2018;June;26;2018-06-26 00:00;85;54;44;98
2018;June;26;2018-06-26 00:00;86;31;36;67
2018;June;26;2018-06-26 00:00;87;42;26;68
2018;June;26;2018-06-26 00:00;88;42;23;65
2018;June;26;2018-06-26 00:00;89;32;23;55
2018;June;26;2018-06-26 00:00;90;26;15;41
2018;June;26;2018-06-26 00:00;91;29;9;38
2018;June;26;2018-06-26 00:00;92;19;11;30
2018;June;26;2018-06-26 00:00;93;19;6;25
2018;June;26;2018-06-26 00:00;94;12;7;19
2018;June;26;2018-06-26 00:00;95;8;5;13
2018;June;26;2018-06-26 00:00;96;11;2;13
2018;June;26;2018-06-26 00:00;97;3;4;7
2018;June;26;2018-06-26 00:00;98;2;2;4
2018;June;26;2018-06-26 00:00;99;0;1;1
2018;June;26;2018-06-26 00:00;100;1;1;2
2018;June;26;2018-06-26 00:00;106;1;0;1
2018;July;27;2018-07-03 00:00;0;103;108;211
2018;July;27;2018-07-03 00:00;1;199;199;398
2018;July;27;2018-07-03 00:00;2;182;209;391
2018;July;27;2018-07-03 00:00;3;191;208;399
2018;July;27;2018-07-03 00:00;4;184;231;415
2018;July;27;2018-07-03 00:00;5;208;226;434
2018;July;27;2018-07-03 00:00;6;194;201;395
2018;July;27;2018-07-03 00:00;7;222;238;460
2018;July;27;2018-07-03 00:00;8;221;235;456
2018;July;27;2018-07-03 00:00;9;211;221;432
2018;July;27;2018-07-03 00:00;10;202;200;402
2018;July;27;2018-07-03 00:00;11;191;204;395
2018;July;27;2018-07-03 00:00;12;226;200;426
2018;July;27;2018-07-03 00:00;13;188;213;401
2018;July;27;2018-07-03 00:00;14;185;203;388
2018;July;27;2018-07-03 00:00;15;178;182;360
2018;July;27;2018-07-03 00:00;16;181;222;403
2018;July;27;2018-07-03 00:00;17;142;182;324
2018;July;27;2018-07-03 00:00;18;182;197;379
2018;July;27;2018-07-03 00:00;19;177;187;364
2018;July;27;2018-07-03 00:00;20;155;170;325
2018;July;27;2018-07-03 00:00;21;144;189;333
2018;July;27;2018-07-03 00:00;22;147;168;315
2018;July;27;2018-07-03 00:00;23;147;182;329
2018;July;27;2018-07-03 00:00;24;173;181;354
2018;July;27;2018-07-03 00:00;25;180;201;381
2018;July;27;2018-07-03 00:00;26;179;181;360
2018;July;27;2018-07-03 00:00;27;187;235;422
2018;July;27;2018-07-03 00:00;28;195;206;401
2018;July;27;2018-07-03 00:00;29;172;197;369
2018;July;27;2018-07-03 00:00;30;187;186;373
2018;July;27;2018-07-03 00:00;31;201;197;398
2018;July;27;2018-07-03 00:00;32;176;187;363
2018;July;27;2018-07-03 00:00;33;196;212;408
2018;July;27;2018-07-03 00:00;34;194;205;399
2018;July;27;2018-07-03 00:00;35;216;186;402
2018;July;27;2018-07-03 00:00;36;208;201;409
2018;July;27;2018-07-03 00:00;37;177;191;368
2018;July;27;2018-07-03 00:00;38;237;209;446
2018;July;27;2018-07-03 00:00;39;208;178;386
2018;July;27;2018-07-03 00:00;40;194;208;402
2018;July;27;2018-07-03 00:00;41;194;206;400
2018;July;27;2018-07-03 00:00;42;222;222;444
2018;July;27;2018-07-03 00:00;43;226;245;471
2018;July;27;2018-07-03 00:00;44;231;282;513
2018;July;27;2018-07-03 00:00;45;210;224;434
2018;July;27;2018-07-03 00:00;46;223;253;476
2018;July;27;2018-07-03 00:00;47;215;216;431
2018;July;27;2018-07-03 00:00;48;208;228;436
2018;July;27;2018-07-03 00:00;49;198;194;392
2018;July;27;2018-07-03 00:00;50;208;219;427
2018;July;27;2018-07-03 00:00;51;237;226;463
2018;July;27;2018-07-03 00:00;52;187;223;410
2018;July;27;2018-07-03 00:00;53;198;223;421
2018;July;27;2018-07-03 00:00;54;187;221;408
2018;July;27;2018-07-03 00:00;55;180;212;392
2018;July;27;2018-07-03 00:00;56;189;187;376
2018;July;27;2018-07-03 00:00;57;151;168;319
2018;July;27;2018-07-03 00:00;58;156;154;310
2018;July;27;2018-07-03 00:00;59;156;163;319
2018;July;27;2018-07-03 00:00;60;152;154;306
2018;July;27;2018-07-03 00:00;61;146;156;302
2018;July;27;2018-07-03 00:00;62;151;158;309
2018;July;27;2018-07-03 00:00;63;134;118;252
2018;July;27;2018-07-03 00:00;64;133;137;270
2018;July;27;2018-07-03 00:00;65;145;136;281
2018;July;27;2018-07-03 00:00;66;136;154;290
2018;July;27;2018-07-03 00:00;67;144;136;280
2018;July;27;2018-07-03 00:00;68;141;156;297
2018;July;27;2018-07-03 00:00;69;149;160;309
2018;July;27;2018-07-03 00:00;70;175;163;338
2018;July;27;2018-07-03 00:00;71;160;156;316
2018;July;27;2018-07-03 00:00;72;181;148;329
2018;July;27;2018-07-03 00:00;73;183;172;355
2018;July;27;2018-07-03 00:00;74;152;160;312
2018;July;27;2018-07-03 00:00;75;152;164;316
2018;July;27;2018-07-03 00:00;76;138;133;271
2018;July;27;2018-07-03 00:00;77;106;101;207
2018;July;27;2018-07-03 00:00;78;82;125;207
2018;July;27;2018-07-03 00:00;79;86;88;174
2018;July;27;2018-07-03 00:00;80;93;77;170
2018;July;27;2018-07-03 00:00;81;79;70;149
2018;July;27;2018-07-03 00:00;82;90;65;155
2018;July;27;2018-07-03 00:00;83;56;63;119
2018;July;27;2018-07-03 00:00;84;64;47;111
2018;July;27;2018-07-03 00:00;85;54;44;98
2018;July;27;2018-07-03 00:00;86;31;36;67
2018;July;27;2018-07-03 00:00;87;43;26;69
2018;July;27;2018-07-03 00:00;88;42;23;65
2018;July;27;2018-07-03 00:00;89;34;23;57
2018;July;27;2018-07-03 00:00;90;26;15;41
2018;July;27;2018-07-03 00:00;91;29;9;38
2018;July;27;2018-07-03 00:00;92;19;11;30
2018;July;27;2018-07-03 00:00;93;19;6;25
2018;July;27;2018-07-03 00:00;94;12;7;19
2018;July;27;2018-07-03 00:00;95;7;5;12
2018;July;27;2018-07-03 00:00;96;11;2;13
2018;July;27;2018-07-03 00:00;97;3;4;7
2018;July;27;2018-07-03 00:00;98;2;2;4
2018;July;27;2018-07-03 00:00;99;0;1;1
2018;July;27;2018-07-03 00:00;100;1;0;1
2018;July;27;2018-07-03 00:00;106;1;0;1
2018;July;29;2018-07-17 00:00;0;106;114;220
2018;July;29;2018-07-17 00:00;1;202;201;403
2018;July;29;2018-07-17 00:00;2;180;210;390
2018;July;29;2018-07-17 00:00;3;192;208;400
2018;July;29;2018-07-17 00:00;4;186;230;416
2018;July;29;2018-07-17 00:00;5;207;226;433
2018;July;29;2018-07-17 00:00;6;194;201;395
2018;July;29;2018-07-17 00:00;7;223;239;462
2018;July;29;2018-07-17 00:00;8;224;239;463
2018;July;29;2018-07-17 00:00;9;212;222;434
2018;July;29;2018-07-17 00:00;10;202;201;403
2018;July;29;2018-07-17 00:00;11;191;204;395
2018;July;29;2018-07-17 00:00;12;226;200;426
2018;July;29;2018-07-17 00:00;13;188;214;402
2018;July;29;2018-07-17 00:00;14;185;205;390
2018;July;29;2018-07-17 00:00;15;178;182;360
2018;July;29;2018-07-17 00:00;16;182;222;404
2018;July;29;2018-07-17 00:00;17;142;183;325
2018;July;29;2018-07-17 00:00;18;183;195;378
2018;July;29;2018-07-17 00:00;19;178;188;366
2018;July;29;2018-07-17 00:00;20;154;171;325
2018;July;29;2018-07-17 00:00;21;147;188;335
2018;July;29;2018-07-17 00:00;22;147;168;315
2018;July;29;2018-07-17 00:00;23;148;182;330
2018;July;29;2018-07-17 00:00;24;173;182;355
2018;July;29;2018-07-17 00:00;25;180;200;380
2018;July;29;2018-07-17 00:00;26;181;184;365
2018;July;29;2018-07-17 00:00;27;188;236;424
2018;July;29;2018-07-17 00:00;28;195;208;403
2018;July;29;2018-07-17 00:00;29;173;197;370
2018;July;29;2018-07-17 00:00;30;189;187;376
2018;July;29;2018-07-17 00:00;31;203;197;400
2018;July;29;2018-07-17 00:00;32;173;187;360
2018;July;29;2018-07-17 00:00;33;196;212;408
2018;July;29;2018-07-17 00:00;34;194;206;400
2018;July;29;2018-07-17 00:00;35;214;185;399
2018;July;29;2018-07-17 00:00;36;207;201;408
2018;July;29;2018-07-17 00:00;37;177;192;369
2018;July;29;2018-07-17 00:00;38;235;210;445
2018;July;29;2018-07-17 00:00;39;209;178;387
2018;July;29;2018-07-17 00:00;40;195;209;404
2018;July;29;2018-07-17 00:00;41;195;207;402
2018;July;29;2018-07-17 00:00;42;223;220;443
2018;July;29;2018-07-17 00:00;43;225;246;471
2018;July;29;2018-07-17 00:00;44;232;282;514
2018;July;29;2018-07-17 00:00;45;211;224;435
2018;July;29;2018-07-17 00:00;46;223;254;477
2018;July;29;2018-07-17 00:00;47;215;217;432
2018;July;29;2018-07-17 00:00;48;208;227;435
2018;July;29;2018-07-17 00:00;49;198;195;393
2018;July;29;2018-07-17 00:00;50;208;220;428
2018;July;29;2018-07-17 00:00;51;237;226;463
2018;July;29;2018-07-17 00:00;52;186;223;409
2018;July;29;2018-07-17 00:00;53;198;224;422
2018;July;29;2018-07-17 00:00;54;187;221;408
2018;July;29;2018-07-17 00:00;55;181;212;393
2018;July;29;2018-07-17 00:00;56;189;187;376
2018;July;29;2018-07-17 00:00;57;150;168;318
2018;July;29;2018-07-17 00:00;58;156;155;311
2018;July;29;2018-07-17 00:00;59;156;162;318
2018;July;29;2018-07-17 00:00;60;152;154;306
2018;July;29;2018-07-17 00:00;61;146;156;302
2018;July;29;2018-07-17 00:00;62;151;158;309
2018;July;29;2018-07-17 00:00;63;134;118;252
2018;July;29;2018-07-17 00:00;64;133;137;270
2018;July;29;2018-07-17 00:00;65;145;136;281
2018;July;29;2018-07-17 00:00;66;136;154;290
2018;July;29;2018-07-17 00:00;67;144;137;281
2018;July;29;2018-07-17 00:00;68;142;156;298
2018;July;29;2018-07-17 00:00;69;149;160;309
2018;July;29;2018-07-17 00:00;70;175;162;337
2018;July;29;2018-07-17 00:00;71;160;156;316
2018;July;29;2018-07-17 00:00;72;181;148;329
2018;July;29;2018-07-17 00:00;73;183;172;355
2018;July;29;2018-07-17 00:00;74;152;160;312
2018;July;29;2018-07-17 00:00;75;152;164;316
2018;July;29;2018-07-17 00:00;76;138;133;271
2018;July;29;2018-07-17 00:00;77;106;101;207
2018;July;29;2018-07-17 00:00;78;82;125;207
2018;July;29;2018-07-17 00:00;79;86;88;174
2018;July;29;2018-07-17 00:00;80;93;77;170
2018;July;29;2018-07-17 00:00;81;78;70;148
2018;July;29;2018-07-17 00:00;82;90;65;155
2018;July;29;2018-07-17 00:00;83;55;63;118
2018;July;29;2018-07-17 00:00;84;64;47;111
2018;July;29;2018-07-17 00:00;85;54;44;98
2018;July;29;2018-07-17 00:00;86;31;35;66
2018;July;29;2018-07-17 00:00;87;43;26;69
2018;July;29;2018-07-17 00:00;88;42;23;65
2018;July;29;2018-07-17 00:00;89;34;23;57
2018;July;29;2018-07-17 00:00;90;26;15;41
2018;July;29;2018-07-17 00:00;91;29;9;38
2018;July;29;2018-07-17 00:00;92;19;11;30
2018;July;29;2018-07-17 00:00;93;19;6;25
2018;July;29;2018-07-17 00:00;94;12;7;19
2018;July;29;2018-07-17 00:00;95;7;5;12
2018;July;29;2018-07-17 00:00;96;11;2;13
2018;July;29;2018-07-17 00:00;97;3;4;7
2018;July;29;2018-07-17 00:00;98;2;2;4
2018;July;29;2018-07-17 00:00;99;0;1;1
2018;July;29;2018-07-17 00:00;100;1;0;1
2018;July;29;2018-07-17 00:00;106;1;0;1
2018;July;31;2018-07-31 00:00;0;117;125;242
2018;July;31;2018-07-31 00:00;1;205;200;405
2018;July;31;2018-07-31 00:00;2;180;210;390
2018;July;31;2018-07-31 00:00;3;194;208;402
2018;July;31;2018-07-31 00:00;4;185;233;418
2018;July;31;2018-07-31 00:00;5;207;225;432
2018;July;31;2018-07-31 00:00;6;195;200;395
2018;July;31;2018-07-31 00:00;7;223;239;462
2018;July;31;2018-07-31 00:00;8;224;239;463
2018;July;31;2018-07-31 00:00;9;213;222;435
2018;July;31;2018-07-31 00:00;10;202;200;402
2018;July;31;2018-07-31 00:00;11;190;206;396
2018;July;31;2018-07-31 00:00;12;226;200;426
2018;July;31;2018-07-31 00:00;13;189;214;403
2018;July;31;2018-07-31 00:00;14;185;205;390
2018;July;31;2018-07-31 00:00;15;178;182;360
2018;July;31;2018-07-31 00:00;16;182;224;406
2018;July;31;2018-07-31 00:00;17;142;183;325
2018;July;31;2018-07-31 00:00;18;183;195;378
2018;July;31;2018-07-31 00:00;19;175;188;363
2018;July;31;2018-07-31 00:00;20;155;170;325
2018;July;31;2018-07-31 00:00;21;149;190;339
2018;July;31;2018-07-31 00:00;22;148;168;316
2018;July;31;2018-07-31 00:00;23;149;183;332
2018;July;31;2018-07-31 00:00;24;173;180;353
2018;July;31;2018-07-31 00:00;25;182;201;383
2018;July;31;2018-07-31 00:00;26;181;184;365
2018;July;31;2018-07-31 00:00;27;190;234;424
2018;July;31;2018-07-31 00:00;28;193;207;400
2018;July;31;2018-07-31 00:00;29;175;196;371
2018;July;31;2018-07-31 00:00;30;190;186;376
2018;July;31;2018-07-31 00:00;31;202;200;402
2018;July;31;2018-07-31 00:00;32;174;186;360
2018;July;31;2018-07-31 00:00;33;198;212;410
2018;July;31;2018-07-31 00:00;34;194;206;400
2018;July;31;2018-07-31 00:00;35;213;185;398
2018;July;31;2018-07-31 00:00;36;207;202;409
2018;July;31;2018-07-31 00:00;37;177;192;369
2018;July;31;2018-07-31 00:00;38;236;209;445
2018;July;31;2018-07-31 00:00;39;209;180;389
2018;July;31;2018-07-31 00:00;40;196;208;404
2018;July;31;2018-07-31 00:00;41;196;208;404
2018;July;31;2018-07-31 00:00;42;223;219;442
2018;July;31;2018-07-31 00:00;43;225;246;471
2018;July;31;2018-07-31 00:00;44;233;281;514
2018;July;31;2018-07-31 00:00;45;211;223;434
2018;July;31;2018-07-31 00:00;46;223;255;478
2018;July;31;2018-07-31 00:00;47;215;216;431
2018;July;31;2018-07-31 00:00;48;209;228;437
2018;July;31;2018-07-31 00:00;49;198;196;394
2018;July;31;2018-07-31 00:00;50;208;221;429
2018;July;31;2018-07-31 00:00;51;237;226;463
2018;July;31;2018-07-31 00:00;52;186;224;410
2018;July;31;2018-07-31 00:00;53;198;223;421
2018;July;31;2018-07-31 00:00;54;187;222;409
2018;July;31;2018-07-31 00:00;55;181;211;392
2018;July;31;2018-07-31 00:00;56;190;188;378
2018;July;31;2018-07-31 00:00;57;150;168;318
2018;July;31;2018-07-31 00:00;58;156;155;311
2018;July;31;2018-07-31 00:00;59;156;162;318
2018;July;31;2018-07-31 00:00;60;152;154;306
2018;July;31;2018-07-31 00:00;61;146;155;301
2018;July;31;2018-07-31 00:00;62;151;158;309
2018;July;31;2018-07-31 00:00;63;134;118;252
2018;July;31;2018-07-31 00:00;64;133;137;270
2018;July;31;2018-07-31 00:00;65;145;136;281
2018;July;31;2018-07-31 00:00;66;136;154;290
2018;July;31;2018-07-31 00:00;67;144;136;280
2018;July;31;2018-07-31 00:00;68;142;156;298
2018;July;31;2018-07-31 00:00;69;149;161;310
2018;July;31;2018-07-31 00:00;70;174;162;336
2018;July;31;2018-07-31 00:00;71;160;155;315
2018;July;31;2018-07-31 00:00;72;181;148;329
2018;July;31;2018-07-31 00:00;73;183;172;355
2018;July;31;2018-07-31 00:00;74;152;160;312
2018;July;31;2018-07-31 00:00;75;152;164;316
2018;July;31;2018-07-31 00:00;76;138;133;271
2018;July;31;2018-07-31 00:00;77;106;101;207
2018;July;31;2018-07-31 00:00;78;82;125;207
2018;July;31;2018-07-31 00:00;79;86;88;174
2018;July;31;2018-07-31 00:00;80;93;77;170
2018;July;31;2018-07-31 00:00;81;78;70;148
2018;July;31;2018-07-31 00:00;82;90;65;155
2018;July;31;2018-07-31 00:00;83;55;63;118
2018;July;31;2018-07-31 00:00;84;64;47;111
2018;July;31;2018-07-31 00:00;85;54;44;98
2018;July;31;2018-07-31 00:00;86;31;35;66
2018;July;31;2018-07-31 00:00;87;43;26;69
2018;July;31;2018-07-31 00:00;88;42;23;65
2018;July;31;2018-07-31 00:00;89;34;23;57
2018;July;31;2018-07-31 00:00;90;26;15;41
2018;July;31;2018-07-31 00:00;91;29;9;38
2018;July;31;2018-07-31 00:00;92;19;11;30
2018;July;31;2018-07-31 00:00;93;19;6;25
2018;July;31;2018-07-31 00:00;94;12;7;19
2018;July;31;2018-07-31 00:00;95;7;5;12
2018;July;31;2018-07-31 00:00;96;11;2;13
2018;July;31;2018-07-31 00:00;97;3;4;7
2018;July;31;2018-07-31 00:00;98;2;2;4
2018;July;31;2018-07-31 00:00;99;0;1;1
2018;July;31;2018-07-31 00:00;100;1;0;1
2018;July;31;2018-07-31 00:00;106;1;0;1
2018;August;32;2018-08-07 00:00;0;119;126;245
2018;August;32;2018-08-07 00:00;1;207;199;406
2018;August;32;2018-08-07 00:00;2;181;210;391
2018;August;32;2018-08-07 00:00;3;194;207;401
2018;August;32;2018-08-07 00:00;4;185;233;418
2018;August;32;2018-08-07 00:00;5;209;224;433
2018;August;32;2018-08-07 00:00;6;195;200;395
2018;August;32;2018-08-07 00:00;7;223;238;461
2018;August;32;2018-08-07 00:00;8;225;239;464
2018;August;32;2018-08-07 00:00;9;213;222;435
2018;August;32;2018-08-07 00:00;10;204;203;407
2018;August;32;2018-08-07 00:00;11;191;208;399
2018;August;32;2018-08-07 00:00;12;226;199;425
2018;August;32;2018-08-07 00:00;13;190;214;404
2018;August;32;2018-08-07 00:00;14;185;206;391
2018;August;32;2018-08-07 00:00;15;178;184;362
2018;August;32;2018-08-07 00:00;16;182;225;407
2018;August;32;2018-08-07 00:00;17;142;183;325
2018;August;32;2018-08-07 00:00;18;183;195;378
2018;August;32;2018-08-07 00:00;19;174;188;362
2018;August;32;2018-08-07 00:00;20;155;171;326
2018;August;32;2018-08-07 00:00;21;146;191;337
2018;August;32;2018-08-07 00:00;22;148;169;317
2018;August;32;2018-08-07 00:00;23;150;182;332
2018;August;32;2018-08-07 00:00;24;176;180;356
2018;August;32;2018-08-07 00:00;25;179;201;380
2018;August;32;2018-08-07 00:00;26;178;185;363
2018;August;32;2018-08-07 00:00;27;189;234;423
2018;August;32;2018-08-07 00:00;28;193;209;402
2018;August;32;2018-08-07 00:00;29;175;197;372
2018;August;32;2018-08-07 00:00;30;190;187;377
2018;August;32;2018-08-07 00:00;31;201;203;404
2018;August;32;2018-08-07 00:00;32;174;186;360
2018;August;32;2018-08-07 00:00;33;196;211;407
2018;August;32;2018-08-07 00:00;34;194;206;400
2018;August;32;2018-08-07 00:00;35;214;185;399
2018;August;32;2018-08-07 00:00;36;207;202;409
2018;August;32;2018-08-07 00:00;37;178;191;369
2018;August;32;2018-08-07 00:00;38;237;209;446
2018;August;32;2018-08-07 00:00;39;209;181;390
2018;August;32;2018-08-07 00:00;40;196;211;407
2018;August;32;2018-08-07 00:00;41;196;208;404
2018;August;32;2018-08-07 00:00;42;223;218;441
2018;August;32;2018-08-07 00:00;43;226;246;472
2018;August;32;2018-08-07 00:00;44;233;281;514
2018;August;32;2018-08-07 00:00;45;212;223;435
2018;August;32;2018-08-07 00:00;46;223;255;478
2018;August;32;2018-08-07 00:00;47;215;217;432
2018;August;32;2018-08-07 00:00;48;209;228;437
2018;August;32;2018-08-07 00:00;49;196;196;392
2018;August;32;2018-08-07 00:00;50;208;221;429
2018;August;32;2018-08-07 00:00;51;238;226;464
2018;August;32;2018-08-07 00:00;52;186;223;409
2018;August;32;2018-08-07 00:00;53;197;223;420
2018;August;32;2018-08-07 00:00;54;187;222;409
2018;August;32;2018-08-07 00:00;55;182;210;392
2018;August;32;2018-08-07 00:00;56;190;188;378
2018;August;32;2018-08-07 00:00;57;150;168;318
2018;August;32;2018-08-07 00:00;58;156;155;311
2018;August;32;2018-08-07 00:00;59;156;162;318
2018;August;32;2018-08-07 00:00;60;152;154;306
2018;August;32;2018-08-07 00:00;61;146;155;301
2018;August;32;2018-08-07 00:00;62;151;158;309
2018;August;32;2018-08-07 00:00;63;134;118;252
2018;August;32;2018-08-07 00:00;64;132;137;269
2018;August;32;2018-08-07 00:00;65;145;136;281
2018;August;32;2018-08-07 00:00;66;136;153;289
2018;August;32;2018-08-07 00:00;67;144;136;280
2018;August;32;2018-08-07 00:00;68;142;156;298
2018;August;32;2018-08-07 00:00;69;149;161;310
2018;August;32;2018-08-07 00:00;70;174;162;336
2018;August;32;2018-08-07 00:00;71;160;155;315
2018;August;32;2018-08-07 00:00;72;181;148;329
2018;August;32;2018-08-07 00:00;73;183;172;355
2018;August;32;2018-08-07 00:00;74;152;160;312
2018;August;32;2018-08-07 00:00;75;152;164;316
2018;August;32;2018-08-07 00:00;76;138;133;271
2018;August;32;2018-08-07 00:00;77;106;101;207
2018;August;32;2018-08-07 00:00;78;82;125;207
2018;August;32;2018-08-07 00:00;79;86;88;174
2018;August;32;2018-08-07 00:00;80;94;77;171
2018;August;32;2018-08-07 00:00;81;78;70;148
2018;August;32;2018-08-07 00:00;82;90;65;155
2018;August;32;2018-08-07 00:00;83;55;64;119
2018;August;32;2018-08-07 00:00;84;64;47;111
2018;August;32;2018-08-07 00:00;85;54;44;98
2018;August;32;2018-08-07 00:00;86;31;35;66
2018;August;32;2018-08-07 00:00;87;43;26;69
2018;August;32;2018-08-07 00:00;88;42;23;65
2018;August;32;2018-08-07 00:00;89;34;23;57
2018;August;32;2018-08-07 00:00;90;26;15;41
2018;August;32;2018-08-07 00:00;91;29;9;38
2018;August;32;2018-08-07 00:00;92;19;11;30
2018;August;32;2018-08-07 00:00;93;18;6;24
2018;August;32;2018-08-07 00:00;94;12;7;19
2018;August;32;2018-08-07 00:00;95;7;5;12
2018;August;32;2018-08-07 00:00;96;11;2;13
2018;August;32;2018-08-07 00:00;97;3;4;7
2018;August;32;2018-08-07 00:00;98;2;2;4
2018;August;32;2018-08-07 00:00;99;0;1;1
2018;August;32;2018-08-07 00:00;100;1;0;1
2018;August;32;2018-08-07 00:00;106;1;0;1
2018;August;33;2018-08-14 00:00;0;122;131;253
2018;August;33;2018-08-14 00:00;1;207;202;409
2018;August;33;2018-08-14 00:00;2;181;210;391
2018;August;33;2018-08-14 00:00;3;194;209;403
2018;August;33;2018-08-14 00:00;4;185;233;418
2018;August;33;2018-08-14 00:00;5;209;224;433
2018;August;33;2018-08-14 00:00;6;195;200;395
2018;August;33;2018-08-14 00:00;7;224;238;462
2018;August;33;2018-08-14 00:00;8;224;239;463
2018;August;33;2018-08-14 00:00;9;213;222;435
2018;August;33;2018-08-14 00:00;10;203;203;406
2018;August;33;2018-08-14 00:00;11;191;208;399
2018;August;33;2018-08-14 00:00;12;225;199;424
2018;August;33;2018-08-14 00:00;13;190;214;404
2018;August;33;2018-08-14 00:00;14;185;205;390
2018;August;33;2018-08-14 00:00;15;178;184;362
2018;August;33;2018-08-14 00:00;16;182;224;406
2018;August;33;2018-08-14 00:00;17;142;183;325
2018;August;33;2018-08-14 00:00;18;183;195;378
2018;August;33;2018-08-14 00:00;19;174;187;361
2018;August;33;2018-08-14 00:00;20;154;171;325
2018;August;33;2018-08-14 00:00;21;145;191;336
2018;August;33;2018-08-14 00:00;22;147;168;315
2018;August;33;2018-08-14 00:00;23;151;183;334
2018;August;33;2018-08-14 00:00;24;176;181;357
2018;August;33;2018-08-14 00:00;25;179;201;380
2018;August;33;2018-08-14 00:00;26;180;185;365
2018;August;33;2018-08-14 00:00;27;190;233;423
2018;August;33;2018-08-14 00:00;28;193;210;403
2018;August;33;2018-08-14 00:00;29;176;199;375
2018;August;33;2018-08-14 00:00;30;189;187;376
2018;August;33;2018-08-14 00:00;31;201;203;404
2018;August;33;2018-08-14 00:00;32;175;185;360
2018;August;33;2018-08-14 00:00;33;196;211;407
2018;August;33;2018-08-14 00:00;34;195;205;400
2018;August;33;2018-08-14 00:00;35;215;186;401
2018;August;33;2018-08-14 00:00;36;208;202;410
2018;August;33;2018-08-14 00:00;37;177;191;368
2018;August;33;2018-08-14 00:00;38;237;209;446
2018;August;33;2018-08-14 00:00;39;208;182;390
2018;August;33;2018-08-14 00:00;40;196;212;408
2018;August;33;2018-08-14 00:00;41;196;208;404
2018;August;33;2018-08-14 00:00;42;223;218;441
2018;August;33;2018-08-14 00:00;43;226;243;469
2018;August;33;2018-08-14 00:00;44;234;281;515
2018;August;33;2018-08-14 00:00;45;212;223;435
2018;August;33;2018-08-14 00:00;46;223;255;478
2018;August;33;2018-08-14 00:00;47;215;217;432
2018;August;33;2018-08-14 00:00;48;209;228;437
2018;August;33;2018-08-14 00:00;49;196;197;393
2018;August;33;2018-08-14 00:00;50;209;220;429
2018;August;33;2018-08-14 00:00;51;238;226;464
2018;August;33;2018-08-14 00:00;52;186;223;409
2018;August;33;2018-08-14 00:00;53;197;222;419
2018;August;33;2018-08-14 00:00;54;187;222;409
2018;August;33;2018-08-14 00:00;55;182;210;392
2018;August;33;2018-08-14 00:00;56;190;188;378
2018;August;33;2018-08-14 00:00;57;150;168;318
2018;August;33;2018-08-14 00:00;58;156;155;311
2018;August;33;2018-08-14 00:00;59;156;162;318
2018;August;33;2018-08-14 00:00;60;152;154;306
2018;August;33;2018-08-14 00:00;61;146;155;301
2018;August;33;2018-08-14 00:00;62;151;158;309
2018;August;33;2018-08-14 00:00;63;134;118;252
2018;August;33;2018-08-14 00:00;64;132;137;269
2018;August;33;2018-08-14 00:00;65;144;136;280
2018;August;33;2018-08-14 00:00;66;136;150;286
2018;August;33;2018-08-14 00:00;67;144;135;279
2018;August;33;2018-08-14 00:00;68;142;157;299
2018;August;33;2018-08-14 00:00;69;149;161;310
2018;August;33;2018-08-14 00:00;70;174;162;336
2018;August;33;2018-08-14 00:00;71;161;155;316
2018;August;33;2018-08-14 00:00;72;181;149;330
2018;August;33;2018-08-14 00:00;73;183;172;355
2018;August;33;2018-08-14 00:00;74;152;160;312
2018;August;33;2018-08-14 00:00;75;152;164;316
2018;August;33;2018-08-14 00:00;76;138;133;271
2018;August;33;2018-08-14 00:00;77;106;101;207
2018;August;33;2018-08-14 00:00;78;82;125;207
2018;August;33;2018-08-14 00:00;79;86;88;174
2018;August;33;2018-08-14 00:00;80;94;77;171
2018;August;33;2018-08-14 00:00;81;78;70;148
2018;August;33;2018-08-14 00:00;82;90;65;155
2018;August;33;2018-08-14 00:00;83;55;64;119
2018;August;33;2018-08-14 00:00;84;64;47;111
2018;August;33;2018-08-14 00:00;85;54;44;98
2018;August;33;2018-08-14 00:00;86;31;35;66
2018;August;33;2018-08-14 00:00;87;43;26;69
2018;August;33;2018-08-14 00:00;88;42;23;65
2018;August;33;2018-08-14 00:00;89;34;23;57
2018;August;33;2018-08-14 00:00;90;26;15;41
2018;August;33;2018-08-14 00:00;91;29;9;38
2018;August;33;2018-08-14 00:00;92;19;11;30
2018;August;33;2018-08-14 00:00;93;18;6;24
2018;August;33;2018-08-14 00:00;94;12;7;19
2018;August;33;2018-08-14 00:00;95;7;5;12
2018;August;33;2018-08-14 00:00;96;11;2;13
2018;August;33;2018-08-14 00:00;97;3;4;7
2018;August;33;2018-08-14 00:00;98;2;2;4
2018;August;33;2018-08-14 00:00;99;0;1;1
2018;August;33;2018-08-14 00:00;100;1;0;1
2018;August;33;2018-08-14 00:00;106;1;0;1
2018;August;35;2018-08-27 00:00;0;124;138;262
2018;August;35;2018-08-27 00:00;1;206;200;406
2018;August;35;2018-08-27 00:00;2;181;210;391
2018;August;35;2018-08-27 00:00;3;194;208;402
2018;August;35;2018-08-27 00:00;4;185;233;418
2018;August;35;2018-08-27 00:00;5;210;224;434
2018;August;35;2018-08-27 00:00;6;194;200;394
2018;August;35;2018-08-27 00:00;7;223;238;461
2018;August;35;2018-08-27 00:00;8;224;239;463
2018;August;35;2018-08-27 00:00;9;212;221;433
2018;August;35;2018-08-27 00:00;10;203;203;406
2018;August;35;2018-08-27 00:00;11;191;208;399
2018;August;35;2018-08-27 00:00;12;225;200;425
2018;August;35;2018-08-27 00:00;13;189;213;402
2018;August;35;2018-08-27 00:00;14;185;205;390
2018;August;35;2018-08-27 00:00;15;179;184;363
2018;August;35;2018-08-27 00:00;16;182;223;405
2018;August;35;2018-08-27 00:00;17;143;183;326
2018;August;35;2018-08-27 00:00;18;183;196;379
2018;August;35;2018-08-27 00:00;19;175;186;361
2018;August;35;2018-08-27 00:00;20;153;172;325
2018;August;35;2018-08-27 00:00;21;145;191;336
2018;August;35;2018-08-27 00:00;22;147;168;315
2018;August;35;2018-08-27 00:00;23;152;183;335
2018;August;35;2018-08-27 00:00;24;176;179;355
2018;August;35;2018-08-27 00:00;25;178;200;378
2018;August;35;2018-08-27 00:00;26;179;185;364
2018;August;35;2018-08-27 00:00;27;189;234;423
2018;August;35;2018-08-27 00:00;28;193;210;403
2018;August;35;2018-08-27 00:00;29;176;198;374
2018;August;35;2018-08-27 00:00;30;189;187;376
2018;August;35;2018-08-27 00:00;31;201;204;405
2018;August;35;2018-08-27 00:00;32;176;186;362
2018;August;35;2018-08-27 00:00;33;196;213;409
2018;August;35;2018-08-27 00:00;34;194;204;398
2018;August;35;2018-08-27 00:00;35;216;186;402
2018;August;35;2018-08-27 00:00;36;208;202;410
2018;August;35;2018-08-27 00:00;37;177;191;368
2018;August;35;2018-08-27 00:00;38;237;209;446
2018;August;35;2018-08-27 00:00;39;209;182;391
2018;August;35;2018-08-27 00:00;40;196;212;408
2018;August;35;2018-08-27 00:00;41;197;209;406
2018;August;35;2018-08-27 00:00;42;223;218;441
2018;August;35;2018-08-27 00:00;43;226;243;469
2018;August;35;2018-08-27 00:00;44;234;281;515
2018;August;35;2018-08-27 00:00;45;211;223;434
2018;August;35;2018-08-27 00:00;46;223;255;478
2018;August;35;2018-08-27 00:00;47;215;217;432
2018;August;35;2018-08-27 00:00;48;209;227;436
2018;August;35;2018-08-27 00:00;49;195;197;392
2018;August;35;2018-08-27 00:00;50;209;220;429
2018;August;35;2018-08-27 00:00;51;238;226;464
2018;August;35;2018-08-27 00:00;52;186;223;409
2018;August;35;2018-08-27 00:00;53;197;222;419
2018;August;35;2018-08-27 00:00;54;187;222;409
2018;August;35;2018-08-27 00:00;55;182;212;394
2018;August;35;2018-08-27 00:00;56;190;188;378
2018;August;35;2018-08-27 00:00;57;150;168;318
2018;August;35;2018-08-27 00:00;58;156;155;311
2018;August;35;2018-08-27 00:00;59;156;163;319
2018;August;35;2018-08-27 00:00;60;152;154;306
2018;August;35;2018-08-27 00:00;61;146;155;301
2018;August;35;2018-08-27 00:00;62;151;158;309
2018;August;35;2018-08-27 00:00;63;133;118;251
2018;August;35;2018-08-27 00:00;64;132;137;269
2018;August;35;2018-08-27 00:00;65;144;135;279
2018;August;35;2018-08-27 00:00;66;137;150;287
2018;August;35;2018-08-27 00:00;67;144;135;279
2018;August;35;2018-08-27 00:00;68;142;157;299
2018;August;35;2018-08-27 00:00;69;149;161;310
2018;August;35;2018-08-27 00:00;70;175;163;338
2018;August;35;2018-08-27 00:00;71;161;155;316
2018;August;35;2018-08-27 00:00;72;181;149;330
2018;August;35;2018-08-27 00:00;73;183;171;354
2018;August;35;2018-08-27 00:00;74;152;160;312
2018;August;35;2018-08-27 00:00;75;152;164;316
2018;August;35;2018-08-27 00:00;76;138;133;271
2018;August;35;2018-08-27 00:00;77;106;101;207
2018;August;35;2018-08-27 00:00;78;82;125;207
2018;August;35;2018-08-27 00:00;79;86;88;174
2018;August;35;2018-08-27 00:00;80;94;77;171
2018;August;35;2018-08-27 00:00;81;78;70;148
2018;August;35;2018-08-27 00:00;82;90;64;154
2018;August;35;2018-08-27 00:00;83;55;64;119
2018;August;35;2018-08-27 00:00;84;64;47;111
2018;August;35;2018-08-27 00:00;85;54;43;97
2018;August;35;2018-08-27 00:00;86;31;35;66
2018;August;35;2018-08-27 00:00;87;43;27;70
2018;August;35;2018-08-27 00:00;88;42;23;65
2018;August;35;2018-08-27 00:00;89;34;23;57
2018;August;35;2018-08-27 00:00;90;25;15;40
2018;August;35;2018-08-27 00:00;91;29;9;38
2018;August;35;2018-08-27 00:00;92;19;11;30
2018;August;35;2018-08-27 00:00;93;18;6;24
2018;August;35;2018-08-27 00:00;94;12;7;19
2018;August;35;2018-08-27 00:00;95;7;5;12
2018;August;35;2018-08-27 00:00;96;11;2;13
2018;August;35;2018-08-27 00:00;97;3;4;7
2018;August;35;2018-08-27 00:00;98;2;2;4
2018;August;35;2018-08-27 00:00;99;0;1;1
2018;August;35;2018-08-27 00:00;100;1;0;1
2018;August;35;2018-08-27 00:00;106;1;0;1
2018;August;35;2018-08-28 00:00;0;126;138;264
2018;August;35;2018-08-28 00:00;1;206;200;406
2018;August;35;2018-08-28 00:00;2;181;210;391
2018;August;35;2018-08-28 00:00;3;193;210;403
2018;August;35;2018-08-28 00:00;4;185;234;419
2018;August;35;2018-08-28 00:00;5;211;224;435
2018;August;35;2018-08-28 00:00;6;194;200;394
2018;August;35;2018-08-28 00:00;7;222;238;460
2018;August;35;2018-08-28 00:00;8;225;238;463
2018;August;35;2018-08-28 00:00;9;212;221;433
2018;August;35;2018-08-28 00:00;10;203;203;406
2018;August;35;2018-08-28 00:00;11;191;208;399
2018;August;35;2018-08-28 00:00;12;225;201;426
2018;August;35;2018-08-28 00:00;13;189;214;403
2018;August;35;2018-08-28 00:00;14;184;205;389
2018;August;35;2018-08-28 00:00;15;178;184;362
2018;August;35;2018-08-28 00:00;16;183;223;406
2018;August;35;2018-08-28 00:00;17;143;183;326
2018;August;35;2018-08-28 00:00;18;183;196;379
2018;August;35;2018-08-28 00:00;19;173;186;359
2018;August;35;2018-08-28 00:00;20;152;173;325
2018;August;35;2018-08-28 00:00;21;143;192;335
2018;August;35;2018-08-28 00:00;22;145;166;311
2018;August;35;2018-08-28 00:00;23;152;183;335
2018;August;35;2018-08-28 00:00;24;175;179;354
2018;August;35;2018-08-28 00:00;25;179;199;378
2018;August;35;2018-08-28 00:00;26;181;184;365
2018;August;35;2018-08-28 00:00;27;187;233;420
2018;August;35;2018-08-28 00:00;28;194;211;405
2018;August;35;2018-08-28 00:00;29;175;196;371
2018;August;35;2018-08-28 00:00;30;190;186;376
2018;August;35;2018-08-28 00:00;31;201;203;404
2018;August;35;2018-08-28 00:00;32;176;186;362
2018;August;35;2018-08-28 00:00;33;197;213;410
2018;August;35;2018-08-28 00:00;34;194;204;398
2018;August;35;2018-08-28 00:00;35;217;187;404
2018;August;35;2018-08-28 00:00;36;209;203;412
2018;August;35;2018-08-28 00:00;37;176;191;367
2018;August;35;2018-08-28 00:00;38;237;209;446
2018;August;35;2018-08-28 00:00;39;209;181;390
2018;August;35;2018-08-28 00:00;40;197;213;410
2018;August;35;2018-08-28 00:00;41;197;209;406
2018;August;35;2018-08-28 00:00;42;223;218;441
2018;August;35;2018-08-28 00:00;43;226;243;469
2018;August;35;2018-08-28 00:00;44;234;281;515
2018;August;35;2018-08-28 00:00;45;211;223;434
2018;August;35;2018-08-28 00:00;46;223;255;478
2018;August;35;2018-08-28 00:00;47;215;218;433
2018;August;35;2018-08-28 00:00;48;209;226;435
2018;August;35;2018-08-28 00:00;49;195;196;391
2018;August;35;2018-08-28 00:00;50;209;220;429
2018;August;35;2018-08-28 00:00;51;239;226;465
2018;August;35;2018-08-28 00:00;52;187;223;410
2018;August;35;2018-08-28 00:00;53;196;221;417
2018;August;35;2018-08-28 00:00;54;187;222;409
2018;August;35;2018-08-28 00:00;55;182;212;394
2018;August;35;2018-08-28 00:00;56;190;188;378
2018;August;35;2018-08-28 00:00;57;149;168;317
2018;August;35;2018-08-28 00:00;58;156;155;311
2018;August;35;2018-08-28 00:00;59;156;163;319
2018;August;35;2018-08-28 00:00;60;152;154;306
2018;August;35;2018-08-28 00:00;61;146;155;301
2018;August;35;2018-08-28 00:00;62;151;158;309
2018;August;35;2018-08-28 00:00;63;133;118;251
2018;August;35;2018-08-28 00:00;64;132;138;270
2018;August;35;2018-08-28 00:00;65;144;135;279
2018;August;35;2018-08-28 00:00;66;137;150;287
2018;August;35;2018-08-28 00:00;67;144;135;279
2018;August;35;2018-08-28 00:00;68;142;156;298
2018;August;35;2018-08-28 00:00;69;149;161;310
2018;August;35;2018-08-28 00:00;70;175;163;338
2018;August;35;2018-08-28 00:00;71;161;155;316
2018;August;35;2018-08-28 00:00;72;181;149;330
2018;August;35;2018-08-28 00:00;73;183;171;354
2018;August;35;2018-08-28 00:00;74;152;160;312
2018;August;35;2018-08-28 00:00;75;152;164;316
2018;August;35;2018-08-28 00:00;76;138;133;271
2018;August;35;2018-08-28 00:00;77;106;101;207
2018;August;35;2018-08-28 00:00;78;82;125;207
2018;August;35;2018-08-28 00:00;79;86;88;174
2018;August;35;2018-08-28 00:00;80;94;77;171
2018;August;35;2018-08-28 00:00;81;78;70;148
2018;August;35;2018-08-28 00:00;82;90;64;154
2018;August;35;2018-08-28 00:00;83;55;64;119
2018;August;35;2018-08-28 00:00;84;64;47;111
2018;August;35;2018-08-28 00:00;85;54;43;97
2018;August;35;2018-08-28 00:00;86;31;35;66
2018;August;35;2018-08-28 00:00;87;42;27;69
2018;August;35;2018-08-28 00:00;88;42;23;65
2018;August;35;2018-08-28 00:00;89;34;23;57
2018;August;35;2018-08-28 00:00;90;24;15;39
2018;August;35;2018-08-28 00:00;91;29;9;38
2018;August;35;2018-08-28 00:00;92;19;11;30
2018;August;35;2018-08-28 00:00;93;18;6;24
2018;August;35;2018-08-28 00:00;94;12;7;19
2018;August;35;2018-08-28 00:00;95;7;5;12
2018;August;35;2018-08-28 00:00;96;11;2;13
2018;August;35;2018-08-28 00:00;97;3;4;7
2018;August;35;2018-08-28 00:00;98;2;2;4
2018;August;35;2018-08-28 00:00;99;0;1;1
2018;August;35;2018-08-28 00:00;100;1;0;1
2018;August;35;2018-08-28 00:00;106;1;0;1
2018;September;36;2018-09-04 00:00;0;127;140;267
2018;September;36;2018-09-04 00:00;1;206;200;406
2018;September;36;2018-09-04 00:00;2;182;209;391
2018;September;36;2018-09-04 00:00;3;193;210;403
2018;September;36;2018-09-04 00:00;4;184;234;418
2018;September;36;2018-09-04 00:00;5;210;225;435
2018;September;36;2018-09-04 00:00;6;194;199;393
2018;September;36;2018-09-04 00:00;7;222;237;459
2018;September;36;2018-09-04 00:00;8;226;238;464
2018;September;36;2018-09-04 00:00;9;212;222;434
2018;September;36;2018-09-04 00:00;10;203;203;406
2018;September;36;2018-09-04 00:00;11;190;208;398
2018;September;36;2018-09-04 00:00;12;225;201;426
2018;September;36;2018-09-04 00:00;13;189;213;402
2018;September;36;2018-09-04 00:00;14;184;206;390
2018;September;36;2018-09-04 00:00;15;178;184;362
2018;September;36;2018-09-04 00:00;16;183;222;405
2018;September;36;2018-09-04 00:00;17;143;183;326
2018;September;36;2018-09-04 00:00;18;182;197;379
2018;September;36;2018-09-04 00:00;19;173;187;360
2018;September;36;2018-09-04 00:00;20;149;173;322
2018;September;36;2018-09-04 00:00;21;145;192;337
2018;September;36;2018-09-04 00:00;22;143;166;309
2018;September;36;2018-09-04 00:00;23;149;181;330
2018;September;36;2018-09-04 00:00;24;174;177;351
2018;September;36;2018-09-04 00:00;25;179;198;377
2018;September;36;2018-09-04 00:00;26;180;183;363
2018;September;36;2018-09-04 00:00;27;186;236;422
2018;September;36;2018-09-04 00:00;28;194;212;406
2018;September;36;2018-09-04 00:00;29;178;196;374
2018;September;36;2018-09-04 00:00;30;190;187;377
2018;September;36;2018-09-04 00:00;31;202;205;407
2018;September;36;2018-09-04 00:00;32;179;184;363
2018;September;36;2018-09-04 00:00;33;198;215;413
2018;September;36;2018-09-04 00:00;34;192;202;394
2018;September;36;2018-09-04 00:00;35;217;188;405
2018;September;36;2018-09-04 00:00;36;209;204;413
2018;September;36;2018-09-04 00:00;37;176;192;368
2018;September;36;2018-09-04 00:00;38;238;208;446
2018;September;36;2018-09-04 00:00;39;209;181;390
2018;September;36;2018-09-04 00:00;40;197;212;409
2018;September;36;2018-09-04 00:00;41;197;208;405
2018;September;36;2018-09-04 00:00;42;223;218;441
2018;September;36;2018-09-04 00:00;43;226;243;469
2018;September;36;2018-09-04 00:00;44;234;281;515
2018;September;36;2018-09-04 00:00;45;212;223;435
2018;September;36;2018-09-04 00:00;46;223;255;478
2018;September;36;2018-09-04 00:00;47;214;219;433
2018;September;36;2018-09-04 00:00;48;208;225;433
2018;September;36;2018-09-04 00:00;49;194;197;391
2018;September;36;2018-09-04 00:00;50;209;220;429
2018;September;36;2018-09-04 00:00;51;240;226;466
2018;September;36;2018-09-04 00:00;52;187;223;410
2018;September;36;2018-09-04 00:00;53;195;218;413
2018;September;36;2018-09-04 00:00;54;187;222;409
2018;September;36;2018-09-04 00:00;55;182;213;395
2018;September;36;2018-09-04 00:00;56;190;189;379
2018;September;36;2018-09-04 00:00;57;150;168;318
2018;September;36;2018-09-04 00:00;58;156;155;311
2018;September;36;2018-09-04 00:00;59;156;163;319
2018;September;36;2018-09-04 00:00;60;152;154;306
2018;September;36;2018-09-04 00:00;61;146;155;301
2018;September;36;2018-09-04 00:00;62;151;158;309
2018;September;36;2018-09-04 00:00;63;133;118;251
2018;September;36;2018-09-04 00:00;64;132;138;270
2018;September;36;2018-09-04 00:00;65;144;134;278
2018;September;36;2018-09-04 00:00;66;137;150;287
2018;September;36;2018-09-04 00:00;67;143;135;278
2018;September;36;2018-09-04 00:00;68;142;156;298
2018;September;36;2018-09-04 00:00;69;149;161;310
2018;September;36;2018-09-04 00:00;70;174;163;337
2018;September;36;2018-09-04 00:00;71;161;156;317
2018;September;36;2018-09-04 00:00;72;182;149;331
2018;September;36;2018-09-04 00:00;73;182;171;353
2018;September;36;2018-09-04 00:00;74;152;160;312
2018;September;36;2018-09-04 00:00;75;152;164;316
2018;September;36;2018-09-04 00:00;76;138;133;271
2018;September;36;2018-09-04 00:00;77;106;100;206
2018;September;36;2018-09-04 00:00;78;82;125;207
2018;September;36;2018-09-04 00:00;79;86;88;174
2018;September;36;2018-09-04 00:00;80;94;77;171
2018;September;36;2018-09-04 00:00;81;78;69;147
2018;September;36;2018-09-04 00:00;82;90;64;154
2018;September;36;2018-09-04 00:00;83;55;64;119
2018;September;36;2018-09-04 00:00;84;64;47;111
2018;September;36;2018-09-04 00:00;85;54;43;97
2018;September;36;2018-09-04 00:00;86;31;35;66
2018;September;36;2018-09-04 00:00;87;42;27;69
2018;September;36;2018-09-04 00:00;88;42;23;65
2018;September;36;2018-09-04 00:00;89;34;23;57
2018;September;36;2018-09-04 00:00;90;24;15;39
2018;September;36;2018-09-04 00:00;91;29;9;38
2018;September;36;2018-09-04 00:00;92;19;11;30
2018;September;36;2018-09-04 00:00;93;18;6;24
2018;September;36;2018-09-04 00:00;94;12;7;19
2018;September;36;2018-09-04 00:00;95;7;5;12
2018;September;36;2018-09-04 00:00;96;11;2;13
2018;September;36;2018-09-04 00:00;97;3;4;7
2018;September;36;2018-09-04 00:00;98;2;2;4
2018;September;36;2018-09-04 00:00;99;0;1;1
2018;September;36;2018-09-04 00:00;100;1;0;1
2018;September;36;2018-09-04 00:00;106;1;0;1
2018;September;37;2018-09-11 00:00;0;128;145;273
2018;September;37;2018-09-11 00:00;1;206;200;406
2018;September;37;2018-09-11 00:00;2;182;212;394
2018;September;37;2018-09-11 00:00;3;194;210;404
2018;September;37;2018-09-11 00:00;4;183;233;416
2018;September;37;2018-09-11 00:00;5;211;226;437
2018;September;37;2018-09-11 00:00;6;194;199;393
2018;September;37;2018-09-11 00:00;7;222;237;459
2018;September;37;2018-09-11 00:00;8;225;238;463
2018;September;37;2018-09-11 00:00;9;213;222;435
2018;September;37;2018-09-11 00:00;10;204;203;407
2018;September;37;2018-09-11 00:00;11;190;208;398
2018;September;37;2018-09-11 00:00;12;225;201;426
2018;September;37;2018-09-11 00:00;13;189;213;402
2018;September;37;2018-09-11 00:00;14;184;206;390
2018;September;37;2018-09-11 00:00;15;178;185;363
2018;September;37;2018-09-11 00:00;16;183;222;405
2018;September;37;2018-09-11 00:00;17;144;183;327
2018;September;37;2018-09-11 00:00;18;181;197;378
2018;September;37;2018-09-11 00:00;19;173;188;361
2018;September;37;2018-09-11 00:00;20;150;172;322
2018;September;37;2018-09-11 00:00;21;143;193;336
2018;September;37;2018-09-11 00:00;22;144;167;311
2018;September;37;2018-09-11 00:00;23;148;182;330
2018;September;37;2018-09-11 00:00;24;174;176;350
2018;September;37;2018-09-11 00:00;25;177;199;376
2018;September;37;2018-09-11 00:00;26;181;183;364
2018;September;37;2018-09-11 00:00;27;185;238;423
2018;September;37;2018-09-11 00:00;28;195;212;407
2018;September;37;2018-09-11 00:00;29;178;197;375
2018;September;37;2018-09-11 00:00;30;191;188;379
2018;September;37;2018-09-11 00:00;31;202;205;407
2018;September;37;2018-09-11 00:00;32;179;185;364
2018;September;37;2018-09-11 00:00;33;200;214;414
2018;September;37;2018-09-11 00:00;34;193;203;396
2018;September;37;2018-09-11 00:00;35;218;189;407
2018;September;37;2018-09-11 00:00;36;207;204;411
2018;September;37;2018-09-11 00:00;37;175;191;366
2018;September;37;2018-09-11 00:00;38;239;209;448
2018;September;37;2018-09-11 00:00;39;209;181;390
2018;September;37;2018-09-11 00:00;40;197;211;408
2018;September;37;2018-09-11 00:00;41;197;208;405
2018;September;37;2018-09-11 00:00;42;223;218;441
2018;September;37;2018-09-11 00:00;43;226;243;469
2018;September;37;2018-09-11 00:00;44;233;282;515
2018;September;37;2018-09-11 00:00;45;212;222;434
2018;September;37;2018-09-11 00:00;46;223;255;478
2018;September;37;2018-09-11 00:00;47;214;218;432
2018;September;37;2018-09-11 00:00;48;208;225;433
2018;September;37;2018-09-11 00:00;49;194;197;391
2018;September;37;2018-09-11 00:00;50;209;220;429
2018;September;37;2018-09-11 00:00;51;240;226;466
2018;September;37;2018-09-11 00:00;52;187;223;410
2018;September;37;2018-09-11 00:00;53;196;218;414
2018;September;37;2018-09-11 00:00;54;187;222;409
2018;September;37;2018-09-11 00:00;55;182;213;395
2018;September;37;2018-09-11 00:00;56;189;189;378
2018;September;37;2018-09-11 00:00;57;150;168;318
2018;September;37;2018-09-11 00:00;58;156;155;311
2018;September;37;2018-09-11 00:00;59;156;163;319
2018;September;37;2018-09-11 00:00;60;152;154;306
2018;September;37;2018-09-11 00:00;61;146;155;301
2018;September;37;2018-09-11 00:00;62;151;157;308
2018;September;37;2018-09-11 00:00;63;133;118;251
2018;September;37;2018-09-11 00:00;64;132;138;270
2018;September;37;2018-09-11 00:00;65;144;134;278
2018;September;37;2018-09-11 00:00;66;137;150;287
2018;September;37;2018-09-11 00:00;67;143;135;278
2018;September;37;2018-09-11 00:00;68;142;156;298
2018;September;37;2018-09-11 00:00;69;149;161;310
2018;September;37;2018-09-11 00:00;70;174;162;336
2018;September;37;2018-09-11 00:00;71;161;156;317
2018;September;37;2018-09-11 00:00;72;182;149;331
2018;September;37;2018-09-11 00:00;73;182;171;353
2018;September;37;2018-09-11 00:00;74;152;159;311
2018;September;37;2018-09-11 00:00;75;152;164;316
2018;September;37;2018-09-11 00:00;76;138;132;270
2018;September;37;2018-09-11 00:00;77;106;100;206
2018;September;37;2018-09-11 00:00;78;82;125;207
2018;September;37;2018-09-11 00:00;79;86;88;174
2018;September;37;2018-09-11 00:00;80;94;77;171
2018;September;37;2018-09-11 00:00;81;78;69;147
2018;September;37;2018-09-11 00:00;82;90;64;154
2018;September;37;2018-09-11 00:00;83;55;64;119
2018;September;37;2018-09-11 00:00;84;64;47;111
2018;September;37;2018-09-11 00:00;85;54;43;97
2018;September;37;2018-09-11 00:00;86;31;35;66
2018;September;37;2018-09-11 00:00;87;42;27;69
2018;September;37;2018-09-11 00:00;88;41;23;64
2018;September;37;2018-09-11 00:00;89;34;23;57
2018;September;37;2018-09-11 00:00;90;24;15;39
2018;September;37;2018-09-11 00:00;91;29;9;38
2018;September;37;2018-09-11 00:00;92;19;11;30
2018;September;37;2018-09-11 00:00;93;18;6;24
2018;September;37;2018-09-11 00:00;94;12;7;19
2018;September;37;2018-09-11 00:00;95;7;5;12
2018;September;37;2018-09-11 00:00;96;11;2;13
2018;September;37;2018-09-11 00:00;97;3;4;7
2018;September;37;2018-09-11 00:00;98;2;2;4
2018;September;37;2018-09-11 00:00;99;0;1;1
2018;September;37;2018-09-11 00:00;100;1;0;1
2018;September;37;2018-09-11 00:00;106;1;0;1
2018;September;38;2018-09-18 00:00;0;133;149;282
2018;September;38;2018-09-18 00:00;1;207;200;407
2018;September;38;2018-09-18 00:00;2;183;212;395
2018;September;38;2018-09-18 00:00;3;196;210;406
2018;September;38;2018-09-18 00:00;4;183;233;416
2018;September;38;2018-09-18 00:00;5;211;226;437
2018;September;38;2018-09-18 00:00;6;194;199;393
2018;September;38;2018-09-18 00:00;7;222;237;459
2018;September;38;2018-09-18 00:00;8;226;238;464
2018;September;38;2018-09-18 00:00;9;213;222;435
2018;September;38;2018-09-18 00:00;10;205;203;408
2018;September;38;2018-09-18 00:00;11;190;208;398
2018;September;38;2018-09-18 00:00;12;224;201;425
2018;September;38;2018-09-18 00:00;13;189;213;402
2018;September;38;2018-09-18 00:00;14;185;206;391
2018;September;38;2018-09-18 00:00;15;178;185;363
2018;September;38;2018-09-18 00:00;16;183;222;405
2018;September;38;2018-09-18 00:00;17;144;183;327
2018;September;38;2018-09-18 00:00;18;181;197;378
2018;September;38;2018-09-18 00:00;19;174;188;362
2018;September;38;2018-09-18 00:00;20;150;172;322
2018;September;38;2018-09-18 00:00;21;143;194;337
2018;September;38;2018-09-18 00:00;22;145;169;314
2018;September;38;2018-09-18 00:00;23;149;181;330
2018;September;38;2018-09-18 00:00;24;174;175;349
2018;September;38;2018-09-18 00:00;25;179;200;379
2018;September;38;2018-09-18 00:00;26;182;182;364
2018;September;38;2018-09-18 00:00;27;185;236;421
2018;September;38;2018-09-18 00:00;28;197;214;411
2018;September;38;2018-09-18 00:00;29;178;198;376
2018;September;38;2018-09-18 00:00;30;192;189;381
2018;September;38;2018-09-18 00:00;31;203;203;406
2018;September;38;2018-09-18 00:00;32;180;186;366
2018;September;38;2018-09-18 00:00;33;199;215;414
2018;September;38;2018-09-18 00:00;34;193;204;397
2018;September;38;2018-09-18 00:00;35;218;190;408
2018;September;38;2018-09-18 00:00;36;207;205;412
2018;September;38;2018-09-18 00:00;37;175;193;368
2018;September;38;2018-09-18 00:00;38;239;208;447
2018;September;38;2018-09-18 00:00;39;209;181;390
2018;September;38;2018-09-18 00:00;40;198;211;409
2018;September;38;2018-09-18 00:00;41;197;209;406
2018;September;38;2018-09-18 00:00;42;223;219;442
2018;September;38;2018-09-18 00:00;43;226;242;468
2018;September;38;2018-09-18 00:00;44;233;282;515
2018;September;38;2018-09-18 00:00;45;213;222;435
2018;September;38;2018-09-18 00:00;46;223;256;479
2018;September;38;2018-09-18 00:00;47;214;218;432
2018;September;38;2018-09-18 00:00;48;208;225;433
2018;September;38;2018-09-18 00:00;49;194;198;392
2018;September;38;2018-09-18 00:00;50;210;220;430
2018;September;38;2018-09-18 00:00;51;239;226;465
2018;September;38;2018-09-18 00:00;52;186;221;407
2018;September;38;2018-09-18 00:00;53;196;218;414
2018;September;38;2018-09-18 00:00;54;187;222;409
2018;September;38;2018-09-18 00:00;55;182;213;395
2018;September;38;2018-09-18 00:00;56;190;189;379
2018;September;38;2018-09-18 00:00;57;150;168;318
2018;September;38;2018-09-18 00:00;58;156;154;310
2018;September;38;2018-09-18 00:00;59;154;163;317
2018;September;38;2018-09-18 00:00;60;151;154;305
2018;September;38;2018-09-18 00:00;61;146;155;301
2018;September;38;2018-09-18 00:00;62;151;157;308
2018;September;38;2018-09-18 00:00;63;133;118;251
2018;September;38;2018-09-18 00:00;64;132;138;270
2018;September;38;2018-09-18 00:00;65;144;134;278
2018;September;38;2018-09-18 00:00;66;137;150;287
2018;September;38;2018-09-18 00:00;67;143;135;278
2018;September;38;2018-09-18 00:00;68;142;156;298
2018;September;38;2018-09-18 00:00;69;149;161;310
2018;September;38;2018-09-18 00:00;70;174;162;336
2018;September;38;2018-09-18 00:00;71;161;156;317
2018;September;38;2018-09-18 00:00;72;182;149;331
2018;September;38;2018-09-18 00:00;73;182;171;353
2018;September;38;2018-09-18 00:00;74;152;158;310
2018;September;38;2018-09-18 00:00;75;152;164;316
2018;September;38;2018-09-18 00:00;76;137;132;269
2018;September;38;2018-09-18 00:00;77;106;100;206
2018;September;38;2018-09-18 00:00;78;82;125;207
2018;September;38;2018-09-18 00:00;79;86;88;174
2018;September;38;2018-09-18 00:00;80;92;77;169
2018;September;38;2018-09-18 00:00;81;78;69;147
2018;September;38;2018-09-18 00:00;82;90;64;154
2018;September;38;2018-09-18 00:00;83;55;64;119
2018;September;38;2018-09-18 00:00;84;64;47;111
2018;September;38;2018-09-18 00:00;85;54;43;97
2018;September;38;2018-09-18 00:00;86;31;35;66
2018;September;38;2018-09-18 00:00;87;42;28;70
2018;September;38;2018-09-18 00:00;88;40;23;63
2018;September;38;2018-09-18 00:00;89;34;23;57
2018;September;38;2018-09-18 00:00;90;24;14;38
2018;September;38;2018-09-18 00:00;91;29;9;38
2018;September;38;2018-09-18 00:00;92;19;10;29
2018;September;38;2018-09-18 00:00;93;18;6;24
2018;September;38;2018-09-18 00:00;94;12;7;19
2018;September;38;2018-09-18 00:00;95;7;5;12
2018;September;38;2018-09-18 00:00;96;11;2;13
2018;September;38;2018-09-18 00:00;97;3;4;7
2018;September;38;2018-09-18 00:00;98;2;2;4
2018;September;38;2018-09-18 00:00;99;0;1;1
2018;September;38;2018-09-18 00:00;100;1;0;1
2018;September;38;2018-09-18 00:00;106;1;0;1
2018;September;39;2018-09-25 00:00;0;138;152;290
2018;September;39;2018-09-25 00:00;1;207;199;406
2018;September;39;2018-09-25 00:00;2;181;212;393
2018;September;39;2018-09-25 00:00;3;195;211;406
2018;September;39;2018-09-25 00:00;4;183;232;415
2018;September;39;2018-09-25 00:00;5;212;227;439
2018;September;39;2018-09-25 00:00;6;194;200;394
2018;September;39;2018-09-25 00:00;7;224;237;461
2018;September;39;2018-09-25 00:00;8;226;238;464
2018;September;39;2018-09-25 00:00;9;214;222;436
2018;September;39;2018-09-25 00:00;10;206;203;409
2018;September;39;2018-09-25 00:00;11;190;207;397
2018;September;39;2018-09-25 00:00;12;224;201;425
2018;September;39;2018-09-25 00:00;13;189;213;402
2018;September;39;2018-09-25 00:00;14;185;205;390
2018;September;39;2018-09-25 00:00;15;177;184;361
2018;September;39;2018-09-25 00:00;16;183;222;405
2018;September;39;2018-09-25 00:00;17;143;183;326
2018;September;39;2018-09-25 00:00;18;180;197;377
2018;September;39;2018-09-25 00:00;19;174;187;361
2018;September;39;2018-09-25 00:00;20;150;172;322
2018;September;39;2018-09-25 00:00;21;143;195;338
2018;September;39;2018-09-25 00:00;22;145;172;317
2018;September;39;2018-09-25 00:00;23;149;181;330
2018;September;39;2018-09-25 00:00;24;174;175;349
2018;September;39;2018-09-25 00:00;25;180;201;381
2018;September;39;2018-09-25 00:00;26;184;182;366
2018;September;39;2018-09-25 00:00;27;184;236;420
2018;September;39;2018-09-25 00:00;28;196;215;411
2018;September;39;2018-09-25 00:00;29;178;197;375
2018;September;39;2018-09-25 00:00;30;192;188;380
2018;September;39;2018-09-25 00:00;31;203;203;406
2018;September;39;2018-09-25 00:00;32;180;186;366
2018;September;39;2018-09-25 00:00;33;199;214;413
2018;September;39;2018-09-25 00:00;34;194;202;396
2018;September;39;2018-09-25 00:00;35;218;192;410
2018;September;39;2018-09-25 00:00;36;207;205;412
2018;September;39;2018-09-25 00:00;37;174;193;367
2018;September;39;2018-09-25 00:00;38;239;207;446
2018;September;39;2018-09-25 00:00;39;209;180;389
2018;September;39;2018-09-25 00:00;40;199;212;411
2018;September;39;2018-09-25 00:00;41;198;209;407
2018;September;39;2018-09-25 00:00;42;223;219;442
2018;September;39;2018-09-25 00:00;43;226;242;468
2018;September;39;2018-09-25 00:00;44;233;281;514
2018;September;39;2018-09-25 00:00;45;212;222;434
2018;September;39;2018-09-25 00:00;46;223;256;479
2018;September;39;2018-09-25 00:00;47;215;218;433
2018;September;39;2018-09-25 00:00;48;207;225;432
2018;September;39;2018-09-25 00:00;49;194;198;392
2018;September;39;2018-09-25 00:00;50;210;220;430
2018;September;39;2018-09-25 00:00;51;239;227;466
2018;September;39;2018-09-25 00:00;52;185;221;406
2018;September;39;2018-09-25 00:00;53;196;219;415
2018;September;39;2018-09-25 00:00;54;187;222;409
2018;September;39;2018-09-25 00:00;55;182;213;395
2018;September;39;2018-09-25 00:00;56;190;189;379
2018;September;39;2018-09-25 00:00;57;150;168;318
2018;September;39;2018-09-25 00:00;58;156;154;310
2018;September;39;2018-09-25 00:00;59;154;163;317
2018;September;39;2018-09-25 00:00;60;150;154;304
2018;September;39;2018-09-25 00:00;61;147;155;302
2018;September;39;2018-09-25 00:00;62;151;157;308
2018;September;39;2018-09-25 00:00;63;133;118;251
2018;September;39;2018-09-25 00:00;64;132;138;270
2018;September;39;2018-09-25 00:00;65;145;134;279
2018;September;39;2018-09-25 00:00;66;137;150;287
2018;September;39;2018-09-25 00:00;67;142;135;277
2018;September;39;2018-09-25 00:00;68;142;156;298
2018;September;39;2018-09-25 00:00;69;149;161;310
2018;September;39;2018-09-25 00:00;70;174;162;336
2018;September;39;2018-09-25 00:00;71;161;156;317
2018;September;39;2018-09-25 00:00;72;182;149;331
2018;September;39;2018-09-25 00:00;73;182;171;353
2018;September;39;2018-09-25 00:00;74;152;158;310
2018;September;39;2018-09-25 00:00;75;152;164;316
2018;September;39;2018-09-25 00:00;76;137;132;269
2018;September;39;2018-09-25 00:00;77;106;100;206
2018;September;39;2018-09-25 00:00;78;82;125;207
2018;September;39;2018-09-25 00:00;79;85;88;173
2018;September;39;2018-09-25 00:00;80;92;77;169
2018;September;39;2018-09-25 00:00;81;78;69;147
2018;September;39;2018-09-25 00:00;82;90;64;154
2018;September;39;2018-09-25 00:00;83;55;64;119
2018;September;39;2018-09-25 00:00;84;64;47;111
2018;September;39;2018-09-25 00:00;85;54;43;97
2018;September;39;2018-09-25 00:00;86;31;35;66
2018;September;39;2018-09-25 00:00;87;42;28;70
2018;September;39;2018-09-25 00:00;88;40;23;63
2018;September;39;2018-09-25 00:00;89;34;23;57
2018;September;39;2018-09-25 00:00;90;23;14;37
2018;September;39;2018-09-25 00:00;91;28;9;37
2018;September;39;2018-09-25 00:00;92;19;10;29
2018;September;39;2018-09-25 00:00;93;18;6;24
2018;September;39;2018-09-25 00:00;94;12;7;19
2018;September;39;2018-09-25 00:00;95;7;5;12
2018;September;39;2018-09-25 00:00;96;11;1;12
2018;September;39;2018-09-25 00:00;97;3;3;6
2018;September;39;2018-09-25 00:00;98;2;2;4
2018;September;39;2018-09-25 00:00;99;0;1;1
2018;September;39;2018-09-25 00:00;100;1;0;1
2018;September;39;2018-09-25 00:00;106;1;0;1
2018;October;40;2018-10-02 00:00;0;143;161;304
2018;October;40;2018-10-02 00:00;1;207;201;408
2018;October;40;2018-10-02 00:00;2;183;213;396
2018;October;40;2018-10-02 00:00;3;195;212;407
2018;October;40;2018-10-02 00:00;4;183;233;416
2018;October;40;2018-10-02 00:00;5;213;228;441
2018;October;40;2018-10-02 00:00;6;194;199;393
2018;October;40;2018-10-02 00:00;7;224;237;461
2018;October;40;2018-10-02 00:00;8;228;238;466
2018;October;40;2018-10-02 00:00;9;214;222;436
2018;October;40;2018-10-02 00:00;10;206;204;410
2018;October;40;2018-10-02 00:00;11;189;207;396
2018;October;40;2018-10-02 00:00;12;224;201;425
2018;October;40;2018-10-02 00:00;13;188;213;401
2018;October;40;2018-10-02 00:00;14;185;206;391
2018;October;40;2018-10-02 00:00;15;177;184;361
2018;October;40;2018-10-02 00:00;16;183;221;404
2018;October;40;2018-10-02 00:00;17;143;183;326
2018;October;40;2018-10-02 00:00;18;178;198;376
2018;October;40;2018-10-02 00:00;19;174;187;361
2018;October;40;2018-10-02 00:00;20;149;172;321
2018;October;40;2018-10-02 00:00;21;142;195;337
2018;October;40;2018-10-02 00:00;22;143;171;314
2018;October;40;2018-10-02 00:00;23;148;177;325
2018;October;40;2018-10-02 00:00;24;173;175;348
2018;October;40;2018-10-02 00:00;25;176;202;378
2018;October;40;2018-10-02 00:00;26;183;182;365
2018;October;40;2018-10-02 00:00;27;184;235;419
2018;October;40;2018-10-02 00:00;28;199;217;416
2018;October;40;2018-10-02 00:00;29;178;198;376
2018;October;40;2018-10-02 00:00;30;194;189;383
2018;October;40;2018-10-02 00:00;31;206;202;408
2018;October;40;2018-10-02 00:00;32;182;185;367
2018;October;40;2018-10-02 00:00;33;200;217;417
2018;October;40;2018-10-02 00:00;34;194;203;397
2018;October;40;2018-10-02 00:00;35;219;190;409
2018;October;40;2018-10-02 00:00;36;207;206;413
2018;October;40;2018-10-02 00:00;37;174;195;369
2018;October;40;2018-10-02 00:00;38;241;207;448
2018;October;40;2018-10-02 00:00;39;209;181;390
2018;October;40;2018-10-02 00:00;40;200;213;413
2018;October;40;2018-10-02 00:00;41;196;208;404
2018;October;40;2018-10-02 00:00;42;223;219;442
2018;October;40;2018-10-02 00:00;43;226;243;469
2018;October;40;2018-10-02 00:00;44;233;281;514
2018;October;40;2018-10-02 00:00;45;212;222;434
2018;October;40;2018-10-02 00:00;46;222;256;478
2018;October;40;2018-10-02 00:00;47;215;218;433
2018;October;40;2018-10-02 00:00;48;207;225;432
2018;October;40;2018-10-02 00:00;49;194;198;392
2018;October;40;2018-10-02 00:00;50;208;221;429
2018;October;40;2018-10-02 00:00;51;240;227;467
2018;October;40;2018-10-02 00:00;52;186;221;407
2018;October;40;2018-10-02 00:00;53;197;219;416
2018;October;40;2018-10-02 00:00;54;186;220;406
2018;October;40;2018-10-02 00:00;55;181;213;394
2018;October;40;2018-10-02 00:00;56;188;188;376
2018;October;40;2018-10-02 00:00;57;149;167;316
2018;October;40;2018-10-02 00:00;58;155;154;309
2018;October;40;2018-10-02 00:00;59;154;163;317
2018;October;40;2018-10-02 00:00;60;149;156;305
2018;October;40;2018-10-02 00:00;61;147;153;300
2018;October;40;2018-10-02 00:00;62;151;157;308
2018;October;40;2018-10-02 00:00;63;133;117;250
2018;October;40;2018-10-02 00:00;64;132;138;270
2018;October;40;2018-10-02 00:00;65;145;135;280
2018;October;40;2018-10-02 00:00;66;139;150;289
2018;October;40;2018-10-02 00:00;67;142;135;277
2018;October;40;2018-10-02 00:00;68;142;156;298
2018;October;40;2018-10-02 00:00;69;149;161;310
2018;October;40;2018-10-02 00:00;70;174;162;336
2018;October;40;2018-10-02 00:00;71;160;156;316
2018;October;40;2018-10-02 00:00;72;182;149;331
2018;October;40;2018-10-02 00:00;73;182;171;353
2018;October;40;2018-10-02 00:00;74;152;158;310
2018;October;40;2018-10-02 00:00;75;152;164;316
2018;October;40;2018-10-02 00:00;76;137;132;269
2018;October;40;2018-10-02 00:00;77;106;100;206
2018;October;40;2018-10-02 00:00;78;82;125;207
2018;October;40;2018-10-02 00:00;79;85;88;173
2018;October;40;2018-10-02 00:00;80;92;77;169
2018;October;40;2018-10-02 00:00;81;78;68;146
2018;October;40;2018-10-02 00:00;82;90;64;154
2018;October;40;2018-10-02 00:00;83;56;64;120
2018;October;40;2018-10-02 00:00;84;64;46;110
2018;October;40;2018-10-02 00:00;85;54;43;97
2018;October;40;2018-10-02 00:00;86;31;35;66
2018;October;40;2018-10-02 00:00;87;42;28;70
2018;October;40;2018-10-02 00:00;88;40;23;63
2018;October;40;2018-10-02 00:00;89;34;23;57
2018;October;40;2018-10-02 00:00;90;23;14;37
2018;October;40;2018-10-02 00:00;91;28;9;37
2018;October;40;2018-10-02 00:00;92;19;10;29
2018;October;40;2018-10-02 00:00;93;18;6;24
2018;October;40;2018-10-02 00:00;94;12;7;19
2018;October;40;2018-10-02 00:00;95;7;5;12
2018;October;40;2018-10-02 00:00;96;11;1;12
2018;October;40;2018-10-02 00:00;97;3;3;6
2018;October;40;2018-10-02 00:00;98;2;2;4
2018;October;40;2018-10-02 00:00;99;0;1;1
2018;October;40;2018-10-02 00:00;100;1;0;1
2018;October;40;2018-10-02 00:00;106;1;0;1
2018;October;41;2018-10-09 00:00;0;147;165;312
2018;October;41;2018-10-09 00:00;1;207;201;408
2018;October;41;2018-10-09 00:00;2;183;214;397
2018;October;41;2018-10-09 00:00;3;195;212;407
2018;October;41;2018-10-09 00:00;4;183;234;417
2018;October;41;2018-10-09 00:00;5;213;229;442
2018;October;41;2018-10-09 00:00;6;194;199;393
2018;October;41;2018-10-09 00:00;7;224;238;462
2018;October;41;2018-10-09 00:00;8;228;238;466
2018;October;41;2018-10-09 00:00;9;214;221;435
2018;October;41;2018-10-09 00:00;10;206;204;410
2018;October;41;2018-10-09 00:00;11;189;207;396
2018;October;41;2018-10-09 00:00;12;224;201;425
2018;October;41;2018-10-09 00:00;13;188;212;400
2018;October;41;2018-10-09 00:00;14;187;206;393
2018;October;41;2018-10-09 00:00;15;177;184;361
2018;October;41;2018-10-09 00:00;16;183;221;404
2018;October;41;2018-10-09 00:00;17;143;183;326
2018;October;41;2018-10-09 00:00;18;177;198;375
2018;October;41;2018-10-09 00:00;19;173;187;360
2018;October;41;2018-10-09 00:00;20;147;172;319
2018;October;41;2018-10-09 00:00;21;143;195;338
2018;October;41;2018-10-09 00:00;22;144;172;316
2018;October;41;2018-10-09 00:00;23;148;177;325
2018;October;41;2018-10-09 00:00;24;172;177;349
2018;October;41;2018-10-09 00:00;25;177;204;381
2018;October;41;2018-10-09 00:00;26;182;183;365
2018;October;41;2018-10-09 00:00;27;184;235;419
2018;October;41;2018-10-09 00:00;28;201;218;419
2018;October;41;2018-10-09 00:00;29;178;199;377
2018;October;41;2018-10-09 00:00;30;193;188;381
2018;October;41;2018-10-09 00:00;31;209;202;411
2018;October;41;2018-10-09 00:00;32;181;185;366
2018;October;41;2018-10-09 00:00;33;200;218;418
2018;October;41;2018-10-09 00:00;34;195;203;398
2018;October;41;2018-10-09 00:00;35;219;190;409
2018;October;41;2018-10-09 00:00;36;207;206;413
2018;October;41;2018-10-09 00:00;37;174;194;368
2018;October;41;2018-10-09 00:00;38;242;207;449
2018;October;41;2018-10-09 00:00;39;209;181;390
2018;October;41;2018-10-09 00:00;40;200;213;413
2018;October;41;2018-10-09 00:00;41;196;207;403
2018;October;41;2018-10-09 00:00;42;222;219;441
2018;October;41;2018-10-09 00:00;43;225;243;468
2018;October;41;2018-10-09 00:00;44;233;281;514
2018;October;41;2018-10-09 00:00;45;212;221;433
2018;October;41;2018-10-09 00:00;46;221;256;477
2018;October;41;2018-10-09 00:00;47;215;218;433
2018;October;41;2018-10-09 00:00;48;207;225;432
2018;October;41;2018-10-09 00:00;49;194;198;392
2018;October;41;2018-10-09 00:00;50;207;221;428
2018;October;41;2018-10-09 00:00;51;240;227;467
2018;October;41;2018-10-09 00:00;52;187;221;408
2018;October;41;2018-10-09 00:00;53;197;218;415
2018;October;41;2018-10-09 00:00;54;186;221;407
2018;October;41;2018-10-09 00:00;55;181;213;394
2018;October;41;2018-10-09 00:00;56;188;189;377
2018;October;41;2018-10-09 00:00;57;149;167;316
2018;October;41;2018-10-09 00:00;58;155;154;309
2018;October;41;2018-10-09 00:00;59;154;164;318
2018;October;41;2018-10-09 00:00;60;148;156;304
2018;October;41;2018-10-09 00:00;61;147;152;299
2018;October;41;2018-10-09 00:00;62;151;158;309
2018;October;41;2018-10-09 00:00;63;133;117;250
2018;October;41;2018-10-09 00:00;64;132;138;270
2018;October;41;2018-10-09 00:00;65;145;135;280
2018;October;41;2018-10-09 00:00;66;139;150;289
2018;October;41;2018-10-09 00:00;67;142;135;277
2018;October;41;2018-10-09 00:00;68;142;156;298
2018;October;41;2018-10-09 00:00;69;149;161;310
2018;October;41;2018-10-09 00:00;70;174;162;336
2018;October;41;2018-10-09 00:00;71;160;156;316
2018;October;41;2018-10-09 00:00;72;182;149;331
2018;October;41;2018-10-09 00:00;73;182;171;353
2018;October;41;2018-10-09 00:00;74;152;158;310
2018;October;41;2018-10-09 00:00;75;152;164;316
2018;October;41;2018-10-09 00:00;76;137;132;269
2018;October;41;2018-10-09 00:00;77;106;100;206
2018;October;41;2018-10-09 00:00;78;82;125;207
2018;October;41;2018-10-09 00:00;79;85;87;172
2018;October;41;2018-10-09 00:00;80;92;77;169
2018;October;41;2018-10-09 00:00;81;78;68;146
2018;October;41;2018-10-09 00:00;82;90;64;154
2018;October;41;2018-10-09 00:00;83;56;63;119
2018;October;41;2018-10-09 00:00;84;63;45;108
2018;October;41;2018-10-09 00:00;85;54;43;97
2018;October;41;2018-10-09 00:00;86;31;35;66
2018;October;41;2018-10-09 00:00;87;42;28;70
2018;October;41;2018-10-09 00:00;88;40;23;63
2018;October;41;2018-10-09 00:00;89;34;23;57
2018;October;41;2018-10-09 00:00;90;23;14;37
2018;October;41;2018-10-09 00:00;91;29;9;38
2018;October;41;2018-10-09 00:00;92;19;10;29
2018;October;41;2018-10-09 00:00;93;18;6;24
2018;October;41;2018-10-09 00:00;94;12;7;19
2018;October;41;2018-10-09 00:00;95;7;5;12
2018;October;41;2018-10-09 00:00;96;11;1;12
2018;October;41;2018-10-09 00:00;97;3;3;6
2018;October;41;2018-10-09 00:00;98;2;2;4
2018;October;41;2018-10-09 00:00;99;0;1;1
2018;October;41;2018-10-09 00:00;100;1;0;1
2018;October;41;2018-10-09 00:00;106;1;0;1
2018;October;42;2018-10-16 00:00;0;148;166;314
2018;October;42;2018-10-16 00:00;1;208;201;409
2018;October;42;2018-10-16 00:00;2;183;213;396
2018;October;42;2018-10-16 00:00;3;196;212;408
2018;October;42;2018-10-16 00:00;4;183;234;417
2018;October;42;2018-10-16 00:00;5;214;229;443
2018;October;42;2018-10-16 00:00;6;194;199;393
2018;October;42;2018-10-16 00:00;7;225;238;463
2018;October;42;2018-10-16 00:00;8;227;237;464
2018;October;42;2018-10-16 00:00;9;214;221;435
2018;October;42;2018-10-16 00:00;10;206;204;410
2018;October;42;2018-10-16 00:00;11;189;207;396
2018;October;42;2018-10-16 00:00;12;224;201;425
2018;October;42;2018-10-16 00:00;13;188;212;400
2018;October;42;2018-10-16 00:00;14;188;204;392
2018;October;42;2018-10-16 00:00;15;177;184;361
2018;October;42;2018-10-16 00:00;16;182;221;403
2018;October;42;2018-10-16 00:00;17;143;183;326
2018;October;42;2018-10-16 00:00;18;174;198;372
2018;October;42;2018-10-16 00:00;19;173;187;360
2018;October;42;2018-10-16 00:00;20;147;171;318
2018;October;42;2018-10-16 00:00;21;143;196;339
2018;October;42;2018-10-16 00:00;22;145;172;317
2018;October;42;2018-10-16 00:00;23;148;175;323
2018;October;42;2018-10-16 00:00;24;174;178;352
2018;October;42;2018-10-16 00:00;25;175;205;380
2018;October;42;2018-10-16 00:00;26;182;183;365
2018;October;42;2018-10-16 00:00;27;185;235;420
2018;October;42;2018-10-16 00:00;28;202;219;421
2018;October;42;2018-10-16 00:00;29;178;199;377
2018;October;42;2018-10-16 00:00;30;193;188;381
2018;October;42;2018-10-16 00:00;31;209;202;411
2018;October;42;2018-10-16 00:00;32;180;185;365
2018;October;42;2018-10-16 00:00;33;200;218;418
2018;October;42;2018-10-16 00:00;34;195;202;397
2018;October;42;2018-10-16 00:00;35;219;189;408
2018;October;42;2018-10-16 00:00;36;207;205;412
2018;October;42;2018-10-16 00:00;37;174;194;368
2018;October;42;2018-10-16 00:00;38;244;208;452
2018;October;42;2018-10-16 00:00;39;209;182;391
2018;October;42;2018-10-16 00:00;40;201;213;414
2018;October;42;2018-10-16 00:00;41;196;207;403
2018;October;42;2018-10-16 00:00;42;222;221;443
2018;October;42;2018-10-16 00:00;43;225;243;468
2018;October;42;2018-10-16 00:00;44;232;281;513
2018;October;42;2018-10-16 00:00;45;212;221;433
2018;October;42;2018-10-16 00:00;46;222;256;478
2018;October;42;2018-10-16 00:00;47;215;219;434
2018;October;42;2018-10-16 00:00;48;207;225;432
2018;October;42;2018-10-16 00:00;49;194;198;392
2018;October;42;2018-10-16 00:00;50;207;221;428
2018;October;42;2018-10-16 00:00;51;240;227;467
2018;October;42;2018-10-16 00:00;52;187;221;408
2018;October;42;2018-10-16 00:00;53;198;218;416
2018;October;42;2018-10-16 00:00;54;186;220;406
2018;October;42;2018-10-16 00:00;55;180;212;392
2018;October;42;2018-10-16 00:00;56;188;188;376
2018;October;42;2018-10-16 00:00;57;149;167;316
2018;October;42;2018-10-16 00:00;58;155;154;309
2018;October;42;2018-10-16 00:00;59;154;164;318
2018;October;42;2018-10-16 00:00;60;148;156;304
2018;October;42;2018-10-16 00:00;61;148;152;300
2018;October;42;2018-10-16 00:00;62;151;158;309
2018;October;42;2018-10-16 00:00;63;132;117;249
2018;October;42;2018-10-16 00:00;64;132;138;270
2018;October;42;2018-10-16 00:00;65;145;135;280
2018;October;42;2018-10-16 00:00;66;139;150;289
2018;October;42;2018-10-16 00:00;67;142;135;277
2018;October;42;2018-10-16 00:00;68;142;156;298
2018;October;42;2018-10-16 00:00;69;148;161;309
2018;October;42;2018-10-16 00:00;70;174;162;336
2018;October;42;2018-10-16 00:00;71;160;156;316
2018;October;42;2018-10-16 00:00;72;182;148;330
2018;October;42;2018-10-16 00:00;73;182;171;353
2018;October;42;2018-10-16 00:00;74;152;158;310
2018;October;42;2018-10-16 00:00;75;152;164;316
2018;October;42;2018-10-16 00:00;76;137;133;270
2018;October;42;2018-10-16 00:00;77;106;100;206
2018;October;42;2018-10-16 00:00;78;82;125;207
2018;October;42;2018-10-16 00:00;79;85;87;172
2018;October;42;2018-10-16 00:00;80;92;77;169
2018;October;42;2018-10-16 00:00;81;78;68;146
2018;October;42;2018-10-16 00:00;82;90;64;154
2018;October;42;2018-10-16 00:00;83;56;63;119
2018;October;42;2018-10-16 00:00;84;63;44;107
2018;October;42;2018-10-16 00:00;85;53;43;96
2018;October;42;2018-10-16 00:00;86;31;35;66
2018;October;42;2018-10-16 00:00;87;42;28;70
2018;October;42;2018-10-16 00:00;88;39;23;62
2018;October;42;2018-10-16 00:00;89;34;23;57
2018;October;42;2018-10-16 00:00;90;23;14;37
2018;October;42;2018-10-16 00:00;91;29;9;38
2018;October;42;2018-10-16 00:00;92;19;9;28
2018;October;42;2018-10-16 00:00;93;18;6;24
2018;October;42;2018-10-16 00:00;94;12;7;19
2018;October;42;2018-10-16 00:00;95;7;5;12
2018;October;42;2018-10-16 00:00;96;11;1;12
2018;October;42;2018-10-16 00:00;97;3;3;6
2018;October;42;2018-10-16 00:00;98;2;2;4
2018;October;42;2018-10-16 00:00;99;0;1;1
2018;October;42;2018-10-16 00:00;100;1;0;1
2018;October;42;2018-10-16 00:00;106;1;0;1
2018;October;43;2018-10-23 00:00;0;152;170;322
2018;October;43;2018-10-23 00:00;1;208;202;410
2018;October;43;2018-10-23 00:00;2;183;213;396
2018;October;43;2018-10-23 00:00;3;194;212;406
2018;October;43;2018-10-23 00:00;4;183;234;417
2018;October;43;2018-10-23 00:00;5;214;229;443
2018;October;43;2018-10-23 00:00;6;194;199;393
2018;October;43;2018-10-23 00:00;7;224;238;462
2018;October;43;2018-10-23 00:00;8;226;238;464
2018;October;43;2018-10-23 00:00;9;215;221;436
2018;October;43;2018-10-23 00:00;10;206;204;410
2018;October;43;2018-10-23 00:00;11;189;208;397
2018;October;43;2018-10-23 00:00;12;224;201;425
2018;October;43;2018-10-23 00:00;13;188;212;400
2018;October;43;2018-10-23 00:00;14;188;204;392
2018;October;43;2018-10-23 00:00;15;177;184;361
2018;October;43;2018-10-23 00:00;16;182;221;403
2018;October;43;2018-10-23 00:00;17;144;183;327
2018;October;43;2018-10-23 00:00;18;174;198;372
2018;October;43;2018-10-23 00:00;19;173;187;360
2018;October;43;2018-10-23 00:00;20;146;171;317
2018;October;43;2018-10-23 00:00;21;143;197;340
2018;October;43;2018-10-23 00:00;22;147;173;320
2018;October;43;2018-10-23 00:00;23;147;178;325
2018;October;43;2018-10-23 00:00;24;175;179;354
2018;October;43;2018-10-23 00:00;25;175;208;383
2018;October;43;2018-10-23 00:00;26;181;182;363
2018;October;43;2018-10-23 00:00;27;185;236;421
2018;October;43;2018-10-23 00:00;28;201;218;419
2018;October;43;2018-10-23 00:00;29;178;199;377
2018;October;43;2018-10-23 00:00;30;194;189;383
2018;October;43;2018-10-23 00:00;31;208;201;409
2018;October;43;2018-10-23 00:00;32;181;185;366
2018;October;43;2018-10-23 00:00;33;200;218;418
2018;October;43;2018-10-23 00:00;34;196;202;398
2018;October;43;2018-10-23 00:00;35;219;189;408
2018;October;43;2018-10-23 00:00;36;207;206;413
2018;October;43;2018-10-23 00:00;37;176;195;371
2018;October;43;2018-10-23 00:00;38;244;208;452
2018;October;43;2018-10-23 00:00;39;211;182;393
2018;October;43;2018-10-23 00:00;40;201;213;414
2018;October;43;2018-10-23 00:00;41;196;208;404
2018;October;43;2018-10-23 00:00;42;223;221;444
2018;October;43;2018-10-23 00:00;43;225;244;469
2018;October;43;2018-10-23 00:00;44;232;281;513
2018;October;43;2018-10-23 00:00;45;212;220;432
2018;October;43;2018-10-23 00:00;46;222;256;478
2018;October;43;2018-10-23 00:00;47;215;220;435
2018;October;43;2018-10-23 00:00;48;207;225;432
2018;October;43;2018-10-23 00:00;49;194;198;392
2018;October;43;2018-10-23 00:00;50;207;222;429
2018;October;43;2018-10-23 00:00;51;240;227;467
2018;October;43;2018-10-23 00:00;52;187;221;408
2018;October;43;2018-10-23 00:00;53;197;218;415
2018;October;43;2018-10-23 00:00;54;186;220;406
2018;October;43;2018-10-23 00:00;55;180;212;392
2018;October;43;2018-10-23 00:00;56;188;188;376
2018;October;43;2018-10-23 00:00;57;149;167;316
2018;October;43;2018-10-23 00:00;58;155;154;309
2018;October;43;2018-10-23 00:00;59;154;164;318
2018;October;43;2018-10-23 00:00;60;148;157;305
2018;October;43;2018-10-23 00:00;61;148;152;300
2018;October;43;2018-10-23 00:00;62;151;158;309
2018;October;43;2018-10-23 00:00;63;132;117;249
2018;October;43;2018-10-23 00:00;64;132;138;270
2018;October;43;2018-10-23 00:00;65;145;135;280
2018;October;43;2018-10-23 00:00;66;139;150;289
2018;October;43;2018-10-23 00:00;67;142;135;277
2018;October;43;2018-10-23 00:00;68;142;156;298
2018;October;43;2018-10-23 00:00;69;148;161;309
2018;October;43;2018-10-23 00:00;70;174;162;336
2018;October;43;2018-10-23 00:00;71;160;156;316
2018;October;43;2018-10-23 00:00;72;182;148;330
2018;October;43;2018-10-23 00:00;73;182;171;353
2018;October;43;2018-10-23 00:00;74;152;158;310
2018;October;43;2018-10-23 00:00;75;152;164;316
2018;October;43;2018-10-23 00:00;76;137;133;270
2018;October;43;2018-10-23 00:00;77;106;100;206
2018;October;43;2018-10-23 00:00;78;82;124;206
2018;October;43;2018-10-23 00:00;79;85;87;172
2018;October;43;2018-10-23 00:00;80;92;77;169
2018;October;43;2018-10-23 00:00;81;78;68;146
2018;October;43;2018-10-23 00:00;82;90;64;154
2018;October;43;2018-10-23 00:00;83;56;63;119
2018;October;43;2018-10-23 00:00;84;63;43;106
2018;October;43;2018-10-23 00:00;85;53;43;96
2018;October;43;2018-10-23 00:00;86;31;35;66
2018;October;43;2018-10-23 00:00;87;42;28;70
2018;October;43;2018-10-23 00:00;88;39;23;62
2018;October;43;2018-10-23 00:00;89;34;23;57
2018;October;43;2018-10-23 00:00;90;23;14;37
2018;October;43;2018-10-23 00:00;91;29;9;38
2018;October;43;2018-10-23 00:00;92;19;9;28
2018;October;43;2018-10-23 00:00;93;18;6;24
2018;October;43;2018-10-23 00:00;94;12;7;19
2018;October;43;2018-10-23 00:00;95;7;5;12
2018;October;43;2018-10-23 00:00;96;11;1;12
2018;October;43;2018-10-23 00:00;97;3;3;6
2018;October;43;2018-10-23 00:00;98;2;2;4
2018;October;43;2018-10-23 00:00;99;0;1;1
2018;October;43;2018-10-23 00:00;100;1;0;1
2018;October;43;2018-10-23 00:00;106;1;0;1
2018;October;44;2018-10-30 00:00;0;152;172;324
2018;October;44;2018-10-30 00:00;1;208;201;409
2018;October;44;2018-10-30 00:00;2;184;212;396
2018;October;44;2018-10-30 00:00;3;194;212;406
2018;October;44;2018-10-30 00:00;4;183;234;417
2018;October;44;2018-10-30 00:00;5;214;228;442
2018;October;44;2018-10-30 00:00;6;194;199;393
2018;October;44;2018-10-30 00:00;7;224;238;462
2018;October;44;2018-10-30 00:00;8;225;238;463
2018;October;44;2018-10-30 00:00;9;215;221;436
2018;October;44;2018-10-30 00:00;10;206;204;410
2018;October;44;2018-10-30 00:00;11;188;208;396
2018;October;44;2018-10-30 00:00;12;224;202;426
2018;October;44;2018-10-30 00:00;13;188;212;400
2018;October;44;2018-10-30 00:00;14;187;204;391
2018;October;44;2018-10-30 00:00;15;177;184;361
2018;October;44;2018-10-30 00:00;16;182;221;403
2018;October;44;2018-10-30 00:00;17;144;183;327
2018;October;44;2018-10-30 00:00;18;174;197;371
2018;October;44;2018-10-30 00:00;19;173;187;360
2018;October;44;2018-10-30 00:00;20;146;171;317
2018;October;44;2018-10-30 00:00;21;143;198;341
2018;October;44;2018-10-30 00:00;22;147;173;320
2018;October;44;2018-10-30 00:00;23;147;178;325
2018;October;44;2018-10-30 00:00;24;175;179;354
2018;October;44;2018-10-30 00:00;25;176;209;385
2018;October;44;2018-10-30 00:00;26;182;182;364
2018;October;44;2018-10-30 00:00;27;185;236;421
2018;October;44;2018-10-30 00:00;28;200;218;418
2018;October;44;2018-10-30 00:00;29;178;199;377
2018;October;44;2018-10-30 00:00;30;193;190;383
2018;October;44;2018-10-30 00:00;31;208;200;408
2018;October;44;2018-10-30 00:00;32;181;185;366
2018;October;44;2018-10-30 00:00;33;200;219;419
2018;October;44;2018-10-30 00:00;34;196;202;398
2018;October;44;2018-10-30 00:00;35;218;189;407
2018;October;44;2018-10-30 00:00;36;207;206;413
2018;October;44;2018-10-30 00:00;37;175;195;370
2018;October;44;2018-10-30 00:00;38;244;208;452
2018;October;44;2018-10-30 00:00;39;210;182;392
2018;October;44;2018-10-30 00:00;40;201;213;414
2018;October;44;2018-10-30 00:00;41;196;208;404
2018;October;44;2018-10-30 00:00;42;223;221;444
2018;October;44;2018-10-30 00:00;43;224;245;469
2018;October;44;2018-10-30 00:00;44;231;278;509
2018;October;44;2018-10-30 00:00;45;212;220;432
2018;October;44;2018-10-30 00:00;46;222;256;478
2018;October;44;2018-10-30 00:00;47;215;220;435
2018;October;44;2018-10-30 00:00;48;208;225;433
2018;October;44;2018-10-30 00:00;49;194;197;391
2018;October;44;2018-10-30 00:00;50;207;222;429
2018;October;44;2018-10-30 00:00;51;239;227;466
2018;October;44;2018-10-30 00:00;52;188;221;409
2018;October;44;2018-10-30 00:00;53;197;218;415
2018;October;44;2018-10-30 00:00;54;187;220;407
2018;October;44;2018-10-30 00:00;55;180;212;392
2018;October;44;2018-10-30 00:00;56;188;188;376
2018;October;44;2018-10-30 00:00;57;149;167;316
2018;October;44;2018-10-30 00:00;58;156;154;310
2018;October;44;2018-10-30 00:00;59;154;164;318
2018;October;44;2018-10-30 00:00;60;148;157;305
2018;October;44;2018-10-30 00:00;61;148;152;300
2018;October;44;2018-10-30 00:00;62;151;157;308
2018;October;44;2018-10-30 00:00;63;132;117;249
2018;October;44;2018-10-30 00:00;64;132;138;270
2018;October;44;2018-10-30 00:00;65;145;135;280
2018;October;44;2018-10-30 00:00;66;139;150;289
2018;October;44;2018-10-30 00:00;67;142;135;277
2018;October;44;2018-10-30 00:00;68;142;156;298
2018;October;44;2018-10-30 00:00;69;148;161;309
2018;October;44;2018-10-30 00:00;70;174;162;336
2018;October;44;2018-10-30 00:00;71;160;156;316
2018;October;44;2018-10-30 00:00;72;182;148;330
2018;October;44;2018-10-30 00:00;73;182;171;353
2018;October;44;2018-10-30 00:00;74;151;158;309
2018;October;44;2018-10-30 00:00;75;152;163;315
2018;October;44;2018-10-30 00:00;76;137;133;270
2018;October;44;2018-10-30 00:00;77;106;100;206
2018;October;44;2018-10-30 00:00;78;82;124;206
2018;October;44;2018-10-30 00:00;79;85;86;171
2018;October;44;2018-10-30 00:00;80;92;77;169
2018;October;44;2018-10-30 00:00;81;78;68;146
2018;October;44;2018-10-30 00:00;82;90;64;154
2018;October;44;2018-10-30 00:00;83;56;63;119
2018;October;44;2018-10-30 00:00;84;62;43;105
2018;October;44;2018-10-30 00:00;85;53;42;95
2018;October;44;2018-10-30 00:00;86;31;35;66
2018;October;44;2018-10-30 00:00;87;42;28;70
2018;October;44;2018-10-30 00:00;88;39;23;62
2018;October;44;2018-10-30 00:00;89;34;23;57
2018;October;44;2018-10-30 00:00;90;23;14;37
2018;October;44;2018-10-30 00:00;91;29;9;38
2018;October;44;2018-10-30 00:00;92;19;9;28
2018;October;44;2018-10-30 00:00;93;18;6;24
2018;October;44;2018-10-30 00:00;94;12;6;18
2018;October;44;2018-10-30 00:00;95;7;5;12
2018;October;44;2018-10-30 00:00;96;11;1;12
2018;October;44;2018-10-30 00:00;97;3;3;6
2018;October;44;2018-10-30 00:00;98;2;2;4
2018;October;44;2018-10-30 00:00;99;0;1;1
2018;October;44;2018-10-30 00:00;100;1;0;1
2018;October;44;2018-10-30 00:00;106;1;0;1
2018;November;45;2018-11-06 00:00;0;156;187;343
2018;November;45;2018-11-06 00:00;1;208;202;410
2018;November;45;2018-11-06 00:00;2;184;212;396
2018;November;45;2018-11-06 00:00;3;194;211;405
2018;November;45;2018-11-06 00:00;4;183;233;416
2018;November;45;2018-11-06 00:00;5;214;228;442
2018;November;45;2018-11-06 00:00;6;196;199;395
2018;November;45;2018-11-06 00:00;7;224;238;462
2018;November;45;2018-11-06 00:00;8;226;239;465
2018;November;45;2018-11-06 00:00;9;215;221;436
2018;November;45;2018-11-06 00:00;10;206;204;410
2018;November;45;2018-11-06 00:00;11;188;208;396
2018;November;45;2018-11-06 00:00;12;224;202;426
2018;November;45;2018-11-06 00:00;13;189;212;401
2018;November;45;2018-11-06 00:00;14;186;206;392
2018;November;45;2018-11-06 00:00;15;176;184;360
2018;November;45;2018-11-06 00:00;16;184;222;406
2018;November;45;2018-11-06 00:00;17;144;183;327
2018;November;45;2018-11-06 00:00;18;175;198;373
2018;November;45;2018-11-06 00:00;19;173;188;361
2018;November;45;2018-11-06 00:00;20;146;173;319
2018;November;45;2018-11-06 00:00;21;143;197;340
2018;November;45;2018-11-06 00:00;22;147;172;319
2018;November;45;2018-11-06 00:00;23;147;177;324
2018;November;45;2018-11-06 00:00;24;176;178;354
2018;November;45;2018-11-06 00:00;25;174;207;381
2018;November;45;2018-11-06 00:00;26;184;184;368
2018;November;45;2018-11-06 00:00;27;184;236;420
2018;November;45;2018-11-06 00:00;28;199;219;418
2018;November;45;2018-11-06 00:00;29;181;199;380
2018;November;45;2018-11-06 00:00;30;194;191;385
2018;November;45;2018-11-06 00:00;31;208;199;407
2018;November;45;2018-11-06 00:00;32;180;185;365
2018;November;45;2018-11-06 00:00;33;200;220;420
2018;November;45;2018-11-06 00:00;34;196;203;399
2018;November;45;2018-11-06 00:00;35;218;188;406
2018;November;45;2018-11-06 00:00;36;209;206;415
2018;November;45;2018-11-06 00:00;37;174;194;368
2018;November;45;2018-11-06 00:00;38;244;209;453
2018;November;45;2018-11-06 00:00;39;210;182;392
2018;November;45;2018-11-06 00:00;40;202;211;413
2018;November;45;2018-11-06 00:00;41;196;210;406
2018;November;45;2018-11-06 00:00;42;224;220;444
2018;November;45;2018-11-06 00:00;43;223;246;469
2018;November;45;2018-11-06 00:00;44;232;276;508
2018;November;45;2018-11-06 00:00;45;211;221;432
2018;November;45;2018-11-06 00:00;46;223;257;480
2018;November;45;2018-11-06 00:00;47;216;221;437
2018;November;45;2018-11-06 00:00;48;208;225;433
2018;November;45;2018-11-06 00:00;49;194;198;392
2018;November;45;2018-11-06 00:00;50;207;222;429
2018;November;45;2018-11-06 00:00;51;238;228;466
2018;November;45;2018-11-06 00:00;52;188;221;409
2018;November;45;2018-11-06 00:00;53;197;218;415
2018;November;45;2018-11-06 00:00;54;187;219;406
2018;November;45;2018-11-06 00:00;55;180;213;393
2018;November;45;2018-11-06 00:00;56;187;186;373
2018;November;45;2018-11-06 00:00;57;149;167;316
2018;November;45;2018-11-06 00:00;58;155;154;309
2018;November;45;2018-11-06 00:00;59;154;163;317
2018;November;45;2018-11-06 00:00;60;147;156;303
2018;November;45;2018-11-06 00:00;61;148;152;300
2018;November;45;2018-11-06 00:00;62;151;157;308
2018;November;45;2018-11-06 00:00;63;132;117;249
2018;November;45;2018-11-06 00:00;64;132;138;270
2018;November;45;2018-11-06 00:00;65;146;135;281
2018;November;45;2018-11-06 00:00;66;139;150;289
2018;November;45;2018-11-06 00:00;67;143;135;278
2018;November;45;2018-11-06 00:00;68;142;156;298
2018;November;45;2018-11-06 00:00;69;148;161;309
2018;November;45;2018-11-06 00:00;70;174;162;336
2018;November;45;2018-11-06 00:00;71;160;156;316
2018;November;45;2018-11-06 00:00;72;182;146;328
2018;November;45;2018-11-06 00:00;73;182;171;353
2018;November;45;2018-11-06 00:00;74;151;158;309
2018;November;45;2018-11-06 00:00;75;152;163;315
2018;November;45;2018-11-06 00:00;76;137;132;269
2018;November;45;2018-11-06 00:00;77;106;100;206
2018;November;45;2018-11-06 00:00;78;82;124;206
2018;November;45;2018-11-06 00:00;79;85;86;171
2018;November;45;2018-11-06 00:00;80;92;77;169
2018;November;45;2018-11-06 00:00;81;78;67;145
2018;November;45;2018-11-06 00:00;82;90;64;154
2018;November;45;2018-11-06 00:00;83;56;62;118
2018;November;45;2018-11-06 00:00;84;62;43;105
2018;November;45;2018-11-06 00:00;85;53;42;95
2018;November;45;2018-11-06 00:00;86;31;35;66
2018;November;45;2018-11-06 00:00;87;42;28;70
2018;November;45;2018-11-06 00:00;88;39;23;62
2018;November;45;2018-11-06 00:00;89;34;23;57
2018;November;45;2018-11-06 00:00;90;24;14;38
2018;November;45;2018-11-06 00:00;91;29;9;38
2018;November;45;2018-11-06 00:00;92;19;9;28
2018;November;45;2018-11-06 00:00;93;18;6;24
2018;November;45;2018-11-06 00:00;94;13;6;19
2018;November;45;2018-11-06 00:00;95;6;5;11
2018;November;45;2018-11-06 00:00;96;11;1;12
2018;November;45;2018-11-06 00:00;97;3;3;6
2018;November;45;2018-11-06 00:00;98;2;2;4
2018;November;45;2018-11-06 00:00;99;0;1;1
2018;November;45;2018-11-06 00:00;100;1;0;1
2018;November;45;2018-11-06 00:00;106;1;0;1
2018;November;46;2018-11-13 00:00;0;158;186;344
2018;November;46;2018-11-13 00:00;1;209;203;412
2018;November;46;2018-11-13 00:00;2;184;214;398
2018;November;46;2018-11-13 00:00;3;194;211;405
2018;November;46;2018-11-13 00:00;4;185;233;418
2018;November;46;2018-11-13 00:00;5;212;228;440
2018;November;46;2018-11-13 00:00;6;196;199;395
2018;November;46;2018-11-13 00:00;7;225;237;462
2018;November;46;2018-11-13 00:00;8;227;238;465
2018;November;46;2018-11-13 00:00;9;214;221;435
2018;November;46;2018-11-13 00:00;10;206;204;410
2018;November;46;2018-11-13 00:00;11;188;208;396
2018;November;46;2018-11-13 00:00;12;224;202;426
2018;November;46;2018-11-13 00:00;13;189;212;401
2018;November;46;2018-11-13 00:00;14;186;206;392
2018;November;46;2018-11-13 00:00;15;176;184;360
2018;November;46;2018-11-13 00:00;16;184;222;406
2018;November;46;2018-11-13 00:00;17;144;183;327
2018;November;46;2018-11-13 00:00;18;176;198;374
2018;November;46;2018-11-13 00:00;19;173;188;361
2018;November;46;2018-11-13 00:00;20;147;173;320
2018;November;46;2018-11-13 00:00;21;142;197;339
2018;November;46;2018-11-13 00:00;22;147;172;319
2018;November;46;2018-11-13 00:00;23;147;177;324
2018;November;46;2018-11-13 00:00;24;175;176;351
2018;November;46;2018-11-13 00:00;25;174;207;381
2018;November;46;2018-11-13 00:00;26;184;185;369
2018;November;46;2018-11-13 00:00;27;185;234;419
2018;November;46;2018-11-13 00:00;28;199;217;416
2018;November;46;2018-11-13 00:00;29;181;199;380
2018;November;46;2018-11-13 00:00;30;193;191;384
2018;November;46;2018-11-13 00:00;31;209;200;409
2018;November;46;2018-11-13 00:00;32;181;185;366
2018;November;46;2018-11-13 00:00;33;200;220;420
2018;November;46;2018-11-13 00:00;34;196;204;400
2018;November;46;2018-11-13 00:00;35;219;188;407
2018;November;46;2018-11-13 00:00;36;210;206;416
2018;November;46;2018-11-13 00:00;37;176;195;371
2018;November;46;2018-11-13 00:00;38;243;209;452
2018;November;46;2018-11-13 00:00;39;210;182;392
2018;November;46;2018-11-13 00:00;40;202;212;414
2018;November;46;2018-11-13 00:00;41;196;210;406
2018;November;46;2018-11-13 00:00;42;224;220;444
2018;November;46;2018-11-13 00:00;43;222;245;467
2018;November;46;2018-11-13 00:00;44;232;277;509
2018;November;46;2018-11-13 00:00;45;211;221;432
2018;November;46;2018-11-13 00:00;46;223;257;480
2018;November;46;2018-11-13 00:00;47;216;221;437
2018;November;46;2018-11-13 00:00;48;208;225;433
2018;November;46;2018-11-13 00:00;49;194;197;391
2018;November;46;2018-11-13 00:00;50;208;222;430
2018;November;46;2018-11-13 00:00;51;238;228;466
2018;November;46;2018-11-13 00:00;52;188;221;409
2018;November;46;2018-11-13 00:00;53;197;218;415
2018;November;46;2018-11-13 00:00;54;188;219;407
2018;November;46;2018-11-13 00:00;55;180;212;392
2018;November;46;2018-11-13 00:00;56;186;184;370
2018;November;46;2018-11-13 00:00;57;149;168;317
2018;November;46;2018-11-13 00:00;58;155;154;309
2018;November;46;2018-11-13 00:00;59;154;162;316
2018;November;46;2018-11-13 00:00;60;147;156;303
2018;November;46;2018-11-13 00:00;61;148;152;300
2018;November;46;2018-11-13 00:00;62;151;157;308
2018;November;46;2018-11-13 00:00;63;132;117;249
2018;November;46;2018-11-13 00:00;64;132;138;270
2018;November;46;2018-11-13 00:00;65;146;135;281
2018;November;46;2018-11-13 00:00;66;139;150;289
2018;November;46;2018-11-13 00:00;67;143;135;278
2018;November;46;2018-11-13 00:00;68;142;156;298
2018;November;46;2018-11-13 00:00;69;147;160;307
2018;November;46;2018-11-13 00:00;70;174;162;336
2018;November;46;2018-11-13 00:00;71;160;154;314
2018;November;46;2018-11-13 00:00;72;181;146;327
2018;November;46;2018-11-13 00:00;73;181;171;352
2018;November;46;2018-11-13 00:00;74;151;158;309
2018;November;46;2018-11-13 00:00;75;152;163;315
2018;November;46;2018-11-13 00:00;76;137;132;269
2018;November;46;2018-11-13 00:00;77;106;100;206
2018;November;46;2018-11-13 00:00;78;82;123;205
2018;November;46;2018-11-13 00:00;79;85;86;171
2018;November;46;2018-11-13 00:00;80;92;77;169
2018;November;46;2018-11-13 00:00;81;78;67;145
2018;November;46;2018-11-13 00:00;82;90;64;154
2018;November;46;2018-11-13 00:00;83;56;62;118
2018;November;46;2018-11-13 00:00;84;62;43;105
2018;November;46;2018-11-13 00:00;85;53;42;95
2018;November;46;2018-11-13 00:00;86;31;35;66
2018;November;46;2018-11-13 00:00;87;42;28;70
2018;November;46;2018-11-13 00:00;88;39;23;62
2018;November;46;2018-11-13 00:00;89;34;23;57
2018;November;46;2018-11-13 00:00;90;24;14;38
2018;November;46;2018-11-13 00:00;91;29;9;38
2018;November;46;2018-11-13 00:00;92;18;9;27
2018;November;46;2018-11-13 00:00;93;18;6;24
2018;November;46;2018-11-13 00:00;94;13;6;19
2018;November;46;2018-11-13 00:00;95;6;5;11
2018;November;46;2018-11-13 00:00;96;11;1;12
2018;November;46;2018-11-13 00:00;97;3;3;6
2018;November;46;2018-11-13 00:00;98;2;2;4
2018;November;46;2018-11-13 00:00;99;0;1;1
2018;November;46;2018-11-13 00:00;100;1;0;1
2018;November;46;2018-11-13 00:00;106;1;0;1
2018;November;47;2018-11-20 00:00;0;164;192;356
2018;November;47;2018-11-20 00:00;1;209;203;412
2018;November;47;2018-11-20 00:00;2;184;213;397
2018;November;47;2018-11-20 00:00;3;195;212;407
2018;November;47;2018-11-20 00:00;4;185;234;419
2018;November;47;2018-11-20 00:00;5;212;228;440
2018;November;47;2018-11-20 00:00;6;196;199;395
2018;November;47;2018-11-20 00:00;7;225;237;462
2018;November;47;2018-11-20 00:00;8;227;239;466
2018;November;47;2018-11-20 00:00;9;214;221;435
2018;November;47;2018-11-20 00:00;10;206;203;409
2018;November;47;2018-11-20 00:00;11;188;208;396
2018;November;47;2018-11-20 00:00;12;223;202;425
2018;November;47;2018-11-20 00:00;13;189;213;402
2018;November;47;2018-11-20 00:00;14;186;206;392
2018;November;47;2018-11-20 00:00;15;176;184;360
2018;November;47;2018-11-20 00:00;16;183;222;405
2018;November;47;2018-11-20 00:00;17;144;184;328
2018;November;47;2018-11-20 00:00;18;176;198;374
2018;November;47;2018-11-20 00:00;19;173;189;362
2018;November;47;2018-11-20 00:00;20;146;175;321
2018;November;47;2018-11-20 00:00;21;142;196;338
2018;November;47;2018-11-20 00:00;22;147;171;318
2018;November;47;2018-11-20 00:00;23;148;178;326
2018;November;47;2018-11-20 00:00;24;176;177;353
2018;November;47;2018-11-20 00:00;25;174;209;383
2018;November;47;2018-11-20 00:00;26;182;185;367
2018;November;47;2018-11-20 00:00;27;185;235;420
2018;November;47;2018-11-20 00:00;28;199;218;417
2018;November;47;2018-11-20 00:00;29;181;199;380
2018;November;47;2018-11-20 00:00;30;193;192;385
2018;November;47;2018-11-20 00:00;31;209;200;409
2018;November;47;2018-11-20 00:00;32;182;185;367
2018;November;47;2018-11-20 00:00;33;200;221;421
2018;November;47;2018-11-20 00:00;34;196;205;401
2018;November;47;2018-11-20 00:00;35;220;188;408
2018;November;47;2018-11-20 00:00;36;210;206;416
2018;November;47;2018-11-20 00:00;37;176;195;371
2018;November;47;2018-11-20 00:00;38;243;209;452
2018;November;47;2018-11-20 00:00;39;209;182;391
2018;November;47;2018-11-20 00:00;40;202;213;415
2018;November;47;2018-11-20 00:00;41;197;212;409
2018;November;47;2018-11-20 00:00;42;224;221;445
2018;November;47;2018-11-20 00:00;43;222;245;467
2018;November;47;2018-11-20 00:00;44;232;277;509
2018;November;47;2018-11-20 00:00;45;211;220;431
2018;November;47;2018-11-20 00:00;46;223;257;480
2018;November;47;2018-11-20 00:00;47;217;222;439
2018;November;47;2018-11-20 00:00;48;208;225;433
2018;November;47;2018-11-20 00:00;49;194;198;392
2018;November;47;2018-11-20 00:00;50;208;221;429
2018;November;47;2018-11-20 00:00;51;238;228;466
2018;November;47;2018-11-20 00:00;52;188;221;409
2018;November;47;2018-11-20 00:00;53;197;218;415
2018;November;47;2018-11-20 00:00;54;188;219;407
2018;November;47;2018-11-20 00:00;55;180;212;392
2018;November;47;2018-11-20 00:00;56;186;184;370
2018;November;47;2018-11-20 00:00;57;149;168;317
2018;November;47;2018-11-20 00:00;58;155;154;309
2018;November;47;2018-11-20 00:00;59;154;162;316
2018;November;47;2018-11-20 00:00;60;147;156;303
2018;November;47;2018-11-20 00:00;61;148;152;300
2018;November;47;2018-11-20 00:00;62;151;157;308
2018;November;47;2018-11-20 00:00;63;132;117;249
2018;November;47;2018-11-20 00:00;64;132;138;270
2018;November;47;2018-11-20 00:00;65;146;135;281
2018;November;47;2018-11-20 00:00;66;139;150;289
2018;November;47;2018-11-20 00:00;67;143;135;278
2018;November;47;2018-11-20 00:00;68;142;156;298
2018;November;47;2018-11-20 00:00;69;147;160;307
2018;November;47;2018-11-20 00:00;70;174;162;336
2018;November;47;2018-11-20 00:00;71;160;155;315
2018;November;47;2018-11-20 00:00;72;181;146;327
2018;November;47;2018-11-20 00:00;73;181;171;352
2018;November;47;2018-11-20 00:00;74;151;158;309
2018;November;47;2018-11-20 00:00;75;152;163;315
2018;November;47;2018-11-20 00:00;76;137;132;269
2018;November;47;2018-11-20 00:00;77;105;100;205
2018;November;47;2018-11-20 00:00;78;82;123;205
2018;November;47;2018-11-20 00:00;79;85;86;171
2018;November;47;2018-11-20 00:00;80;92;77;169
2018;November;47;2018-11-20 00:00;81;78;67;145
2018;November;47;2018-11-20 00:00;82;90;64;154
2018;November;47;2018-11-20 00:00;83;56;62;118
2018;November;47;2018-11-20 00:00;84;62;43;105
2018;November;47;2018-11-20 00:00;85;53;42;95
2018;November;47;2018-11-20 00:00;86;31;35;66
2018;November;47;2018-11-20 00:00;87;42;28;70
2018;November;47;2018-11-20 00:00;88;39;23;62
2018;November;47;2018-11-20 00:00;89;34;23;57
2018;November;47;2018-11-20 00:00;90;24;14;38
2018;November;47;2018-11-20 00:00;91;29;9;38
2018;November;47;2018-11-20 00:00;92;18;9;27
2018;November;47;2018-11-20 00:00;93;18;6;24
2018;November;47;2018-11-20 00:00;94;13;6;19
2018;November;47;2018-11-20 00:00;95;6;5;11
2018;November;47;2018-11-20 00:00;96;11;1;12
2018;November;47;2018-11-20 00:00;97;3;3;6
2018;November;47;2018-11-20 00:00;98;2;2;4
2018;November;47;2018-11-20 00:00;99;0;1;1
2018;November;47;2018-11-20 00:00;106;1;0;1
2018;November;48;2018-11-27 00:00;0;170;195;365
2018;November;48;2018-11-27 00:00;1;209;202;411
2018;November;48;2018-11-27 00:00;2;184;213;397
2018;November;48;2018-11-27 00:00;3;195;212;407
2018;November;48;2018-11-27 00:00;4;185;234;419
2018;November;48;2018-11-27 00:00;5;212;228;440
2018;November;48;2018-11-27 00:00;6;196;200;396
2018;November;48;2018-11-27 00:00;7;225;236;461
2018;November;48;2018-11-27 00:00;8;227;238;465
2018;November;48;2018-11-27 00:00;9;214;221;435
2018;November;48;2018-11-27 00:00;10;206;203;409
2018;November;48;2018-11-27 00:00;11;188;208;396
2018;November;48;2018-11-27 00:00;12;223;202;425
2018;November;48;2018-11-27 00:00;13;189;213;402
2018;November;48;2018-11-27 00:00;14;186;206;392
2018;November;48;2018-11-27 00:00;15;176;184;360
2018;November;48;2018-11-27 00:00;16;183;222;405
2018;November;48;2018-11-27 00:00;17;144;185;329
2018;November;48;2018-11-27 00:00;18;176;198;374
2018;November;48;2018-11-27 00:00;19;173;189;362
2018;November;48;2018-11-27 00:00;20;145;176;321
2018;November;48;2018-11-27 00:00;21;142;196;338
2018;November;48;2018-11-27 00:00;22;147;170;317
2018;November;48;2018-11-27 00:00;23;148;179;327
2018;November;48;2018-11-27 00:00;24;176;179;355
2018;November;48;2018-11-27 00:00;25;173;207;380
2018;November;48;2018-11-27 00:00;26;184;185;369
2018;November;48;2018-11-27 00:00;27;185;236;421
2018;November;48;2018-11-27 00:00;28;199;218;417
2018;November;48;2018-11-27 00:00;29;180;198;378
2018;November;48;2018-11-27 00:00;30;193;192;385
2018;November;48;2018-11-27 00:00;31;209;202;411
2018;November;48;2018-11-27 00:00;32;182;185;367
2018;November;48;2018-11-27 00:00;33;200;221;421
2018;November;48;2018-11-27 00:00;34;195;205;400
2018;November;48;2018-11-27 00:00;35;220;186;406
2018;November;48;2018-11-27 00:00;36;211;206;417
2018;November;48;2018-11-27 00:00;37;176;195;371
2018;November;48;2018-11-27 00:00;38;242;209;451
2018;November;48;2018-11-27 00:00;39;210;182;392
2018;November;48;2018-11-27 00:00;40;202;212;414
2018;November;48;2018-11-27 00:00;41;197;212;409
2018;November;48;2018-11-27 00:00;42;224;221;445
2018;November;48;2018-11-27 00:00;43;223;245;468
2018;November;48;2018-11-27 00:00;44;232;277;509
2018;November;48;2018-11-27 00:00;45;211;220;431
2018;November;48;2018-11-27 00:00;46;224;257;481
2018;November;48;2018-11-27 00:00;47;217;222;439
2018;November;48;2018-11-27 00:00;48;208;225;433
2018;November;48;2018-11-27 00:00;49;194;199;393
2018;November;48;2018-11-27 00:00;50;208;221;429
2018;November;48;2018-11-27 00:00;51;238;228;466
2018;November;48;2018-11-27 00:00;52;188;221;409
2018;November;48;2018-11-27 00:00;53;197;219;416
2018;November;48;2018-11-27 00:00;54;188;219;407
2018;November;48;2018-11-27 00:00;55;180;212;392
2018;November;48;2018-11-27 00:00;56;186;184;370
2018;November;48;2018-11-27 00:00;57;149;168;317
2018;November;48;2018-11-27 00:00;58;155;154;309
2018;November;48;2018-11-27 00:00;59;153;162;315
2018;November;48;2018-11-27 00:00;60;147;156;303
2018;November;48;2018-11-27 00:00;61;148;152;300
2018;November;48;2018-11-27 00:00;62;151;157;308
2018;November;48;2018-11-27 00:00;63;132;116;248
2018;November;48;2018-11-27 00:00;64;132;138;270
2018;November;48;2018-11-27 00:00;65;146;135;281
2018;November;48;2018-11-27 00:00;66;139;150;289
2018;November;48;2018-11-27 00:00;67;143;134;277
2018;November;48;2018-11-27 00:00;68;142;156;298
2018;November;48;2018-11-27 00:00;69;147;160;307
2018;November;48;2018-11-27 00:00;70;174;162;336
2018;November;48;2018-11-27 00:00;71;160;154;314
2018;November;48;2018-11-27 00:00;72;181;147;328
2018;November;48;2018-11-27 00:00;73;181;171;352
2018;November;48;2018-11-27 00:00;74;151;158;309
2018;November;48;2018-11-27 00:00;75;152;163;315
2018;November;48;2018-11-27 00:00;76;137;132;269
2018;November;48;2018-11-27 00:00;77;105;100;205
2018;November;48;2018-11-27 00:00;78;82;123;205
2018;November;48;2018-11-27 00:00;79;85;86;171
2018;November;48;2018-11-27 00:00;80;92;77;169
2018;November;48;2018-11-27 00:00;81;78;67;145
2018;November;48;2018-11-27 00:00;82;90;64;154
2018;November;48;2018-11-27 00:00;83;56;62;118
2018;November;48;2018-11-27 00:00;84;62;42;104
2018;November;48;2018-11-27 00:00;85;52;42;94
2018;November;48;2018-11-27 00:00;86;31;35;66
2018;November;48;2018-11-27 00:00;87;41;28;69
2018;November;48;2018-11-27 00:00;88;39;23;62
2018;November;48;2018-11-27 00:00;89;33;23;56
2018;November;48;2018-11-27 00:00;90;24;14;38
2018;November;48;2018-11-27 00:00;91;29;9;38
2018;November;48;2018-11-27 00:00;92;18;9;27
2018;November;48;2018-11-27 00:00;93;18;6;24
2018;November;48;2018-11-27 00:00;94;13;6;19
2018;November;48;2018-11-27 00:00;95;6;5;11
2018;November;48;2018-11-27 00:00;96;11;1;12
2018;November;48;2018-11-27 00:00;97;3;3;6
2018;November;48;2018-11-27 00:00;98;2;2;4
2018;November;48;2018-11-27 00:00;99;0;1;1
2018;November;48;2018-11-27 00:00;106;1;0;1
2018;December;49;2018-12-04 00:00;0;173;200;373
2018;December;49;2018-12-04 00:00;1;208;202;410
2018;December;49;2018-12-04 00:00;2;184;214;398
2018;December;49;2018-12-04 00:00;3;195;213;408
2018;December;49;2018-12-04 00:00;4;185;233;418
2018;December;49;2018-12-04 00:00;5;211;228;439
2018;December;49;2018-12-04 00:00;6;194;201;395
2018;December;49;2018-12-04 00:00;7;225;237;462
2018;December;49;2018-12-04 00:00;8;227;237;464
2018;December;49;2018-12-04 00:00;9;213;221;434
2018;December;49;2018-12-04 00:00;10;206;202;408
2018;December;49;2018-12-04 00:00;11;188;208;396
2018;December;49;2018-12-04 00:00;12;224;202;426
2018;December;49;2018-12-04 00:00;13;189;213;402
2018;December;49;2018-12-04 00:00;14;187;206;393
2018;December;49;2018-12-04 00:00;15;176;184;360
2018;December;49;2018-12-04 00:00;16;183;223;406
2018;December;49;2018-12-04 00:00;17;144;184;328
2018;December;49;2018-12-04 00:00;18;177;198;375
2018;December;49;2018-12-04 00:00;19;174;190;364
2018;December;49;2018-12-04 00:00;20;145;175;320
2018;December;49;2018-12-04 00:00;21;142;195;337
2018;December;49;2018-12-04 00:00;22;147;171;318
2018;December;49;2018-12-04 00:00;23;150;179;329
2018;December;49;2018-12-04 00:00;24;176;180;356
2018;December;49;2018-12-04 00:00;25;173;207;380
2018;December;49;2018-12-04 00:00;26;185;185;370
2018;December;49;2018-12-04 00:00;27;184;235;419
2018;December;49;2018-12-04 00:00;28;197;217;414
2018;December;49;2018-12-04 00:00;29;182;198;380
2018;December;49;2018-12-04 00:00;30;194;193;387
2018;December;49;2018-12-04 00:00;31;212;203;415
2018;December;49;2018-12-04 00:00;32;182;183;365
2018;December;49;2018-12-04 00:00;33;197;221;418
2018;December;49;2018-12-04 00:00;34;195;203;398
2018;December;49;2018-12-04 00:00;35;220;188;408
2018;December;49;2018-12-04 00:00;36;212;206;418
2018;December;49;2018-12-04 00:00;37;175;195;370
2018;December;49;2018-12-04 00:00;38;242;208;450
2018;December;49;2018-12-04 00:00;39;210;182;392
2018;December;49;2018-12-04 00:00;40;202;213;415
2018;December;49;2018-12-04 00:00;41;197;212;409
2018;December;49;2018-12-04 00:00;42;224;221;445
2018;December;49;2018-12-04 00:00;43;223;245;468
2018;December;49;2018-12-04 00:00;44;231;277;508
2018;December;49;2018-12-04 00:00;45;211;219;430
2018;December;49;2018-12-04 00:00;46;224;256;480
2018;December;49;2018-12-04 00:00;47;217;223;440
2018;December;49;2018-12-04 00:00;48;208;225;433
2018;December;49;2018-12-04 00:00;49;194;199;393
2018;December;49;2018-12-04 00:00;50;207;222;429
2018;December;49;2018-12-04 00:00;51;237;228;465
2018;December;49;2018-12-04 00:00;52;188;221;409
2018;December;49;2018-12-04 00:00;53;198;219;417
2018;December;49;2018-12-04 00:00;54;188;218;406
2018;December;49;2018-12-04 00:00;55;180;212;392
2018;December;49;2018-12-04 00:00;56;186;184;370
2018;December;49;2018-12-04 00:00;57;149;166;315
2018;December;49;2018-12-04 00:00;58;155;154;309
2018;December;49;2018-12-04 00:00;59;153;162;315
2018;December;49;2018-12-04 00:00;60;147;156;303
2018;December;49;2018-12-04 00:00;61;148;152;300
2018;December;49;2018-12-04 00:00;62;151;157;308
2018;December;49;2018-12-04 00:00;63;132;116;248
2018;December;49;2018-12-04 00:00;64;132;139;271
2018;December;49;2018-12-04 00:00;65;146;135;281
2018;December;49;2018-12-04 00:00;66;140;150;290
2018;December;49;2018-12-04 00:00;67;143;133;276
2018;December;49;2018-12-04 00:00;68;142;156;298
2018;December;49;2018-12-04 00:00;69;147;160;307
2018;December;49;2018-12-04 00:00;70;174;162;336
2018;December;49;2018-12-04 00:00;71;160;154;314
2018;December;49;2018-12-04 00:00;72;181;147;328
2018;December;49;2018-12-04 00:00;73;181;171;352
2018;December;49;2018-12-04 00:00;74;151;158;309
2018;December;49;2018-12-04 00:00;75;152;161;313
2018;December;49;2018-12-04 00:00;76;136;132;268
2018;December;49;2018-12-04 00:00;77;105;100;205
2018;December;49;2018-12-04 00:00;78;82;123;205
2018;December;49;2018-12-04 00:00;79;85;86;171
2018;December;49;2018-12-04 00:00;80;92;77;169
2018;December;49;2018-12-04 00:00;81;78;68;146
2018;December;49;2018-12-04 00:00;82;90;64;154
2018;December;49;2018-12-04 00:00;83;56;62;118
2018;December;49;2018-12-04 00:00;84;61;42;103
2018;December;49;2018-12-04 00:00;85;52;42;94
2018;December;49;2018-12-04 00:00;86;31;35;66
2018;December;49;2018-12-04 00:00;87;41;28;69
2018;December;49;2018-12-04 00:00;88;39;23;62
2018;December;49;2018-12-04 00:00;89;33;23;56
2018;December;49;2018-12-04 00:00;90;23;14;37
2018;December;49;2018-12-04 00:00;91;29;8;37
2018;December;49;2018-12-04 00:00;92;18;9;27
2018;December;49;2018-12-04 00:00;93;18;6;24
2018;December;49;2018-12-04 00:00;94;13;5;18
2018;December;49;2018-12-04 00:00;95;6;5;11
2018;December;49;2018-12-04 00:00;96;11;1;12
2018;December;49;2018-12-04 00:00;97;3;3;6
2018;December;49;2018-12-04 00:00;98;2;2;4
2018;December;49;2018-12-04 00:00;99;0;1;1
2018;December;49;2018-12-04 00:00;106;1;0;1
2018;December;50;2018-12-11 00:00;0;178;205;383
2018;December;50;2018-12-11 00:00;1;208;202;410
2018;December;50;2018-12-11 00:00;2;185;214;399
2018;December;50;2018-12-11 00:00;3;195;214;409
2018;December;50;2018-12-11 00:00;4;185;233;418
2018;December;50;2018-12-11 00:00;5;212;228;440
2018;December;50;2018-12-11 00:00;6;194;200;394
2018;December;50;2018-12-11 00:00;7;225;237;462
2018;December;50;2018-12-11 00:00;8;227;237;464
2018;December;50;2018-12-11 00:00;9;213;222;435
2018;December;50;2018-12-11 00:00;10;206;203;409
2018;December;50;2018-12-11 00:00;11;187;208;395
2018;December;50;2018-12-11 00:00;12;225;203;428
2018;December;50;2018-12-11 00:00;13;190;213;403
2018;December;50;2018-12-11 00:00;14;187;206;393
2018;December;50;2018-12-11 00:00;15;176;184;360
2018;December;50;2018-12-11 00:00;16;183;223;406
2018;December;50;2018-12-11 00:00;17;144;184;328
2018;December;50;2018-12-11 00:00;18;178;198;376
2018;December;50;2018-12-11 00:00;19;174;190;364
2018;December;50;2018-12-11 00:00;20;143;175;318
2018;December;50;2018-12-11 00:00;21;141;193;334
2018;December;50;2018-12-11 00:00;22;147;172;319
2018;December;50;2018-12-11 00:00;23;150;182;332
2018;December;50;2018-12-11 00:00;24;176;179;355
2018;December;50;2018-12-11 00:00;25;172;207;379
2018;December;50;2018-12-11 00:00;26;186;185;371
2018;December;50;2018-12-11 00:00;27;184;236;420
2018;December;50;2018-12-11 00:00;28;197;218;415
2018;December;50;2018-12-11 00:00;29;182;196;378
2018;December;50;2018-12-11 00:00;30;195;194;389
2018;December;50;2018-12-11 00:00;31;212;202;414
2018;December;50;2018-12-11 00:00;32;182;183;365
2018;December;50;2018-12-11 00:00;33;197;221;418
2018;December;50;2018-12-11 00:00;34;196;203;399
2018;December;50;2018-12-11 00:00;35;221;188;409
2018;December;50;2018-12-11 00:00;36;212;206;418
2018;December;50;2018-12-11 00:00;37;175;196;371
2018;December;50;2018-12-11 00:00;38;242;209;451
2018;December;50;2018-12-11 00:00;39;211;182;393
2018;December;50;2018-12-11 00:00;40;201;213;414
2018;December;50;2018-12-11 00:00;41;197;213;410
2018;December;50;2018-12-11 00:00;42;225;221;446
2018;December;50;2018-12-11 00:00;43;223;245;468
2018;December;50;2018-12-11 00:00;44;231;277;508
2018;December;50;2018-12-11 00:00;45;211;220;431
2018;December;50;2018-12-11 00:00;46;223;255;478
2018;December;50;2018-12-11 00:00;47;217;223;440
2018;December;50;2018-12-11 00:00;48;208;225;433
2018;December;50;2018-12-11 00:00;49;194;200;394
2018;December;50;2018-12-11 00:00;50;208;223;431
2018;December;50;2018-12-11 00:00;51;237;228;465
2018;December;50;2018-12-11 00:00;52;187;221;408
2018;December;50;2018-12-11 00:00;53;198;219;417
2018;December;50;2018-12-11 00:00;54;188;218;406
2018;December;50;2018-12-11 00:00;55;180;212;392
2018;December;50;2018-12-11 00:00;56;186;184;370
2018;December;50;2018-12-11 00:00;57;149;166;315
2018;December;50;2018-12-11 00:00;58;155;154;309
2018;December;50;2018-12-11 00:00;59;153;162;315
2018;December;50;2018-12-11 00:00;60;148;156;304
2018;December;50;2018-12-11 00:00;61;148;152;300
2018;December;50;2018-12-11 00:00;62;150;157;307
2018;December;50;2018-12-11 00:00;63;132;116;248
2018;December;50;2018-12-11 00:00;64;132;139;271
2018;December;50;2018-12-11 00:00;65;146;135;281
2018;December;50;2018-12-11 00:00;66;140;150;290
2018;December;50;2018-12-11 00:00;67;143;132;275
2018;December;50;2018-12-11 00:00;68;142;156;298
2018;December;50;2018-12-11 00:00;69;147;160;307
2018;December;50;2018-12-11 00:00;70;174;162;336
2018;December;50;2018-12-11 00:00;71;160;154;314
2018;December;50;2018-12-11 00:00;72;181;147;328
2018;December;50;2018-12-11 00:00;73;181;171;352
2018;December;50;2018-12-11 00:00;74;151;157;308
2018;December;50;2018-12-11 00:00;75;151;161;312
2018;December;50;2018-12-11 00:00;76;135;132;267
2018;December;50;2018-12-11 00:00;77;105;100;205
2018;December;50;2018-12-11 00:00;78;82;123;205
2018;December;50;2018-12-11 00:00;79;85;86;171
2018;December;50;2018-12-11 00:00;80;92;77;169
2018;December;50;2018-12-11 00:00;81;78;68;146
2018;December;50;2018-12-11 00:00;82;90;64;154
2018;December;50;2018-12-11 00:00;83;56;62;118
2018;December;50;2018-12-11 00:00;84;61;42;103
2018;December;50;2018-12-11 00:00;85;52;42;94
2018;December;50;2018-12-11 00:00;86;31;35;66
2018;December;50;2018-12-11 00:00;87;41;28;69
2018;December;50;2018-12-11 00:00;88;39;23;62
2018;December;50;2018-12-11 00:00;89;33;23;56
2018;December;50;2018-12-11 00:00;90;23;14;37
2018;December;50;2018-12-11 00:00;91;29;8;37
2018;December;50;2018-12-11 00:00;92;18;9;27
2018;December;50;2018-12-11 00:00;93;18;6;24
2018;December;50;2018-12-11 00:00;94;13;5;18
2018;December;50;2018-12-11 00:00;95;6;5;11
2018;December;50;2018-12-11 00:00;96;10;1;11
2018;December;50;2018-12-11 00:00;97;3;3;6
2018;December;50;2018-12-11 00:00;98;2;2;4
2018;December;50;2018-12-11 00:00;99;0;1;1
2018;December;50;2018-12-11 00:00;106;1;0;1
2018;December;51;2018-12-18 00:00;0;185;208;393
2018;December;51;2018-12-18 00:00;1;209;204;413
2018;December;51;2018-12-18 00:00;2;185;214;399
2018;December;51;2018-12-18 00:00;3;195;214;409
2018;December;51;2018-12-18 00:00;4;185;233;418
2018;December;51;2018-12-18 00:00;5;212;230;442
2018;December;51;2018-12-18 00:00;6;195;200;395
2018;December;51;2018-12-18 00:00;7;225;237;462
2018;December;51;2018-12-18 00:00;8;227;239;466
2018;December;51;2018-12-18 00:00;9;214;224;438
2018;December;51;2018-12-18 00:00;10;207;203;410
2018;December;51;2018-12-18 00:00;11;187;208;395
2018;December;51;2018-12-18 00:00;12;225;203;428
2018;December;51;2018-12-18 00:00;13;191;213;404
2018;December;51;2018-12-18 00:00;14;188;206;394
2018;December;51;2018-12-18 00:00;15;176;184;360
2018;December;51;2018-12-18 00:00;16;183;224;407
2018;December;51;2018-12-18 00:00;17;144;184;328
2018;December;51;2018-12-18 00:00;18;178;198;376
2018;December;51;2018-12-18 00:00;19;175;192;367
2018;December;51;2018-12-18 00:00;20;143;177;320
2018;December;51;2018-12-18 00:00;21;142;193;335
2018;December;51;2018-12-18 00:00;22;144;170;314
2018;December;51;2018-12-18 00:00;23;151;183;334
2018;December;51;2018-12-18 00:00;24;177;178;355
2018;December;51;2018-12-18 00:00;25;174;208;382
2018;December;51;2018-12-18 00:00;26;185;184;369
2018;December;51;2018-12-18 00:00;27;184;236;420
2018;December;51;2018-12-18 00:00;28;197;218;415
2018;December;51;2018-12-18 00:00;29;183;199;382
2018;December;51;2018-12-18 00:00;30;195;196;391
2018;December;51;2018-12-18 00:00;31;211;201;412
2018;December;51;2018-12-18 00:00;32;183;184;367
2018;December;51;2018-12-18 00:00;33;198;221;419
2018;December;51;2018-12-18 00:00;34;196;204;400
2018;December;51;2018-12-18 00:00;35;221;188;409
2018;December;51;2018-12-18 00:00;36;213;207;420
2018;December;51;2018-12-18 00:00;37;173;196;369
2018;December;51;2018-12-18 00:00;38;242;209;451
2018;December;51;2018-12-18 00:00;39;211;182;393
2018;December;51;2018-12-18 00:00;40;201;212;413
2018;December;51;2018-12-18 00:00;41;197;213;410
2018;December;51;2018-12-18 00:00;42;225;221;446
2018;December;51;2018-12-18 00:00;43;223;245;468
2018;December;51;2018-12-18 00:00;44;231;278;509
2018;December;51;2018-12-18 00:00;45;211;220;431
2018;December;51;2018-12-18 00:00;46;222;254;476
2018;December;51;2018-12-18 00:00;47;218;224;442
2018;December;51;2018-12-18 00:00;48;208;224;432
2018;December;51;2018-12-18 00:00;49;194;200;394
2018;December;51;2018-12-18 00:00;50;208;223;431
2018;December;51;2018-12-18 00:00;51;237;228;465
2018;December;51;2018-12-18 00:00;52;187;221;408
2018;December;51;2018-12-18 00:00;53;198;219;417
2018;December;51;2018-12-18 00:00;54;188;218;406
2018;December;51;2018-12-18 00:00;55;180;214;394
2018;December;51;2018-12-18 00:00;56;186;184;370
2018;December;51;2018-12-18 00:00;57;149;166;315
2018;December;51;2018-12-18 00:00;58;155;154;309
2018;December;51;2018-12-18 00:00;59;153;162;315
2018;December;51;2018-12-18 00:00;60;148;156;304
2018;December;51;2018-12-18 00:00;61;148;152;300
2018;December;51;2018-12-18 00:00;62;149;157;306
2018;December;51;2018-12-18 00:00;63;132;116;248
2018;December;51;2018-12-18 00:00;64;132;139;271
2018;December;51;2018-12-18 00:00;65;146;135;281
2018;December;51;2018-12-18 00:00;66;140;150;290
2018;December;51;2018-12-18 00:00;67;142;132;274
2018;December;51;2018-12-18 00:00;68;142;155;297
2018;December;51;2018-12-18 00:00;69;147;160;307
2018;December;51;2018-12-18 00:00;70;174;162;336
2018;December;51;2018-12-18 00:00;71;160;154;314
2018;December;51;2018-12-18 00:00;72;181;147;328
2018;December;51;2018-12-18 00:00;73;181;171;352
2018;December;51;2018-12-18 00:00;74;151;157;308
2018;December;51;2018-12-18 00:00;75;151;161;312
2018;December;51;2018-12-18 00:00;76;135;132;267
2018;December;51;2018-12-18 00:00;77;105;100;205
2018;December;51;2018-12-18 00:00;78;82;123;205
2018;December;51;2018-12-18 00:00;79;85;86;171
2018;December;51;2018-12-18 00:00;80;93;77;170
2018;December;51;2018-12-18 00:00;81;78;68;146
2018;December;51;2018-12-18 00:00;82;90;64;154
2018;December;51;2018-12-18 00:00;83;56;62;118
2018;December;51;2018-12-18 00:00;84;61;42;103
2018;December;51;2018-12-18 00:00;85;52;42;94
2018;December;51;2018-12-18 00:00;86;31;35;66
2018;December;51;2018-12-18 00:00;87;41;28;69
2018;December;51;2018-12-18 00:00;88;39;23;62
2018;December;51;2018-12-18 00:00;89;33;23;56
2018;December;51;2018-12-18 00:00;90;23;14;37
2018;December;51;2018-12-18 00:00;91;29;8;37
2018;December;51;2018-12-18 00:00;92;18;9;27
2018;December;51;2018-12-18 00:00;93;18;6;24
2018;December;51;2018-12-18 00:00;94;13;5;18
2018;December;51;2018-12-18 00:00;95;6;5;11
2018;December;51;2018-12-18 00:00;96;10;1;11
2018;December;51;2018-12-18 00:00;97;3;3;6
2018;December;51;2018-12-18 00:00;98;2;2;4
2018;December;51;2018-12-18 00:00;99;0;1;1
2018;December;51;2018-12-18 00:00;106;1;0;1
2019;January;2;2019-01-08 00:00;0;2;2;4
2019;January;2;2019-01-08 00:00;1;191;214;405
2019;January;2;2019-01-08 00:00;2;209;204;413
2019;January;2;2019-01-08 00:00;3;186;213;399
2019;January;2;2019-01-08 00:00;4;194;214;408
2019;January;2;2019-01-08 00:00;5;184;233;417
2019;January;2;2019-01-08 00:00;6;212;231;443
2019;January;2;2019-01-08 00:00;7;195;200;395
2019;January;2;2019-01-08 00:00;8;226;238;464
2019;January;2;2019-01-08 00:00;9;227;238;465
2019;January;2;2019-01-08 00:00;10;214;224;438
2019;January;2;2019-01-08 00:00;11;208;203;411
2019;January;2;2019-01-08 00:00;12;187;208;395
2019;January;2;2019-01-08 00:00;13;225;203;428
2019;January;2;2019-01-08 00:00;14;191;213;404
2019;January;2;2019-01-08 00:00;15;189;204;393
2019;January;2;2019-01-08 00:00;16;177;185;362
2019;January;2;2019-01-08 00:00;17;182;224;406
2019;January;2;2019-01-08 00:00;18;145;184;329
2019;January;2;2019-01-08 00:00;19;178;197;375
2019;January;2;2019-01-08 00:00;20;174;192;366
2019;January;2;2019-01-08 00:00;21;146;175;321
2019;January;2;2019-01-08 00:00;22;143;193;336
2019;January;2;2019-01-08 00:00;23;142;171;313
2019;January;2;2019-01-08 00:00;24;152;181;333
2019;January;2;2019-01-08 00:00;25;176;178;354
2019;January;2;2019-01-08 00:00;26;177;208;385
2019;January;2;2019-01-08 00:00;27;184;185;369
2019;January;2;2019-01-08 00:00;28;184;237;421
2019;January;2;2019-01-08 00:00;29;198;220;418
2019;January;2;2019-01-08 00:00;30;183;201;384
2019;January;2;2019-01-08 00:00;31;197;198;395
2019;January;2;2019-01-08 00:00;32;211;201;412
2019;January;2;2019-01-08 00:00;33;183;185;368
2019;January;2;2019-01-08 00:00;34;194;219;413
2019;January;2;2019-01-08 00:00;35;198;205;403
2019;January;2;2019-01-08 00:00;36;221;188;409
2019;January;2;2019-01-08 00:00;37;215;207;422
2019;January;2;2019-01-08 00:00;38;174;196;370
2019;January;2;2019-01-08 00:00;39;242;211;453
2019;January;2;2019-01-08 00:00;40;213;184;397
2019;January;2;2019-01-08 00:00;41;201;212;413
2019;January;2;2019-01-08 00:00;42;198;216;414
2019;January;2;2019-01-08 00:00;43;226;220;446
2019;January;2;2019-01-08 00:00;44;223;243;466
2019;January;2;2019-01-08 00:00;45;230;278;508
2019;January;2;2019-01-08 00:00;46;210;220;430
2019;January;2;2019-01-08 00:00;47;222;256;478
2019;January;2;2019-01-08 00:00;48;218;225;443
2019;January;2;2019-01-08 00:00;49;207;224;431
2019;January;2;2019-01-08 00:00;50;193;200;393
2019;January;2;2019-01-08 00:00;51;208;222;430
2019;January;2;2019-01-08 00:00;52;236;229;465
2019;January;2;2019-01-08 00:00;53;186;221;407
2019;January;2;2019-01-08 00:00;54;198;220;418
2019;January;2;2019-01-08 00:00;55;188;218;406
2019;January;2;2019-01-08 00:00;56;178;214;392
2019;January;2;2019-01-08 00:00;57;186;183;369
2019;January;2;2019-01-08 00:00;58;149;166;315
2019;January;2;2019-01-08 00:00;59;155;155;310
2019;January;2;2019-01-08 00:00;60;152;162;314
2019;January;2;2019-01-08 00:00;61;147;156;303
2019;January;2;2019-01-08 00:00;62;148;151;299
2019;January;2;2019-01-08 00:00;63;150;157;307
2019;January;2;2019-01-08 00:00;64;132;115;247
2019;January;2;2019-01-08 00:00;65;132;139;271
2019;January;2;2019-01-08 00:00;66;146;135;281
2019;January;2;2019-01-08 00:00;67;140;150;290
2019;January;2;2019-01-08 00:00;68;142;131;273
2019;January;2;2019-01-08 00:00;69;142;155;297
2019;January;2;2019-01-08 00:00;70;147;161;308
2019;January;2;2019-01-08 00:00;71;173;161;334
2019;January;2;2019-01-08 00:00;72;159;153;312
2019;January;2;2019-01-08 00:00;73;181;146;327
2019;January;2;2019-01-08 00:00;74;180;171;351
2019;January;2;2019-01-08 00:00;75;151;157;308
2019;January;2;2019-01-08 00:00;76;151;160;311
2019;January;2;2019-01-08 00:00;77;135;132;267
2019;January;2;2019-01-08 00:00;78;106;99;205
2019;January;2;2019-01-08 00:00;79;82;122;204
2019;January;2;2019-01-08 00:00;80;85;86;171
2019;January;2;2019-01-08 00:00;81;92;77;169
2019;January;2;2019-01-08 00:00;82;78;68;146
2019;January;2;2019-01-08 00:00;83;90;64;154
2019;January;2;2019-01-08 00:00;84;56;62;118
2019;January;2;2019-01-08 00:00;85;61;42;103
2019;January;2;2019-01-08 00:00;86;51;42;93
2019;January;2;2019-01-08 00:00;87;31;35;66
2019;January;2;2019-01-08 00:00;88;41;27;68
2019;January;2;2019-01-08 00:00;89;39;23;62
2019;January;2;2019-01-08 00:00;90;33;23;56
2019;January;2;2019-01-08 00:00;91;23;14;37
2019;January;2;2019-01-08 00:00;92;28;8;36
2019;January;2;2019-01-08 00:00;93;18;9;27
2019;January;2;2019-01-08 00:00;94;18;6;24
2019;January;2;2019-01-08 00:00;95;13;4;17
2019;January;2;2019-01-08 00:00;96;6;4;10
2019;January;2;2019-01-08 00:00;97;10;1;11
2019;January;2;2019-01-08 00:00;98;3;3;6
2019;January;2;2019-01-08 00:00;99;2;2;4
2019;January;2;2019-01-08 00:00;100;0;1;1
2019;January;2;2019-01-08 00:00;107;1;0;1
2019;January;3;2019-01-15 00:00;0;5;6;11
2019;January;3;2019-01-15 00:00;1;191;215;406
2019;January;3;2019-01-15 00:00;2;210;204;414
2019;January;3;2019-01-15 00:00;3;186;213;399
2019;January;3;2019-01-15 00:00;4;194;214;408
2019;January;3;2019-01-15 00:00;5;184;234;418
2019;January;3;2019-01-15 00:00;6;211;232;443
2019;January;3;2019-01-15 00:00;7;195;200;395
2019;January;3;2019-01-15 00:00;8;225;237;462
2019;January;3;2019-01-15 00:00;9;227;236;463
2019;January;3;2019-01-15 00:00;10;214;225;439
2019;January;3;2019-01-15 00:00;11;207;203;410
2019;January;3;2019-01-15 00:00;12;188;208;396
2019;January;3;2019-01-15 00:00;13;225;204;429
2019;January;3;2019-01-15 00:00;14;191;213;404
2019;January;3;2019-01-15 00:00;15;190;204;394
2019;January;3;2019-01-15 00:00;16;177;188;365
2019;January;3;2019-01-15 00:00;17;181;224;405
2019;January;3;2019-01-15 00:00;18;145;184;329
2019;January;3;2019-01-15 00:00;19;177;198;375
2019;January;3;2019-01-15 00:00;20;175;192;367
2019;January;3;2019-01-15 00:00;21;146;175;321
2019;January;3;2019-01-15 00:00;22;142;191;333
2019;January;3;2019-01-15 00:00;23;143;171;314
2019;January;3;2019-01-15 00:00;24;153;181;334
2019;January;3;2019-01-15 00:00;25;177;177;354
2019;January;3;2019-01-15 00:00;26;177;208;385
2019;January;3;2019-01-15 00:00;27;183;185;368
2019;January;3;2019-01-15 00:00;28;183;236;419
2019;January;3;2019-01-15 00:00;29;198;221;419
2019;January;3;2019-01-15 00:00;30;183;201;384
2019;January;3;2019-01-15 00:00;31;197;198;395
2019;January;3;2019-01-15 00:00;32;211;201;412
2019;January;3;2019-01-15 00:00;33;182;186;368
2019;January;3;2019-01-15 00:00;34;195;218;413
2019;January;3;2019-01-15 00:00;35;200;205;405
2019;January;3;2019-01-15 00:00;36;220;187;407
2019;January;3;2019-01-15 00:00;37;215;208;423
2019;January;3;2019-01-15 00:00;38;174;196;370
2019;January;3;2019-01-15 00:00;39;242;210;452
2019;January;3;2019-01-15 00:00;40;213;184;397
2019;January;3;2019-01-15 00:00;41;201;213;414
2019;January;3;2019-01-15 00:00;42;198;216;414
2019;January;3;2019-01-15 00:00;43;226;220;446
2019;January;3;2019-01-15 00:00;44;223;243;466
2019;January;3;2019-01-15 00:00;45;230;278;508
2019;January;3;2019-01-15 00:00;46;210;220;430
2019;January;3;2019-01-15 00:00;47;222;256;478
2019;January;3;2019-01-15 00:00;48;218;226;444
2019;January;3;2019-01-15 00:00;49;207;224;431
2019;January;3;2019-01-15 00:00;50;193;200;393
2019;January;3;2019-01-15 00:00;51;208;223;431
2019;January;3;2019-01-15 00:00;52;236;230;466
2019;January;3;2019-01-15 00:00;53;186;221;407
2019;January;3;2019-01-15 00:00;54;198;219;417
2019;January;3;2019-01-15 00:00;55;187;217;404
2019;January;3;2019-01-15 00:00;56;178;214;392
2019;January;3;2019-01-15 00:00;57;186;183;369
2019;January;3;2019-01-15 00:00;58;149;166;315
2019;January;3;2019-01-15 00:00;59;155;155;310
2019;January;3;2019-01-15 00:00;60;152;162;314
2019;January;3;2019-01-15 00:00;61;147;156;303
2019;January;3;2019-01-15 00:00;62;148;151;299
2019;January;3;2019-01-15 00:00;63;150;157;307
2019;January;3;2019-01-15 00:00;64;132;115;247
2019;January;3;2019-01-15 00:00;65;132;139;271
2019;January;3;2019-01-15 00:00;66;146;135;281
2019;January;3;2019-01-15 00:00;67;140;150;290
2019;January;3;2019-01-15 00:00;68;142;131;273
2019;January;3;2019-01-15 00:00;69;142;155;297
2019;January;3;2019-01-15 00:00;70;147;161;308
2019;January;3;2019-01-15 00:00;71;172;161;333
2019;January;3;2019-01-15 00:00;72;159;153;312
2019;January;3;2019-01-15 00:00;73;181;146;327
2019;January;3;2019-01-15 00:00;74;180;171;351
2019;January;3;2019-01-15 00:00;75;151;157;308
2019;January;3;2019-01-15 00:00;76;151;161;312
2019;January;3;2019-01-15 00:00;77;135;131;266
2019;January;3;2019-01-15 00:00;78;106;99;205
2019;January;3;2019-01-15 00:00;79;82;122;204
2019;January;3;2019-01-15 00:00;80;85;86;171
2019;January;3;2019-01-15 00:00;81;92;77;169
2019;January;3;2019-01-15 00:00;82;78;68;146
2019;January;3;2019-01-15 00:00;83;90;63;153
2019;January;3;2019-01-15 00:00;84;56;62;118
2019;January;3;2019-01-15 00:00;85;61;42;103
2019;January;3;2019-01-15 00:00;86;51;42;93
2019;January;3;2019-01-15 00:00;87;31;35;66
2019;January;3;2019-01-15 00:00;88;41;27;68
2019;January;3;2019-01-15 00:00;89;39;23;62
2019;January;3;2019-01-15 00:00;90;33;23;56
2019;January;3;2019-01-15 00:00;91;23;14;37
2019;January;3;2019-01-15 00:00;92;28;8;36
2019;January;3;2019-01-15 00:00;93;18;9;27
2019;January;3;2019-01-15 00:00;94;18;6;24
2019;January;3;2019-01-15 00:00;95;13;4;17
2019;January;3;2019-01-15 00:00;96;6;4;10
2019;January;3;2019-01-15 00:00;97;10;1;11
2019;January;3;2019-01-15 00:00;98;3;3;6
2019;January;3;2019-01-15 00:00;99;2;2;4
2019;January;3;2019-01-15 00:00;100;0;1;1
2019;January;3;2019-01-15 00:00;107;1;0;1
2019;January;4;2019-01-22 00:00;0;5;9;14
2019;January;4;2019-01-22 00:00;1;191;216;407
2019;January;4;2019-01-22 00:00;2;211;204;415
2019;January;4;2019-01-22 00:00;3;186;213;399
2019;January;4;2019-01-22 00:00;4;194;215;409
2019;January;4;2019-01-22 00:00;5;184;235;419
2019;January;4;2019-01-22 00:00;6;212;232;444
2019;January;4;2019-01-22 00:00;7;195;200;395
2019;January;4;2019-01-22 00:00;8;224;238;462
2019;January;4;2019-01-22 00:00;9;229;236;465
2019;January;4;2019-01-22 00:00;10;213;225;438
2019;January;4;2019-01-22 00:00;11;206;203;409
2019;January;4;2019-01-22 00:00;12;188;208;396
2019;January;4;2019-01-22 00:00;13;226;204;430
2019;January;4;2019-01-22 00:00;14;191;213;404
2019;January;4;2019-01-22 00:00;15;190;204;394
2019;January;4;2019-01-22 00:00;16;177;189;366
2019;January;4;2019-01-22 00:00;17;182;225;407
2019;January;4;2019-01-22 00:00;18;144;184;328
2019;January;4;2019-01-22 00:00;19;177;199;376
2019;January;4;2019-01-22 00:00;20;175;193;368
2019;January;4;2019-01-22 00:00;21;145;176;321
2019;January;4;2019-01-22 00:00;22;142;190;332
2019;January;4;2019-01-22 00:00;23;143;171;314
2019;January;4;2019-01-22 00:00;24;154;179;333
2019;January;4;2019-01-22 00:00;25;175;175;350
2019;January;4;2019-01-22 00:00;26;177;205;382
2019;January;4;2019-01-22 00:00;27;183;183;366
2019;January;4;2019-01-22 00:00;28;183;236;419
2019;January;4;2019-01-22 00:00;29;200;222;422
2019;January;4;2019-01-22 00:00;30;183;201;384
2019;January;4;2019-01-22 00:00;31;197;198;395
2019;January;4;2019-01-22 00:00;32;211;201;412
2019;January;4;2019-01-22 00:00;33;182;188;370
2019;January;4;2019-01-22 00:00;34;196;218;414
2019;January;4;2019-01-22 00:00;35;200;205;405
2019;January;4;2019-01-22 00:00;36;220;186;406
2019;January;4;2019-01-22 00:00;37;215;208;423
2019;January;4;2019-01-22 00:00;38;174;196;370
2019;January;4;2019-01-22 00:00;39;242;211;453
2019;January;4;2019-01-22 00:00;40;212;184;396
2019;January;4;2019-01-22 00:00;41;200;213;413
2019;January;4;2019-01-22 00:00;42;199;217;416
2019;January;4;2019-01-22 00:00;43;226;220;446
2019;January;4;2019-01-22 00:00;44;223;243;466
2019;January;4;2019-01-22 00:00;45;230;279;509
2019;January;4;2019-01-22 00:00;46;210;220;430
2019;January;4;2019-01-22 00:00;47;223;256;479
2019;January;4;2019-01-22 00:00;48;218;226;444
2019;January;4;2019-01-22 00:00;49;206;222;428
2019;January;4;2019-01-22 00:00;50;193;199;392
2019;January;4;2019-01-22 00:00;51;207;223;430
2019;January;4;2019-01-22 00:00;52;237;233;470
2019;January;4;2019-01-22 00:00;53;186;221;407
2019;January;4;2019-01-22 00:00;54;199;219;418
2019;January;4;2019-01-22 00:00;55;187;217;404
2019;January;4;2019-01-22 00:00;56;178;214;392
2019;January;4;2019-01-22 00:00;57;186;183;369
2019;January;4;2019-01-22 00:00;58;149;166;315
2019;January;4;2019-01-22 00:00;59;155;155;310
2019;January;4;2019-01-22 00:00;60;152;162;314
2019;January;4;2019-01-22 00:00;61;147;156;303
2019;January;4;2019-01-22 00:00;62;148;152;300
2019;January;4;2019-01-22 00:00;63;150;157;307
2019;January;4;2019-01-22 00:00;64;132;115;247
2019;January;4;2019-01-22 00:00;65;132;139;271
2019;January;4;2019-01-22 00:00;66;146;135;281
2019;January;4;2019-01-22 00:00;67;140;151;291
2019;January;4;2019-01-22 00:00;68;142;131;273
2019;January;4;2019-01-22 00:00;69;141;155;296
2019;January;4;2019-01-22 00:00;70;147;161;308
2019;January;4;2019-01-22 00:00;71;172;161;333
2019;January;4;2019-01-22 00:00;72;159;153;312
2019;January;4;2019-01-22 00:00;73;181;147;328
2019;January;4;2019-01-22 00:00;74;180;171;351
2019;January;4;2019-01-22 00:00;75;151;157;308
2019;January;4;2019-01-22 00:00;76;151;161;312
2019;January;4;2019-01-22 00:00;77;135;131;266
2019;January;4;2019-01-22 00:00;78;106;99;205
2019;January;4;2019-01-22 00:00;79;82;122;204
2019;January;4;2019-01-22 00:00;80;85;86;171
2019;January;4;2019-01-22 00:00;81;92;77;169
2019;January;4;2019-01-22 00:00;82;78;68;146
2019;January;4;2019-01-22 00:00;83;89;63;152
2019;January;4;2019-01-22 00:00;84;56;62;118
2019;January;4;2019-01-22 00:00;85;61;42;103
2019;January;4;2019-01-22 00:00;86;51;42;93
2019;January;4;2019-01-22 00:00;87;31;35;66
2019;January;4;2019-01-22 00:00;88;41;27;68
2019;January;4;2019-01-22 00:00;89;39;22;61
2019;January;4;2019-01-22 00:00;90;33;23;56
2019;January;4;2019-01-22 00:00;91;22;13;35
2019;January;4;2019-01-22 00:00;92;27;8;35
2019;January;4;2019-01-22 00:00;93;18;9;27
2019;January;4;2019-01-22 00:00;94;17;6;23
2019;January;4;2019-01-22 00:00;95;13;4;17
2019;January;4;2019-01-22 00:00;96;6;4;10
2019;January;4;2019-01-22 00:00;97;10;1;11
2019;January;4;2019-01-22 00:00;98;3;3;6
2019;January;4;2019-01-22 00:00;99;2;2;4
2019;January;4;2019-01-22 00:00;100;0;1;1
2019;January;4;2019-01-22 00:00;107;1;0;1
2019;January;5;2019-01-29 00:00;0;11;10;21
2019;January;5;2019-01-29 00:00;1;191;217;408
2019;January;5;2019-01-29 00:00;2;211;206;417
2019;January;5;2019-01-29 00:00;3;186;213;399
2019;January;5;2019-01-29 00:00;4;194;215;409
2019;January;5;2019-01-29 00:00;5;184;235;419
2019;January;5;2019-01-29 00:00;6;211;232;443
2019;January;5;2019-01-29 00:00;7;196;199;395
2019;January;5;2019-01-29 00:00;8;224;239;463
2019;January;5;2019-01-29 00:00;9;229;236;465
2019;January;5;2019-01-29 00:00;10;213;226;439
2019;January;5;2019-01-29 00:00;11;206;203;409
2019;January;5;2019-01-29 00:00;12;188;208;396
2019;January;5;2019-01-29 00:00;13;226;204;430
2019;January;5;2019-01-29 00:00;14;191;213;404
2019;January;5;2019-01-29 00:00;15;189;204;393
2019;January;5;2019-01-29 00:00;16;177;189;366
2019;January;5;2019-01-29 00:00;17;183;225;408
2019;January;5;2019-01-29 00:00;18;144;184;328
2019;January;5;2019-01-29 00:00;19;176;198;374
2019;January;5;2019-01-29 00:00;20;175;193;368
2019;January;5;2019-01-29 00:00;21;145;175;320
2019;January;5;2019-01-29 00:00;22;143;190;333
2019;January;5;2019-01-29 00:00;23;143;171;314
2019;January;5;2019-01-29 00:00;24;152;178;330
2019;January;5;2019-01-29 00:00;25;175;175;350
2019;January;5;2019-01-29 00:00;26;177;204;381
2019;January;5;2019-01-29 00:00;27;183;183;366
2019;January;5;2019-01-29 00:00;28;183;237;420
2019;January;5;2019-01-29 00:00;29;200;222;422
2019;January;5;2019-01-29 00:00;30;184;201;385
2019;January;5;2019-01-29 00:00;31;197;198;395
2019;January;5;2019-01-29 00:00;32;210;201;411
2019;January;5;2019-01-29 00:00;33;181;191;372
2019;January;5;2019-01-29 00:00;34;196;218;414
2019;January;5;2019-01-29 00:00;35;200;204;404
2019;January;5;2019-01-29 00:00;36;220;186;406
2019;January;5;2019-01-29 00:00;37;215;208;423
2019;January;5;2019-01-29 00:00;38;174;195;369
2019;January;5;2019-01-29 00:00;39;242;211;453
2019;January;5;2019-01-29 00:00;40;211;184;395
2019;January;5;2019-01-29 00:00;41;200;213;413
2019;January;5;2019-01-29 00:00;42;199;217;416
2019;January;5;2019-01-29 00:00;43;226;220;446
2019;January;5;2019-01-29 00:00;44;223;243;466
2019;January;5;2019-01-29 00:00;45;231;280;511
2019;January;5;2019-01-29 00:00;46;210;220;430
2019;January;5;2019-01-29 00:00;47;223;255;478
2019;January;5;2019-01-29 00:00;48;218;227;445
2019;January;5;2019-01-29 00:00;49;206;221;427
2019;January;5;2019-01-29 00:00;50;193;200;393
2019;January;5;2019-01-29 00:00;51;207;223;430
2019;January;5;2019-01-29 00:00;52;237;233;470
2019;January;5;2019-01-29 00:00;53;186;220;406
2019;January;5;2019-01-29 00:00;54;199;219;418
2019;January;5;2019-01-29 00:00;55;187;217;404
2019;January;5;2019-01-29 00:00;56;177;214;391
2019;January;5;2019-01-29 00:00;57;186;183;369
2019;January;5;2019-01-29 00:00;58;149;166;315
2019;January;5;2019-01-29 00:00;59;155;155;310
2019;January;5;2019-01-29 00:00;60;152;162;314
2019;January;5;2019-01-29 00:00;61;147;156;303
2019;January;5;2019-01-29 00:00;62;148;152;300
2019;January;5;2019-01-29 00:00;63;150;157;307
2019;January;5;2019-01-29 00:00;64;132;115;247
2019;January;5;2019-01-29 00:00;65;132;139;271
2019;January;5;2019-01-29 00:00;66;146;135;281
2019;January;5;2019-01-29 00:00;67;139;150;289
2019;January;5;2019-01-29 00:00;68;142;131;273
2019;January;5;2019-01-29 00:00;69;141;155;296
2019;January;5;2019-01-29 00:00;70;146;161;307
2019;January;5;2019-01-29 00:00;71;172;161;333
2019;January;5;2019-01-29 00:00;72;159;152;311
2019;January;5;2019-01-29 00:00;73;181;147;328
2019;January;5;2019-01-29 00:00;74;180;171;351
2019;January;5;2019-01-29 00:00;75;151;156;307
2019;January;5;2019-01-29 00:00;76;151;160;311
2019;January;5;2019-01-29 00:00;77;135;131;266
2019;January;5;2019-01-29 00:00;78;106;98;204
2019;January;5;2019-01-29 00:00;79;82;122;204
2019;January;5;2019-01-29 00:00;80;84;86;170
2019;January;5;2019-01-29 00:00;81;92;77;169
2019;January;5;2019-01-29 00:00;82;78;68;146
2019;January;5;2019-01-29 00:00;83;89;62;151
2019;January;5;2019-01-29 00:00;84;56;62;118
2019;January;5;2019-01-29 00:00;85;61;42;103
2019;January;5;2019-01-29 00:00;86;51;42;93
2019;January;5;2019-01-29 00:00;87;31;35;66
2019;January;5;2019-01-29 00:00;88;41;27;68
2019;January;5;2019-01-29 00:00;89;39;22;61
2019;January;5;2019-01-29 00:00;90;33;23;56
2019;January;5;2019-01-29 00:00;91;22;13;35
2019;January;5;2019-01-29 00:00;92;27;8;35
2019;January;5;2019-01-29 00:00;93;18;9;27
2019;January;5;2019-01-29 00:00;94;17;6;23
2019;January;5;2019-01-29 00:00;95;13;4;17
2019;January;5;2019-01-29 00:00;96;6;4;10
2019;January;5;2019-01-29 00:00;97;10;1;11
2019;January;5;2019-01-29 00:00;98;3;2;5
2019;January;5;2019-01-29 00:00;99;2;2;4
2019;January;5;2019-01-29 00:00;100;0;1;1
2019;January;5;2019-01-29 00:00;107;1;0;1
2019;February;6;2019-02-05 00:00;0;15;14;29
2019;February;6;2019-02-05 00:00;1;194;217;411
2019;February;6;2019-02-05 00:00;2;212;206;418
2019;February;6;2019-02-05 00:00;3;187;215;402
2019;February;6;2019-02-05 00:00;4;194;215;409
2019;February;6;2019-02-05 00:00;5;184;235;419
2019;February;6;2019-02-05 00:00;6;212;232;444
2019;February;6;2019-02-05 00:00;7;195;199;394
2019;February;6;2019-02-05 00:00;8;224;238;462
2019;February;6;2019-02-05 00:00;9;230;236;466
2019;February;6;2019-02-05 00:00;10;213;228;441
2019;February;6;2019-02-05 00:00;11;206;203;409
2019;February;6;2019-02-05 00:00;12;188;208;396
2019;February;6;2019-02-05 00:00;13;226;204;430
2019;February;6;2019-02-05 00:00;14;191;213;404
2019;February;6;2019-02-05 00:00;15;189;204;393
2019;February;6;2019-02-05 00:00;16;177;189;366
2019;February;6;2019-02-05 00:00;17;183;224;407
2019;February;6;2019-02-05 00:00;18;144;184;328
2019;February;6;2019-02-05 00:00;19;176;197;373
2019;February;6;2019-02-05 00:00;20;175;196;371
2019;February;6;2019-02-05 00:00;21;145;175;320
2019;February;6;2019-02-05 00:00;22;143;189;332
2019;February;6;2019-02-05 00:00;23;143;172;315
2019;February;6;2019-02-05 00:00;24;153;177;330
2019;February;6;2019-02-05 00:00;25;176;176;352
2019;February;6;2019-02-05 00:00;26;177;205;382
2019;February;6;2019-02-05 00:00;27;184;183;367
2019;February;6;2019-02-05 00:00;28;184;240;424
2019;February;6;2019-02-05 00:00;29;202;221;423
2019;February;6;2019-02-05 00:00;30;186;200;386
2019;February;6;2019-02-05 00:00;31;202;199;401
2019;February;6;2019-02-05 00:00;32;211;202;413
2019;February;6;2019-02-05 00:00;33;182;191;373
2019;February;6;2019-02-05 00:00;34;195;219;414
2019;February;6;2019-02-05 00:00;35;201;205;406
2019;February;6;2019-02-05 00:00;36;219;189;408
2019;February;6;2019-02-05 00:00;37;215;208;423
2019;February;6;2019-02-05 00:00;38;175;195;370
2019;February;6;2019-02-05 00:00;39;242;212;454
2019;February;6;2019-02-05 00:00;40;211;184;395
2019;February;6;2019-02-05 00:00;41;201;215;416
2019;February;6;2019-02-05 00:00;42;199;217;416
2019;February;6;2019-02-05 00:00;43;226;220;446
2019;February;6;2019-02-05 00:00;44;222;243;465
2019;February;6;2019-02-05 00:00;45;231;280;511
2019;February;6;2019-02-05 00:00;46;210;221;431
2019;February;6;2019-02-05 00:00;47;224;255;479
2019;February;6;2019-02-05 00:00;48;218;225;443
2019;February;6;2019-02-05 00:00;49;206;221;427
2019;February;6;2019-02-05 00:00;50;193;200;393
2019;February;6;2019-02-05 00:00;51;206;225;431
2019;February;6;2019-02-05 00:00;52;238;233;471
2019;February;6;2019-02-05 00:00;53;188;220;408
2019;February;6;2019-02-05 00:00;54;199;218;417
2019;February;6;2019-02-05 00:00;55;187;217;404
2019;February;6;2019-02-05 00:00;56;177;214;391
2019;February;6;2019-02-05 00:00;57;186;183;369
2019;February;6;2019-02-05 00:00;58;149;166;315
2019;February;6;2019-02-05 00:00;59;155;155;310
2019;February;6;2019-02-05 00:00;60;152;161;313
2019;February;6;2019-02-05 00:00;61;146;156;302
2019;February;6;2019-02-05 00:00;62;148;152;300
2019;February;6;2019-02-05 00:00;63;150;157;307
2019;February;6;2019-02-05 00:00;64;132;115;247
2019;February;6;2019-02-05 00:00;65;133;139;272
2019;February;6;2019-02-05 00:00;66;146;136;282
2019;February;6;2019-02-05 00:00;67;139;150;289
2019;February;6;2019-02-05 00:00;68;142;131;273
2019;February;6;2019-02-05 00:00;69;140;155;295
2019;February;6;2019-02-05 00:00;70;147;161;308
2019;February;6;2019-02-05 00:00;71;172;161;333
2019;February;6;2019-02-05 00:00;72;159;151;310
2019;February;6;2019-02-05 00:00;73;181;148;329
2019;February;6;2019-02-05 00:00;74;178;171;349
2019;February;6;2019-02-05 00:00;75;151;156;307
2019;February;6;2019-02-05 00:00;76;151;160;311
2019;February;6;2019-02-05 00:00;77;135;131;266
2019;February;6;2019-02-05 00:00;78;106;98;204
2019;February;6;2019-02-05 00:00;79;82;122;204
2019;February;6;2019-02-05 00:00;80;84;86;170
2019;February;6;2019-02-05 00:00;81;92;77;169
2019;February;6;2019-02-05 00:00;82;78;68;146
2019;February;6;2019-02-05 00:00;83;89;62;151
2019;February;6;2019-02-05 00:00;84;56;62;118
2019;February;6;2019-02-05 00:00;85;61;42;103
2019;February;6;2019-02-05 00:00;86;51;42;93
2019;February;6;2019-02-05 00:00;87;31;35;66
2019;February;6;2019-02-05 00:00;88;41;27;68
2019;February;6;2019-02-05 00:00;89;39;22;61
2019;February;6;2019-02-05 00:00;90;33;23;56
2019;February;6;2019-02-05 00:00;91;22;13;35
2019;February;6;2019-02-05 00:00;92;27;8;35
2019;February;6;2019-02-05 00:00;93;18;9;27
2019;February;6;2019-02-05 00:00;94;17;6;23
2019;February;6;2019-02-05 00:00;95;13;4;17
2019;February;6;2019-02-05 00:00;96;6;4;10
2019;February;6;2019-02-05 00:00;97;10;1;11
2019;February;6;2019-02-05 00:00;98;3;2;5
2019;February;6;2019-02-05 00:00;99;2;2;4
2019;February;6;2019-02-05 00:00;100;0;1;1
2019;February;6;2019-02-05 00:00;107;1;0;1
2019;February;7;2019-02-12 00:00;0;18;19;37
2019;February;7;2019-02-12 00:00;1;194;217;411
2019;February;7;2019-02-12 00:00;2;213;207;420
2019;February;7;2019-02-12 00:00;3;187;215;402
2019;February;7;2019-02-12 00:00;4;194;215;409
2019;February;7;2019-02-12 00:00;5;185;236;421
2019;February;7;2019-02-12 00:00;6;212;232;444
2019;February;7;2019-02-12 00:00;7;195;200;395
2019;February;7;2019-02-12 00:00;8;224;238;462
2019;February;7;2019-02-12 00:00;9;230;236;466
2019;February;7;2019-02-12 00:00;10;213;229;442
2019;February;7;2019-02-12 00:00;11;206;203;409
2019;February;7;2019-02-12 00:00;12;188;208;396
2019;February;7;2019-02-12 00:00;13;226;204;430
2019;February;7;2019-02-12 00:00;14;191;213;404
2019;February;7;2019-02-12 00:00;15;189;204;393
2019;February;7;2019-02-12 00:00;16;177;189;366
2019;February;7;2019-02-12 00:00;17;183;224;407
2019;February;7;2019-02-12 00:00;18;143;184;327
2019;February;7;2019-02-12 00:00;19;176;198;374
2019;February;7;2019-02-12 00:00;20;172;198;370
2019;February;7;2019-02-12 00:00;21;144;174;318
2019;February;7;2019-02-12 00:00;22;140;188;328
2019;February;7;2019-02-12 00:00;23;143;172;315
2019;February;7;2019-02-12 00:00;24;152;178;330
2019;February;7;2019-02-12 00:00;25;177;175;352
2019;February;7;2019-02-12 00:00;26;178;205;383
2019;February;7;2019-02-12 00:00;27;184;184;368
2019;February;7;2019-02-12 00:00;28;185;241;426
2019;February;7;2019-02-12 00:00;29;203;222;425
2019;February;7;2019-02-12 00:00;30;186;201;387
2019;February;7;2019-02-12 00:00;31;202;199;401
2019;February;7;2019-02-12 00:00;32;211;202;413
2019;February;7;2019-02-12 00:00;33;182;191;373
2019;February;7;2019-02-12 00:00;34;196;218;414
2019;February;7;2019-02-12 00:00;35;201;205;406
2019;February;7;2019-02-12 00:00;36;220;189;409
2019;February;7;2019-02-12 00:00;37;215;210;425
2019;February;7;2019-02-12 00:00;38;175;195;370
2019;February;7;2019-02-12 00:00;39;243;215;458
2019;February;7;2019-02-12 00:00;40;212;183;395
2019;February;7;2019-02-12 00:00;41;202;214;416
2019;February;7;2019-02-12 00:00;42;199;217;416
2019;February;7;2019-02-12 00:00;43;226;220;446
2019;February;7;2019-02-12 00:00;44;222;243;465
2019;February;7;2019-02-12 00:00;45;231;278;509
2019;February;7;2019-02-12 00:00;46;210;221;431
2019;February;7;2019-02-12 00:00;47;224;256;480
2019;February;7;2019-02-12 00:00;48;217;226;443
2019;February;7;2019-02-12 00:00;49;206;221;427
2019;February;7;2019-02-12 00:00;50;193;200;393
2019;February;7;2019-02-12 00:00;51;206;225;431
2019;February;7;2019-02-12 00:00;52;237;232;469
2019;February;7;2019-02-12 00:00;53;188;219;407
2019;February;7;2019-02-12 00:00;54;199;218;417
2019;February;7;2019-02-12 00:00;55;187;217;404
2019;February;7;2019-02-12 00:00;56;177;214;391
2019;February;7;2019-02-12 00:00;57;186;182;368
2019;February;7;2019-02-12 00:00;58;149;166;315
2019;February;7;2019-02-12 00:00;59;155;155;310
2019;February;7;2019-02-12 00:00;60;152;162;314
2019;February;7;2019-02-12 00:00;61;146;156;302
2019;February;7;2019-02-12 00:00;62;148;153;301
2019;February;7;2019-02-12 00:00;63;150;157;307
2019;February;7;2019-02-12 00:00;64;132;115;247
2019;February;7;2019-02-12 00:00;65;133;140;273
2019;February;7;2019-02-12 00:00;66;145;136;281
2019;February;7;2019-02-12 00:00;67;139;150;289
2019;February;7;2019-02-12 00:00;68;141;131;272
2019;February;7;2019-02-12 00:00;69;140;155;295
2019;February;7;2019-02-12 00:00;70;147;161;308
2019;February;7;2019-02-12 00:00;71;172;161;333
2019;February;7;2019-02-12 00:00;72;159;150;309
2019;February;7;2019-02-12 00:00;73;181;148;329
2019;February;7;2019-02-12 00:00;74;178;171;349
2019;February;7;2019-02-12 00:00;75;151;157;308
2019;February;7;2019-02-12 00:00;76;151;160;311
2019;February;7;2019-02-12 00:00;77;135;131;266
2019;February;7;2019-02-12 00:00;78;106;98;204
2019;February;7;2019-02-12 00:00;79;82;121;203
2019;February;7;2019-02-12 00:00;80;84;86;170
2019;February;7;2019-02-12 00:00;81;92;77;169
2019;February;7;2019-02-12 00:00;82;78;68;146
2019;February;7;2019-02-12 00:00;83;89;61;150
2019;February;7;2019-02-12 00:00;84;56;62;118
2019;February;7;2019-02-12 00:00;85;61;42;103
2019;February;7;2019-02-12 00:00;86;51;42;93
2019;February;7;2019-02-12 00:00;87;31;35;66
2019;February;7;2019-02-12 00:00;88;41;27;68
2019;February;7;2019-02-12 00:00;89;39;22;61
2019;February;7;2019-02-12 00:00;90;33;23;56
2019;February;7;2019-02-12 00:00;91;22;13;35
2019;February;7;2019-02-12 00:00;92;27;8;35
2019;February;7;2019-02-12 00:00;93;18;9;27
2019;February;7;2019-02-12 00:00;94;17;6;23
2019;February;7;2019-02-12 00:00;95;12;4;16
2019;February;7;2019-02-12 00:00;96;6;4;10
2019;February;7;2019-02-12 00:00;97;10;1;11
2019;February;7;2019-02-12 00:00;98;2;2;4
2019;February;7;2019-02-12 00:00;99;2;2;4
2019;February;7;2019-02-12 00:00;100;0;1;1
2019;February;7;2019-02-12 00:00;107;1;0;1
2019;February;8;2019-02-19 00:00;0;21;25;46
2019;February;8;2019-02-19 00:00;1;195;219;414
2019;February;8;2019-02-19 00:00;2;213;207;420
2019;February;8;2019-02-19 00:00;3;185;216;401
2019;February;8;2019-02-19 00:00;4;194;215;409
2019;February;8;2019-02-19 00:00;5;184;236;420
2019;February;8;2019-02-19 00:00;6;211;232;443
2019;February;8;2019-02-19 00:00;7;196;200;396
2019;February;8;2019-02-19 00:00;8;223;237;460
2019;February;8;2019-02-19 00:00;9;230;236;466
2019;February;8;2019-02-19 00:00;10;212;229;441
2019;February;8;2019-02-19 00:00;11;206;204;410
2019;February;8;2019-02-19 00:00;12;187;208;395
2019;February;8;2019-02-19 00:00;13;225;204;429
2019;February;8;2019-02-19 00:00;14;191;213;404
2019;February;8;2019-02-19 00:00;15;189;204;393
2019;February;8;2019-02-19 00:00;16;176;188;364
2019;February;8;2019-02-19 00:00;17;183;224;407
2019;February;8;2019-02-19 00:00;18;143;184;327
2019;February;8;2019-02-19 00:00;19;176;198;374
2019;February;8;2019-02-19 00:00;20;172;198;370
2019;February;8;2019-02-19 00:00;21;144;173;317
2019;February;8;2019-02-19 00:00;22;140;187;327
2019;February;8;2019-02-19 00:00;23;143;173;316
2019;February;8;2019-02-19 00:00;24;151;178;329
2019;February;8;2019-02-19 00:00;25;177;175;352
2019;February;8;2019-02-19 00:00;26;178;206;384
2019;February;8;2019-02-19 00:00;27;185;184;369
2019;February;8;2019-02-19 00:00;28;185;241;426
2019;February;8;2019-02-19 00:00;29;204;223;427
2019;February;8;2019-02-19 00:00;30;186;201;387
2019;February;8;2019-02-19 00:00;31;201;199;400
2019;February;8;2019-02-19 00:00;32;211;204;415
2019;February;8;2019-02-19 00:00;33;181;191;372
2019;February;8;2019-02-19 00:00;34;195;216;411
2019;February;8;2019-02-19 00:00;35;200;204;404
2019;February;8;2019-02-19 00:00;36;220;189;409
2019;February;8;2019-02-19 00:00;37;215;212;427
2019;February;8;2019-02-19 00:00;38;175;195;370
2019;February;8;2019-02-19 00:00;39;243;215;458
2019;February;8;2019-02-19 00:00;40;212;183;395
2019;February;8;2019-02-19 00:00;41;202;213;415
2019;February;8;2019-02-19 00:00;42;199;216;415
2019;February;8;2019-02-19 00:00;43;226;221;447
2019;February;8;2019-02-19 00:00;44;222;242;464
2019;February;8;2019-02-19 00:00;45;231;279;510
2019;February;8;2019-02-19 00:00;46;209;221;430
2019;February;8;2019-02-19 00:00;47;223;254;477
2019;February;8;2019-02-19 00:00;48;216;226;442
2019;February;8;2019-02-19 00:00;49;206;221;427
2019;February;8;2019-02-19 00:00;50;194;200;394
2019;February;8;2019-02-19 00:00;51;206;225;431
2019;February;8;2019-02-19 00:00;52;237;231;468
2019;February;8;2019-02-19 00:00;53;188;219;407
2019;February;8;2019-02-19 00:00;54;199;218;417
2019;February;8;2019-02-19 00:00;55;187;217;404
2019;February;8;2019-02-19 00:00;56;177;215;392
2019;February;8;2019-02-19 00:00;57;186;182;368
2019;February;8;2019-02-19 00:00;58;149;166;315
2019;February;8;2019-02-19 00:00;59;155;155;310
2019;February;8;2019-02-19 00:00;60;151;162;313
2019;February;8;2019-02-19 00:00;61;146;156;302
2019;February;8;2019-02-19 00:00;62;148;153;301
2019;February;8;2019-02-19 00:00;63;150;157;307
2019;February;8;2019-02-19 00:00;64;132;115;247
2019;February;8;2019-02-19 00:00;65;133;140;273
2019;February;8;2019-02-19 00:00;66;145;136;281
2019;February;8;2019-02-19 00:00;67;139;150;289
2019;February;8;2019-02-19 00:00;68;141;131;272
2019;February;8;2019-02-19 00:00;69;140;155;295
2019;February;8;2019-02-19 00:00;70;148;161;309
2019;February;8;2019-02-19 00:00;71;172;161;333
2019;February;8;2019-02-19 00:00;72;159;150;309
2019;February;8;2019-02-19 00:00;73;181;147;328
2019;February;8;2019-02-19 00:00;74;178;172;350
2019;February;8;2019-02-19 00:00;75;151;157;308
2019;February;8;2019-02-19 00:00;76;151;160;311
2019;February;8;2019-02-19 00:00;77;135;131;266
2019;February;8;2019-02-19 00:00;78;106;98;204
2019;February;8;2019-02-19 00:00;79;82;121;203
2019;February;8;2019-02-19 00:00;80;84;86;170
2019;February;8;2019-02-19 00:00;81;92;77;169
2019;February;8;2019-02-19 00:00;82;78;68;146
2019;February;8;2019-02-19 00:00;83;89;61;150
2019;February;8;2019-02-19 00:00;84;56;62;118
2019;February;8;2019-02-19 00:00;85;61;42;103
2019;February;8;2019-02-19 00:00;86;51;42;93
2019;February;8;2019-02-19 00:00;87;31;35;66
2019;February;8;2019-02-19 00:00;88;41;26;67
2019;February;8;2019-02-19 00:00;89;39;22;61
2019;February;8;2019-02-19 00:00;90;33;23;56
2019;February;8;2019-02-19 00:00;91;21;13;34
2019;February;8;2019-02-19 00:00;92;27;8;35
2019;February;8;2019-02-19 00:00;93;18;9;27
2019;February;8;2019-02-19 00:00;94;17;6;23
2019;February;8;2019-02-19 00:00;95;12;4;16
2019;February;8;2019-02-19 00:00;96;5;4;9
2019;February;8;2019-02-19 00:00;97;10;1;11
2019;February;8;2019-02-19 00:00;98;2;2;4
2019;February;8;2019-02-19 00:00;99;2;2;4
2019;February;8;2019-02-19 00:00;100;0;1;1
2019;February;8;2019-02-19 00:00;107;1;0;1
2019;February;9;2019-02-26 00:00;0;22;28;50
2019;February;9;2019-02-26 00:00;1;200;219;419
2019;February;9;2019-02-26 00:00;2;212;206;418
2019;February;9;2019-02-26 00:00;3;185;218;403
2019;February;9;2019-02-26 00:00;4;196;216;412
2019;February;9;2019-02-26 00:00;5;184;237;421
2019;February;9;2019-02-26 00:00;6;213;234;447
2019;February;9;2019-02-26 00:00;7;195;202;397
2019;February;9;2019-02-26 00:00;8;222;236;458
2019;February;9;2019-02-26 00:00;9;229;236;465
2019;February;9;2019-02-26 00:00;10;212;230;442
2019;February;9;2019-02-26 00:00;11;205;203;408
2019;February;9;2019-02-26 00:00;12;188;208;396
2019;February;9;2019-02-26 00:00;13;225;205;430
2019;February;9;2019-02-26 00:00;14;192;213;405
2019;February;9;2019-02-26 00:00;15;189;204;393
2019;February;9;2019-02-26 00:00;16;176;188;364
2019;February;9;2019-02-26 00:00;17;182;224;406
2019;February;9;2019-02-26 00:00;18;143;184;327
2019;February;9;2019-02-26 00:00;19;176;198;374
2019;February;9;2019-02-26 00:00;20;172;199;371
2019;February;9;2019-02-26 00:00;21;143;173;316
2019;February;9;2019-02-26 00:00;22;140;188;328
2019;February;9;2019-02-26 00:00;23;143;173;316
2019;February;9;2019-02-26 00:00;24;150;177;327
2019;February;9;2019-02-26 00:00;25;178;175;353
2019;February;9;2019-02-26 00:00;26;179;204;383
2019;February;9;2019-02-26 00:00;27;185;184;369
2019;February;9;2019-02-26 00:00;28;184;240;424
2019;February;9;2019-02-26 00:00;29;204;223;427
2019;February;9;2019-02-26 00:00;30;185;201;386
2019;February;9;2019-02-26 00:00;31;201;199;400
2019;February;9;2019-02-26 00:00;32;214;206;420
2019;February;9;2019-02-26 00:00;33;184;193;377
2019;February;9;2019-02-26 00:00;34;197;218;415
2019;February;9;2019-02-26 00:00;35;201;205;406
2019;February;9;2019-02-26 00:00;36;220;189;409
2019;February;9;2019-02-26 00:00;37;214;212;426
2019;February;9;2019-02-26 00:00;38;174;196;370
2019;February;9;2019-02-26 00:00;39;242;215;457
2019;February;9;2019-02-26 00:00;40;212;184;396
2019;February;9;2019-02-26 00:00;41;203;214;417
2019;February;9;2019-02-26 00:00;42;199;217;416
2019;February;9;2019-02-26 00:00;43;227;221;448
2019;February;9;2019-02-26 00:00;44;222;242;464
2019;February;9;2019-02-26 00:00;45;231;280;511
2019;February;9;2019-02-26 00:00;46;209;220;429
2019;February;9;2019-02-26 00:00;47;223;255;478
2019;February;9;2019-02-26 00:00;48;216;225;441
2019;February;9;2019-02-26 00:00;49;206;221;427
2019;February;9;2019-02-26 00:00;50;194;200;394
2019;February;9;2019-02-26 00:00;51;206;225;431
2019;February;9;2019-02-26 00:00;52;237;231;468
2019;February;9;2019-02-26 00:00;53;188;218;406
2019;February;9;2019-02-26 00:00;54;199;218;417
2019;February;9;2019-02-26 00:00;55;187;217;404
2019;February;9;2019-02-26 00:00;56;177;215;392
2019;February;9;2019-02-26 00:00;57;186;182;368
2019;February;9;2019-02-26 00:00;58;149;166;315
2019;February;9;2019-02-26 00:00;59;155;155;310
2019;February;9;2019-02-26 00:00;60;151;161;312
2019;February;9;2019-02-26 00:00;61;146;156;302
2019;February;9;2019-02-26 00:00;62;147;152;299
2019;February;9;2019-02-26 00:00;63;150;157;307
2019;February;9;2019-02-26 00:00;64;132;115;247
2019;February;9;2019-02-26 00:00;65;133;140;273
2019;February;9;2019-02-26 00:00;66;145;136;281
2019;February;9;2019-02-26 00:00;67;139;150;289
2019;February;9;2019-02-26 00:00;68;141;131;272
2019;February;9;2019-02-26 00:00;69;140;155;295
2019;February;9;2019-02-26 00:00;70;148;161;309
2019;February;9;2019-02-26 00:00;71;172;161;333
2019;February;9;2019-02-26 00:00;72;159;150;309
2019;February;9;2019-02-26 00:00;73;181;147;328
2019;February;9;2019-02-26 00:00;74;178;172;350
2019;February;9;2019-02-26 00:00;75;151;157;308
2019;February;9;2019-02-26 00:00;76;151;160;311
2019;February;9;2019-02-26 00:00;77;135;131;266
2019;February;9;2019-02-26 00:00;78;106;98;204
2019;February;9;2019-02-26 00:00;79;82;120;202
2019;February;9;2019-02-26 00:00;80;84;86;170
2019;February;9;2019-02-26 00:00;81;92;77;169
2019;February;9;2019-02-26 00:00;82;78;68;146
2019;February;9;2019-02-26 00:00;83;88;61;149
2019;February;9;2019-02-26 00:00;84;55;62;117
2019;February;9;2019-02-26 00:00;85;61;42;103
2019;February;9;2019-02-26 00:00;86;51;42;93
2019;February;9;2019-02-26 00:00;87;31;35;66
2019;February;9;2019-02-26 00:00;88;40;26;66
2019;February;9;2019-02-26 00:00;89;39;22;61
2019;February;9;2019-02-26 00:00;90;33;23;56
2019;February;9;2019-02-26 00:00;91;22;13;35
2019;February;9;2019-02-26 00:00;92;27;8;35
2019;February;9;2019-02-26 00:00;93;18;9;27
2019;February;9;2019-02-26 00:00;94;17;6;23
2019;February;9;2019-02-26 00:00;95;12;4;16
2019;February;9;2019-02-26 00:00;96;5;4;9
2019;February;9;2019-02-26 00:00;97;10;1;11
2019;February;9;2019-02-26 00:00;98;2;2;4
2019;February;9;2019-02-26 00:00;99;2;2;4
2019;February;9;2019-02-26 00:00;100;0;1;1
2019;February;9;2019-02-26 00:00;107;1;0;1
2019;March;10;2019-03-05 00:00;0;24;32;56
2019;March;10;2019-03-05 00:00;1;199;221;420
2019;March;10;2019-03-05 00:00;2;213;209;422
2019;March;10;2019-03-05 00:00;3;187;218;405
2019;March;10;2019-03-05 00:00;4;198;219;417
2019;March;10;2019-03-05 00:00;5;184;238;422
2019;March;10;2019-03-05 00:00;6;212;235;447
2019;March;10;2019-03-05 00:00;7;195;204;399
2019;March;10;2019-03-05 00:00;8;222;236;458
2019;March;10;2019-03-05 00:00;9;229;236;465
2019;March;10;2019-03-05 00:00;10;212;230;442
2019;March;10;2019-03-05 00:00;11;205;204;409
2019;March;10;2019-03-05 00:00;12;188;208;396
2019;March;10;2019-03-05 00:00;13;225;205;430
2019;March;10;2019-03-05 00:00;14;192;214;406
2019;March;10;2019-03-05 00:00;15;189;204;393
2019;March;10;2019-03-05 00:00;16;177;188;365
2019;March;10;2019-03-05 00:00;17;182;225;407
2019;March;10;2019-03-05 00:00;18;143;185;328
2019;March;10;2019-03-05 00:00;19;176;198;374
2019;March;10;2019-03-05 00:00;20;172;198;370
2019;March;10;2019-03-05 00:00;21;142;174;316
2019;March;10;2019-03-05 00:00;22;137;187;324
2019;March;10;2019-03-05 00:00;23;142;173;315
2019;March;10;2019-03-05 00:00;24;151;174;325
2019;March;10;2019-03-05 00:00;25;177;175;352
2019;March;10;2019-03-05 00:00;26;179;205;384
2019;March;10;2019-03-05 00:00;27;186;184;370
2019;March;10;2019-03-05 00:00;28;186;243;429
2019;March;10;2019-03-05 00:00;29;204;224;428
2019;March;10;2019-03-05 00:00;30;185;205;390
2019;March;10;2019-03-05 00:00;31;202;202;404
2019;March;10;2019-03-05 00:00;32;216;207;423
2019;March;10;2019-03-05 00:00;33;187;193;380
2019;March;10;2019-03-05 00:00;34;197;217;414
2019;March;10;2019-03-05 00:00;35;202;207;409
2019;March;10;2019-03-05 00:00;36;222;189;411
2019;March;10;2019-03-05 00:00;37;217;210;427
2019;March;10;2019-03-05 00:00;38;175;196;371
2019;March;10;2019-03-05 00:00;39;242;216;458
2019;March;10;2019-03-05 00:00;40;212;186;398
2019;March;10;2019-03-05 00:00;41;203;215;418
2019;March;10;2019-03-05 00:00;42;198;216;414
2019;March;10;2019-03-05 00:00;43;227;220;447
2019;March;10;2019-03-05 00:00;44;222;242;464
2019;March;10;2019-03-05 00:00;45;230;281;511
2019;March;10;2019-03-05 00:00;46;209;219;428
2019;March;10;2019-03-05 00:00;47;223;255;478
2019;March;10;2019-03-05 00:00;48;216;224;440
2019;March;10;2019-03-05 00:00;49;205;221;426
2019;March;10;2019-03-05 00:00;50;195;200;395
2019;March;10;2019-03-05 00:00;51;206;224;430
2019;March;10;2019-03-05 00:00;52;237;230;467
2019;March;10;2019-03-05 00:00;53;187;218;405
2019;March;10;2019-03-05 00:00;54;199;217;416
2019;March;10;2019-03-05 00:00;55;188;217;405
2019;March;10;2019-03-05 00:00;56;178;215;393
2019;March;10;2019-03-05 00:00;57;186;183;369
2019;March;10;2019-03-05 00:00;58;149;167;316
2019;March;10;2019-03-05 00:00;59;156;154;310
2019;March;10;2019-03-05 00:00;60;150;161;311
2019;March;10;2019-03-05 00:00;61;146;156;302
2019;March;10;2019-03-05 00:00;62;146;152;298
2019;March;10;2019-03-05 00:00;63;150;157;307
2019;March;10;2019-03-05 00:00;64;132;116;248
2019;March;10;2019-03-05 00:00;65;133;140;273
2019;March;10;2019-03-05 00:00;66;145;136;281
2019;March;10;2019-03-05 00:00;67;139;150;289
2019;March;10;2019-03-05 00:00;68;141;130;271
2019;March;10;2019-03-05 00:00;69;140;155;295
2019;March;10;2019-03-05 00:00;70;148;160;308
2019;March;10;2019-03-05 00:00;71;172;160;332
2019;March;10;2019-03-05 00:00;72;159;150;309
2019;March;10;2019-03-05 00:00;73;181;147;328
2019;March;10;2019-03-05 00:00;74;178;172;350
2019;March;10;2019-03-05 00:00;75;151;157;308
2019;March;10;2019-03-05 00:00;76;151;160;311
2019;March;10;2019-03-05 00:00;77;135;131;266
2019;March;10;2019-03-05 00:00;78;106;97;203
2019;March;10;2019-03-05 00:00;79;83;119;202
2019;March;10;2019-03-05 00:00;80;84;86;170
2019;March;10;2019-03-05 00:00;81;92;76;168
2019;March;10;2019-03-05 00:00;82;78;68;146
2019;March;10;2019-03-05 00:00;83;88;61;149
2019;March;10;2019-03-05 00:00;84;55;61;116
2019;March;10;2019-03-05 00:00;85;60;42;102
2019;March;10;2019-03-05 00:00;86;51;42;93
2019;March;10;2019-03-05 00:00;87;31;35;66
2019;March;10;2019-03-05 00:00;88;39;26;65
2019;March;10;2019-03-05 00:00;89;39;22;61
2019;March;10;2019-03-05 00:00;90;33;23;56
2019;March;10;2019-03-05 00:00;91;22;13;35
2019;March;10;2019-03-05 00:00;92;26;8;34
2019;March;10;2019-03-05 00:00;93;17;9;26
2019;March;10;2019-03-05 00:00;94;17;6;23
2019;March;10;2019-03-05 00:00;95;12;4;16
2019;March;10;2019-03-05 00:00;96;5;4;9
2019;March;10;2019-03-05 00:00;97;10;1;11
2019;March;10;2019-03-05 00:00;98;2;2;4
2019;March;10;2019-03-05 00:00;99;1;2;3
2019;March;10;2019-03-05 00:00;100;0;1;1
2019;March;10;2019-03-05 00:00;107;1;0;1
2019;March;11;2019-03-12 00:00;0;29;36;65
2019;March;11;2019-03-12 00:00;1;199;220;419
2019;March;11;2019-03-12 00:00;2;214;209;423
2019;March;11;2019-03-12 00:00;3;187;218;405
2019;March;11;2019-03-12 00:00;4;200;219;419
2019;March;11;2019-03-12 00:00;5;185;237;422
2019;March;11;2019-03-12 00:00;6;212;236;448
2019;March;11;2019-03-12 00:00;7;195;204;399
2019;March;11;2019-03-12 00:00;8;223;237;460
2019;March;11;2019-03-12 00:00;9;230;236;466
2019;March;11;2019-03-12 00:00;10;212;231;443
2019;March;11;2019-03-12 00:00;11;205;204;409
2019;March;11;2019-03-12 00:00;12;188;208;396
2019;March;11;2019-03-12 00:00;13;225;206;431
2019;March;11;2019-03-12 00:00;14;192;214;406
2019;March;11;2019-03-12 00:00;15;189;204;393
2019;March;11;2019-03-12 00:00;16;178;188;366
2019;March;11;2019-03-12 00:00;17;181;225;406
2019;March;11;2019-03-12 00:00;18;144;185;329
2019;March;11;2019-03-12 00:00;19;176;198;374
2019;March;11;2019-03-12 00:00;20;172;198;370
2019;March;11;2019-03-12 00:00;21;142;174;316
2019;March;11;2019-03-12 00:00;22;136;185;321
2019;March;11;2019-03-12 00:00;23;141;174;315
2019;March;11;2019-03-12 00:00;24;151;174;325
2019;March;11;2019-03-12 00:00;25;175;175;350
2019;March;11;2019-03-12 00:00;26;180;207;387
2019;March;11;2019-03-12 00:00;27;186;184;370
2019;March;11;2019-03-12 00:00;28;185;243;428
2019;March;11;2019-03-12 00:00;29;205;225;430
2019;March;11;2019-03-12 00:00;30;185;205;390
2019;March;11;2019-03-12 00:00;31;202;201;403
2019;March;11;2019-03-12 00:00;32;216;207;423
2019;March;11;2019-03-12 00:00;33;187;193;380
2019;March;11;2019-03-12 00:00;34;196;218;414
2019;March;11;2019-03-12 00:00;35;204;209;413
2019;March;11;2019-03-12 00:00;36;222;189;411
2019;March;11;2019-03-12 00:00;37;218;210;428
2019;March;11;2019-03-12 00:00;38;175;196;371
2019;March;11;2019-03-12 00:00;39;241;216;457
2019;March;11;2019-03-12 00:00;40;212;186;398
2019;March;11;2019-03-12 00:00;41;203;213;416
2019;March;11;2019-03-12 00:00;42;198;216;414
2019;March;11;2019-03-12 00:00;43;227;220;447
2019;March;11;2019-03-12 00:00;44;222;240;462
2019;March;11;2019-03-12 00:00;45;229;282;511
2019;March;11;2019-03-12 00:00;46;209;219;428
2019;March;11;2019-03-12 00:00;47;223;255;478
2019;March;11;2019-03-12 00:00;48;216;224;440
2019;March;11;2019-03-12 00:00;49;205;221;426
2019;March;11;2019-03-12 00:00;50;195;199;394
2019;March;11;2019-03-12 00:00;51;206;223;429
2019;March;11;2019-03-12 00:00;52;237;230;467
2019;March;11;2019-03-12 00:00;53;187;218;405
2019;March;11;2019-03-12 00:00;54;199;217;416
2019;March;11;2019-03-12 00:00;55;189;217;406
2019;March;11;2019-03-12 00:00;56;178;216;394
2019;March;11;2019-03-12 00:00;57;186;183;369
2019;March;11;2019-03-12 00:00;58;149;168;317
2019;March;11;2019-03-12 00:00;59;156;154;310
2019;March;11;2019-03-12 00:00;60;150;161;311
2019;March;11;2019-03-12 00:00;61;146;156;302
2019;March;11;2019-03-12 00:00;62;146;152;298
2019;March;11;2019-03-12 00:00;63;150;157;307
2019;March;11;2019-03-12 00:00;64;132;116;248
2019;March;11;2019-03-12 00:00;65;133;140;273
2019;March;11;2019-03-12 00:00;66;145;136;281
2019;March;11;2019-03-12 00:00;67;139;150;289
2019;March;11;2019-03-12 00:00;68;141;130;271
2019;March;11;2019-03-12 00:00;69;140;155;295
2019;March;11;2019-03-12 00:00;70;148;160;308
2019;March;11;2019-03-12 00:00;71;172;160;332
2019;March;11;2019-03-12 00:00;72;159;150;309
2019;March;11;2019-03-12 00:00;73;180;147;327
2019;March;11;2019-03-12 00:00;74;178;172;350
2019;March;11;2019-03-12 00:00;75;151;157;308
2019;March;11;2019-03-12 00:00;76;152;161;313
2019;March;11;2019-03-12 00:00;77;135;131;266
2019;March;11;2019-03-12 00:00;78;106;97;203
2019;March;11;2019-03-12 00:00;79;83;119;202
2019;March;11;2019-03-12 00:00;80;84;86;170
2019;March;11;2019-03-12 00:00;81;92;76;168
2019;March;11;2019-03-12 00:00;82;78;68;146
2019;March;11;2019-03-12 00:00;83;88;61;149
2019;March;11;2019-03-12 00:00;84;55;61;116
2019;March;11;2019-03-12 00:00;85;60;42;102
2019;March;11;2019-03-12 00:00;86;51;42;93
2019;March;11;2019-03-12 00:00;87;31;35;66
2019;March;11;2019-03-12 00:00;88;38;26;64
2019;March;11;2019-03-12 00:00;89;39;22;61
2019;March;11;2019-03-12 00:00;90;33;23;56
2019;March;11;2019-03-12 00:00;91;22;13;35
2019;March;11;2019-03-12 00:00;92;26;8;34
2019;March;11;2019-03-12 00:00;93;17;9;26
2019;March;11;2019-03-12 00:00;94;17;6;23
2019;March;11;2019-03-12 00:00;95;12;4;16
2019;March;11;2019-03-12 00:00;96;5;4;9
2019;March;11;2019-03-12 00:00;97;10;1;11
2019;March;11;2019-03-12 00:00;98;2;2;4
2019;March;11;2019-03-12 00:00;99;1;2;3
2019;March;11;2019-03-12 00:00;100;0;1;1
2019;March;11;2019-03-12 00:00;107;1;0;1
2019;March;12;2019-03-19 00:00;0;34;40;74
2019;March;12;2019-03-19 00:00;1;199;220;419
2019;March;12;2019-03-19 00:00;2;214;208;422
2019;March;12;2019-03-19 00:00;3;188;219;407
2019;March;12;2019-03-19 00:00;4;200;219;419
2019;March;12;2019-03-19 00:00;5;185;237;422
2019;March;12;2019-03-19 00:00;6;212;236;448
2019;March;12;2019-03-19 00:00;7;195;204;399
2019;March;12;2019-03-19 00:00;8;223;237;460
2019;March;12;2019-03-19 00:00;9;230;236;466
2019;March;12;2019-03-19 00:00;10;212;231;443
2019;March;12;2019-03-19 00:00;11;205;204;409
2019;March;12;2019-03-19 00:00;12;188;208;396
2019;March;12;2019-03-19 00:00;13;225;206;431
2019;March;12;2019-03-19 00:00;14;192;214;406
2019;March;12;2019-03-19 00:00;15;189;204;393
2019;March;12;2019-03-19 00:00;16;178;188;366
2019;March;12;2019-03-19 00:00;17;181;225;406
2019;March;12;2019-03-19 00:00;18;144;185;329
2019;March;12;2019-03-19 00:00;19;177;198;375
2019;March;12;2019-03-19 00:00;20;172;197;369
2019;March;12;2019-03-19 00:00;21;144;174;318
2019;March;12;2019-03-19 00:00;22;136;184;320
2019;March;12;2019-03-19 00:00;23;141;174;315
2019;March;12;2019-03-19 00:00;24;151;174;325
2019;March;12;2019-03-19 00:00;25;178;177;355
2019;March;12;2019-03-19 00:00;26;180;207;387
2019;March;12;2019-03-19 00:00;27;187;183;370
2019;March;12;2019-03-19 00:00;28;185;244;429
2019;March;12;2019-03-19 00:00;29;206;225;431
2019;March;12;2019-03-19 00:00;30;185;205;390
2019;March;12;2019-03-19 00:00;31;204;202;406
2019;March;12;2019-03-19 00:00;32;216;208;424
2019;March;12;2019-03-19 00:00;33;187;194;381
2019;March;12;2019-03-19 00:00;34;196;221;417
2019;March;12;2019-03-19 00:00;35;205;209;414
2019;March;12;2019-03-19 00:00;36;222;190;412
2019;March;12;2019-03-19 00:00;37;218;209;427
2019;March;12;2019-03-19 00:00;38;175;196;371
2019;March;12;2019-03-19 00:00;39;242;217;459
2019;March;12;2019-03-19 00:00;40;213;186;399
2019;March;12;2019-03-19 00:00;41;203;213;416
2019;March;12;2019-03-19 00:00;42;198;216;414
2019;March;12;2019-03-19 00:00;43;227;220;447
2019;March;12;2019-03-19 00:00;44;222;239;461
2019;March;12;2019-03-19 00:00;45;229;282;511
2019;March;12;2019-03-19 00:00;46;210;219;429
2019;March;12;2019-03-19 00:00;47;223;255;478
2019;March;12;2019-03-19 00:00;48;216;224;440
2019;March;12;2019-03-19 00:00;49;205;221;426
2019;March;12;2019-03-19 00:00;50;195;199;394
2019;March;12;2019-03-19 00:00;51;206;223;429
2019;March;12;2019-03-19 00:00;52;237;231;468
2019;March;12;2019-03-19 00:00;53;187;218;405
2019;March;12;2019-03-19 00:00;54;199;218;417
2019;March;12;2019-03-19 00:00;55;189;218;407
2019;March;12;2019-03-19 00:00;56;179;216;395
2019;March;12;2019-03-19 00:00;57;185;184;369
2019;March;12;2019-03-19 00:00;58;149;168;317
2019;March;12;2019-03-19 00:00;59;156;154;310
2019;March;12;2019-03-19 00:00;60;150;160;310
2019;March;12;2019-03-19 00:00;61;146;154;300
2019;March;12;2019-03-19 00:00;62;146;152;298
2019;March;12;2019-03-19 00:00;63;150;157;307
2019;March;12;2019-03-19 00:00;64;132;116;248
2019;March;12;2019-03-19 00:00;65;133;140;273
2019;March;12;2019-03-19 00:00;66;145;136;281
2019;March;12;2019-03-19 00:00;67;139;150;289
2019;March;12;2019-03-19 00:00;68;141;130;271
2019;March;12;2019-03-19 00:00;69;140;155;295
2019;March;12;2019-03-19 00:00;70;149;160;309
2019;March;12;2019-03-19 00:00;71;172;161;333
2019;March;12;2019-03-19 00:00;72;159;150;309
2019;March;12;2019-03-19 00:00;73;180;147;327
2019;March;12;2019-03-19 00:00;74;178;172;350
2019;March;12;2019-03-19 00:00;75;151;157;308
2019;March;12;2019-03-19 00:00;76;152;160;312
2019;March;12;2019-03-19 00:00;77;135;131;266
2019;March;12;2019-03-19 00:00;78;106;97;203
2019;March;12;2019-03-19 00:00;79;83;119;202
2019;March;12;2019-03-19 00:00;80;84;86;170
2019;March;12;2019-03-19 00:00;81;92;76;168
2019;March;12;2019-03-19 00:00;82;78;68;146
2019;March;12;2019-03-19 00:00;83;88;61;149
2019;March;12;2019-03-19 00:00;84;55;61;116
2019;March;12;2019-03-19 00:00;85;60;42;102
2019;March;12;2019-03-19 00:00;86;51;42;93
2019;March;12;2019-03-19 00:00;87;31;35;66
2019;March;12;2019-03-19 00:00;88;38;26;64
2019;March;12;2019-03-19 00:00;89;39;22;61
2019;March;12;2019-03-19 00:00;90;33;22;55
2019;March;12;2019-03-19 00:00;91;22;13;35
2019;March;12;2019-03-19 00:00;92;26;8;34
2019;March;12;2019-03-19 00:00;93;17;9;26
2019;March;12;2019-03-19 00:00;94;17;6;23
2019;March;12;2019-03-19 00:00;95;12;4;16
2019;March;12;2019-03-19 00:00;96;5;4;9
2019;March;12;2019-03-19 00:00;97;9;1;10
2019;March;12;2019-03-19 00:00;98;2;2;4
2019;March;12;2019-03-19 00:00;99;1;2;3
2019;March;12;2019-03-19 00:00;100;0;1;1
2019;March;12;2019-03-19 00:00;107;1;0;1
2019;March;13;2019-03-26 00:00;0;38;43;81
2019;March;13;2019-03-26 00:00;1;199;220;419
2019;March;13;2019-03-26 00:00;2;214;209;423
2019;March;13;2019-03-26 00:00;3;189;218;407
2019;March;13;2019-03-26 00:00;4;200;220;420
2019;March;13;2019-03-26 00:00;5;185;239;424
2019;March;13;2019-03-26 00:00;6;213;236;449
2019;March;13;2019-03-26 00:00;7;195;205;400
2019;March;13;2019-03-26 00:00;8;223;237;460
2019;March;13;2019-03-26 00:00;9;230;236;466
2019;March;13;2019-03-26 00:00;10;212;231;443
2019;March;13;2019-03-26 00:00;11;205;204;409
2019;March;13;2019-03-26 00:00;12;188;209;397
2019;March;13;2019-03-26 00:00;13;226;206;432
2019;March;13;2019-03-26 00:00;14;192;215;407
2019;March;13;2019-03-26 00:00;15;190;204;394
2019;March;13;2019-03-26 00:00;16;178;188;366
2019;March;13;2019-03-26 00:00;17;181;225;406
2019;March;13;2019-03-26 00:00;18;144;184;328
2019;March;13;2019-03-26 00:00;19;177;198;375
2019;March;13;2019-03-26 00:00;20;170;197;367
2019;March;13;2019-03-26 00:00;21;143;174;317
2019;March;13;2019-03-26 00:00;22;136;185;321
2019;March;13;2019-03-26 00:00;23;141;175;316
2019;March;13;2019-03-26 00:00;24;151;175;326
2019;March;13;2019-03-26 00:00;25;177;176;353
2019;March;13;2019-03-26 00:00;26;180;206;386
2019;March;13;2019-03-26 00:00;27;186;183;369
2019;March;13;2019-03-26 00:00;28;184;244;428
2019;March;13;2019-03-26 00:00;29;206;226;432
2019;March;13;2019-03-26 00:00;30;185;205;390
2019;March;13;2019-03-26 00:00;31;204;202;406
2019;March;13;2019-03-26 00:00;32;216;207;423
2019;March;13;2019-03-26 00:00;33;188;195;383
2019;March;13;2019-03-26 00:00;34;196;222;418
2019;March;13;2019-03-26 00:00;35;205;210;415
2019;March;13;2019-03-26 00:00;36;222;190;412
2019;March;13;2019-03-26 00:00;37;219;211;430
2019;March;13;2019-03-26 00:00;38;176;197;373
2019;March;13;2019-03-26 00:00;39;242;217;459
2019;March;13;2019-03-26 00:00;40;213;186;399
2019;March;13;2019-03-26 00:00;41;204;213;417
2019;March;13;2019-03-26 00:00;42;198;216;414
2019;March;13;2019-03-26 00:00;43;227;219;446
2019;March;13;2019-03-26 00:00;44;222;239;461
2019;March;13;2019-03-26 00:00;45;229;282;511
2019;March;13;2019-03-26 00:00;46;210;219;429
2019;March;13;2019-03-26 00:00;47;223;255;478
2019;March;13;2019-03-26 00:00;48;216;224;440
2019;March;13;2019-03-26 00:00;49;205;221;426
2019;March;13;2019-03-26 00:00;50;195;199;394
2019;March;13;2019-03-26 00:00;51;206;223;429
2019;March;13;2019-03-26 00:00;52;237;231;468
2019;March;13;2019-03-26 00:00;53;187;217;404
2019;March;13;2019-03-26 00:00;54;199;218;417
2019;March;13;2019-03-26 00:00;55;189;218;407
2019;March;13;2019-03-26 00:00;56;178;217;395
2019;March;13;2019-03-26 00:00;57;185;184;369
2019;March;13;2019-03-26 00:00;58;149;168;317
2019;March;13;2019-03-26 00:00;59;156;154;310
2019;March;13;2019-03-26 00:00;60;150;160;310
2019;March;13;2019-03-26 00:00;61;146;153;299
2019;March;13;2019-03-26 00:00;62;145;152;297
2019;March;13;2019-03-26 00:00;63;150;157;307
2019;March;13;2019-03-26 00:00;64;132;117;249
2019;March;13;2019-03-26 00:00;65;133;140;273
2019;March;13;2019-03-26 00:00;66;145;136;281
2019;March;13;2019-03-26 00:00;67;139;150;289
2019;March;13;2019-03-26 00:00;68;141;130;271
2019;March;13;2019-03-26 00:00;69;140;155;295
2019;March;13;2019-03-26 00:00;70;149;160;309
2019;March;13;2019-03-26 00:00;71;172;161;333
2019;March;13;2019-03-26 00:00;72;159;150;309
2019;March;13;2019-03-26 00:00;73;180;147;327
2019;March;13;2019-03-26 00:00;74;178;172;350
2019;March;13;2019-03-26 00:00;75;150;157;307
2019;March;13;2019-03-26 00:00;76;152;160;312
2019;March;13;2019-03-26 00:00;77;135;131;266
2019;March;13;2019-03-26 00:00;78;106;97;203
2019;March;13;2019-03-26 00:00;79;83;119;202
2019;March;13;2019-03-26 00:00;80;84;86;170
2019;March;13;2019-03-26 00:00;81;92;76;168
2019;March;13;2019-03-26 00:00;82;78;67;145
2019;March;13;2019-03-26 00:00;83;88;61;149
2019;March;13;2019-03-26 00:00;84;55;61;116
2019;March;13;2019-03-26 00:00;85;60;42;102
2019;March;13;2019-03-26 00:00;86;51;42;93
2019;March;13;2019-03-26 00:00;87;31;35;66
2019;March;13;2019-03-26 00:00;88;38;26;64
2019;March;13;2019-03-26 00:00;89;39;22;61
2019;March;13;2019-03-26 00:00;90;33;22;55
2019;March;13;2019-03-26 00:00;91;22;13;35
2019;March;13;2019-03-26 00:00;92;26;8;34
2019;March;13;2019-03-26 00:00;93;17;8;25
2019;March;13;2019-03-26 00:00;94;17;6;23
2019;March;13;2019-03-26 00:00;95;12;4;16
2019;March;13;2019-03-26 00:00;96;5;4;9
2019;March;13;2019-03-26 00:00;97;9;1;10
2019;March;13;2019-03-26 00:00;98;2;2;4
2019;March;13;2019-03-26 00:00;99;1;2;3
2019;March;13;2019-03-26 00:00;100;0;1;1
2019;March;13;2019-03-26 00:00;107;1;0;1
2019;April;14;2019-04-02 00:00;0;43;46;89
2019;April;14;2019-04-02 00:00;1;199;221;420
2019;April;14;2019-04-02 00:00;2;213;209;422
2019;April;14;2019-04-02 00:00;3;190;219;409
2019;April;14;2019-04-02 00:00;4;200;221;421
2019;April;14;2019-04-02 00:00;5;184;240;424
2019;April;14;2019-04-02 00:00;6;213;236;449
2019;April;14;2019-04-02 00:00;7;196;205;401
2019;April;14;2019-04-02 00:00;8;223;237;460
2019;April;14;2019-04-02 00:00;9;230;237;467
2019;April;14;2019-04-02 00:00;10;212;231;443
2019;April;14;2019-04-02 00:00;11;205;205;410
2019;April;14;2019-04-02 00:00;12;188;209;397
2019;April;14;2019-04-02 00:00;13;226;208;434
2019;April;14;2019-04-02 00:00;14;192;217;409
2019;April;14;2019-04-02 00:00;15;190;204;394
2019;April;14;2019-04-02 00:00;16;178;189;367
2019;April;14;2019-04-02 00:00;17;181;225;406
2019;April;14;2019-04-02 00:00;18;143;185;328
2019;April;14;2019-04-02 00:00;19;177;198;375
2019;April;14;2019-04-02 00:00;20;170;197;367
2019;April;14;2019-04-02 00:00;21;143;174;317
2019;April;14;2019-04-02 00:00;22;134;184;318
2019;April;14;2019-04-02 00:00;23;140;176;316
2019;April;14;2019-04-02 00:00;24;151;175;326
2019;April;14;2019-04-02 00:00;25;177;174;351
2019;April;14;2019-04-02 00:00;26;180;206;386
2019;April;14;2019-04-02 00:00;27;186;182;368
2019;April;14;2019-04-02 00:00;28;185;244;429
2019;April;14;2019-04-02 00:00;29;205;226;431
2019;April;14;2019-04-02 00:00;30;184;205;389
2019;April;14;2019-04-02 00:00;31;205;201;406
2019;April;14;2019-04-02 00:00;32;215;209;424
2019;April;14;2019-04-02 00:00;33;189;197;386
2019;April;14;2019-04-02 00:00;34;196;221;417
2019;April;14;2019-04-02 00:00;35;206;211;417
2019;April;14;2019-04-02 00:00;36;223;189;412
2019;April;14;2019-04-02 00:00;37;219;214;433
2019;April;14;2019-04-02 00:00;38;175;197;372
2019;April;14;2019-04-02 00:00;39;240;216;456
2019;April;14;2019-04-02 00:00;40;213;186;399
2019;April;14;2019-04-02 00:00;41;205;213;418
2019;April;14;2019-04-02 00:00;42;199;216;415
2019;April;14;2019-04-02 00:00;43;228;218;446
2019;April;14;2019-04-02 00:00;44;222;241;463
2019;April;14;2019-04-02 00:00;45;228;282;510
2019;April;14;2019-04-02 00:00;46;209;220;429
2019;April;14;2019-04-02 00:00;47;223;255;478
2019;April;14;2019-04-02 00:00;48;217;224;441
2019;April;14;2019-04-02 00:00;49;205;223;428
2019;April;14;2019-04-02 00:00;50;196;199;395
2019;April;14;2019-04-02 00:00;51;206;222;428
2019;April;14;2019-04-02 00:00;52;237;231;468
2019;April;14;2019-04-02 00:00;53;187;217;404
2019;April;14;2019-04-02 00:00;54;198;218;416
2019;April;14;2019-04-02 00:00;55;190;218;408
2019;April;14;2019-04-02 00:00;56;178;217;395
2019;April;14;2019-04-02 00:00;57;185;184;369
2019;April;14;2019-04-02 00:00;58;149;168;317
2019;April;14;2019-04-02 00:00;59;156;154;310
2019;April;14;2019-04-02 00:00;60;152;161;313
2019;April;14;2019-04-02 00:00;61;146;154;300
2019;April;14;2019-04-02 00:00;62;145;152;297
2019;April;14;2019-04-02 00:00;63;149;157;306
2019;April;14;2019-04-02 00:00;64;133;117;250
2019;April;14;2019-04-02 00:00;65;133;140;273
2019;April;14;2019-04-02 00:00;66;145;136;281
2019;April;14;2019-04-02 00:00;67;139;150;289
2019;April;14;2019-04-02 00:00;68;141;130;271
2019;April;14;2019-04-02 00:00;69;139;155;294
2019;April;14;2019-04-02 00:00;70;149;160;309
2019;April;14;2019-04-02 00:00;71;172;161;333
2019;April;14;2019-04-02 00:00;72;159;150;309
2019;April;14;2019-04-02 00:00;73;179;146;325
2019;April;14;2019-04-02 00:00;74;178;172;350
2019;April;14;2019-04-02 00:00;75;150;156;306
2019;April;14;2019-04-02 00:00;76;152;160;312
2019;April;14;2019-04-02 00:00;77;135;131;266
2019;April;14;2019-04-02 00:00;78;106;97;203
2019;April;14;2019-04-02 00:00;79;83;119;202
2019;April;14;2019-04-02 00:00;80;84;86;170
2019;April;14;2019-04-02 00:00;81;92;76;168
2019;April;14;2019-04-02 00:00;82;78;67;145
2019;April;14;2019-04-02 00:00;83;88;61;149
2019;April;14;2019-04-02 00:00;84;55;61;116
2019;April;14;2019-04-02 00:00;85;60;42;102
2019;April;14;2019-04-02 00:00;86;50;42;92
2019;April;14;2019-04-02 00:00;87;30;34;64
2019;April;14;2019-04-02 00:00;88;38;26;64
2019;April;14;2019-04-02 00:00;89;39;21;60
2019;April;14;2019-04-02 00:00;90;33;22;55
2019;April;14;2019-04-02 00:00;91;23;13;36
2019;April;14;2019-04-02 00:00;92;26;8;34
2019;April;14;2019-04-02 00:00;93;17;8;25
2019;April;14;2019-04-02 00:00;94;17;6;23
2019;April;14;2019-04-02 00:00;95;12;3;15
2019;April;14;2019-04-02 00:00;96;5;4;9
2019;April;14;2019-04-02 00:00;97;8;1;9
2019;April;14;2019-04-02 00:00;98;2;2;4
2019;April;14;2019-04-02 00:00;99;1;2;3
2019;April;14;2019-04-02 00:00;100;0;1;1
2019;April;14;2019-04-02 00:00;107;1;0;1
2019;April;15;2019-04-09 00:00;0;43;48;91
2019;April;15;2019-04-09 00:00;1;198;221;419
2019;April;15;2019-04-09 00:00;2;213;209;422
2019;April;15;2019-04-09 00:00;3;190;219;409
2019;April;15;2019-04-09 00:00;4;200;221;421
2019;April;15;2019-04-09 00:00;5;184;240;424
2019;April;15;2019-04-09 00:00;6;213;236;449
2019;April;15;2019-04-09 00:00;7;196;205;401
2019;April;15;2019-04-09 00:00;8;223;237;460
2019;April;15;2019-04-09 00:00;9;230;236;466
2019;April;15;2019-04-09 00:00;10;212;231;443
2019;April;15;2019-04-09 00:00;11;205;205;410
2019;April;15;2019-04-09 00:00;12;189;209;398
2019;April;15;2019-04-09 00:00;13;226;208;434
2019;April;15;2019-04-09 00:00;14;192;217;409
2019;April;15;2019-04-09 00:00;15;190;204;394
2019;April;15;2019-04-09 00:00;16;178;189;367
2019;April;15;2019-04-09 00:00;17;181;224;405
2019;April;15;2019-04-09 00:00;18;143;185;328
2019;April;15;2019-04-09 00:00;19;177;198;375
2019;April;15;2019-04-09 00:00;20;171;196;367
2019;April;15;2019-04-09 00:00;21;143;176;319
2019;April;15;2019-04-09 00:00;22;134;183;317
2019;April;15;2019-04-09 00:00;23;140;176;316
2019;April;15;2019-04-09 00:00;24;151;175;326
2019;April;15;2019-04-09 00:00;25;177;175;352
2019;April;15;2019-04-09 00:00;26;179;206;385
2019;April;15;2019-04-09 00:00;27;187;184;371
2019;April;15;2019-04-09 00:00;28;185;242;427
2019;April;15;2019-04-09 00:00;29;205;226;431
2019;April;15;2019-04-09 00:00;30;183;208;391
2019;April;15;2019-04-09 00:00;31;204;200;404
2019;April;15;2019-04-09 00:00;32;216;208;424
2019;April;15;2019-04-09 00:00;33;190;198;388
2019;April;15;2019-04-09 00:00;34;197;221;418
2019;April;15;2019-04-09 00:00;35;206;211;417
2019;April;15;2019-04-09 00:00;36;223;189;412
2019;April;15;2019-04-09 00:00;37;219;215;434
2019;April;15;2019-04-09 00:00;38;175;197;372
2019;April;15;2019-04-09 00:00;39;239;216;455
2019;April;15;2019-04-09 00:00;40;213;186;399
2019;April;15;2019-04-09 00:00;41;205;213;418
2019;April;15;2019-04-09 00:00;42;199;216;415
2019;April;15;2019-04-09 00:00;43;228;218;446
2019;April;15;2019-04-09 00:00;44;222;240;462
2019;April;15;2019-04-09 00:00;45;228;282;510
2019;April;15;2019-04-09 00:00;46;209;219;428
2019;April;15;2019-04-09 00:00;47;223;255;478
2019;April;15;2019-04-09 00:00;48;217;224;441
2019;April;15;2019-04-09 00:00;49;205;223;428
2019;April;15;2019-04-09 00:00;50;197;199;396
2019;April;15;2019-04-09 00:00;51;206;222;428
2019;April;15;2019-04-09 00:00;52;238;231;469
2019;April;15;2019-04-09 00:00;53;186;215;401
2019;April;15;2019-04-09 00:00;54;198;218;416
2019;April;15;2019-04-09 00:00;55;189;218;407
2019;April;15;2019-04-09 00:00;56;178;217;395
2019;April;15;2019-04-09 00:00;57;185;184;369
2019;April;15;2019-04-09 00:00;58;149;168;317
2019;April;15;2019-04-09 00:00;59;156;154;310
2019;April;15;2019-04-09 00:00;60;152;161;313
2019;April;15;2019-04-09 00:00;61;146;154;300
2019;April;15;2019-04-09 00:00;62;145;152;297
2019;April;15;2019-04-09 00:00;63;149;157;306
2019;April;15;2019-04-09 00:00;64;133;117;250
2019;April;15;2019-04-09 00:00;65;133;139;272
2019;April;15;2019-04-09 00:00;66;145;136;281
2019;April;15;2019-04-09 00:00;67;138;150;288
2019;April;15;2019-04-09 00:00;68;141;129;270
2019;April;15;2019-04-09 00:00;69;138;155;293
2019;April;15;2019-04-09 00:00;70;149;160;309
2019;April;15;2019-04-09 00:00;71;172;161;333
2019;April;15;2019-04-09 00:00;72;159;150;309
2019;April;15;2019-04-09 00:00;73;179;146;325
2019;April;15;2019-04-09 00:00;74;178;171;349
2019;April;15;2019-04-09 00:00;75;150;156;306
2019;April;15;2019-04-09 00:00;76;152;160;312
2019;April;15;2019-04-09 00:00;77;135;131;266
2019;April;15;2019-04-09 00:00;78;106;97;203
2019;April;15;2019-04-09 00:00;79;84;119;203
2019;April;15;2019-04-09 00:00;80;84;86;170
2019;April;15;2019-04-09 00:00;81;93;76;169
2019;April;15;2019-04-09 00:00;82;78;67;145
2019;April;15;2019-04-09 00:00;83;88;59;147
2019;April;15;2019-04-09 00:00;84;55;60;115
2019;April;15;2019-04-09 00:00;85;58;42;100
2019;April;15;2019-04-09 00:00;86;50;42;92
2019;April;15;2019-04-09 00:00;87;30;34;64
2019;April;15;2019-04-09 00:00;88;38;26;64
2019;April;15;2019-04-09 00:00;89;39;21;60
2019;April;15;2019-04-09 00:00;90;33;22;55
2019;April;15;2019-04-09 00:00;91;23;13;36
2019;April;15;2019-04-09 00:00;92;26;8;34
2019;April;15;2019-04-09 00:00;93;17;8;25
2019;April;15;2019-04-09 00:00;94;17;5;22
2019;April;15;2019-04-09 00:00;95;11;3;14
2019;April;15;2019-04-09 00:00;96;5;4;9
2019;April;15;2019-04-09 00:00;97;8;1;9
2019;April;15;2019-04-09 00:00;98;2;2;4
2019;April;15;2019-04-09 00:00;99;1;2;3
2019;April;15;2019-04-09 00:00;100;0;1;1
2019;April;15;2019-04-09 00:00;107;1;0;1
2019;April;16;2019-04-16 00:00;0;44;52;96
2019;April;16;2019-04-16 00:00;1;199;222;421
2019;April;16;2019-04-16 00:00;2;213;209;422
2019;April;16;2019-04-16 00:00;3;190;219;409
2019;April;16;2019-04-16 00:00;4;200;221;421
2019;April;16;2019-04-16 00:00;5;184;242;426
2019;April;16;2019-04-16 00:00;6;213;236;449
2019;April;16;2019-04-16 00:00;7;196;206;402
2019;April;16;2019-04-16 00:00;8;223;237;460
2019;April;16;2019-04-16 00:00;9;230;236;466
2019;April;16;2019-04-16 00:00;10;212;231;443
2019;April;16;2019-04-16 00:00;11;205;205;410
2019;April;16;2019-04-16 00:00;12;189;209;398
2019;April;16;2019-04-16 00:00;13;225;208;433
2019;April;16;2019-04-16 00:00;14;192;217;409
2019;April;16;2019-04-16 00:00;15;190;204;394
2019;April;16;2019-04-16 00:00;16;178;188;366
2019;April;16;2019-04-16 00:00;17;181;225;406
2019;April;16;2019-04-16 00:00;18;143;185;328
2019;April;16;2019-04-16 00:00;19;177;198;375
2019;April;16;2019-04-16 00:00;20;171;196;367
2019;April;16;2019-04-16 00:00;21;142;176;318
2019;April;16;2019-04-16 00:00;22;134;182;316
2019;April;16;2019-04-16 00:00;23;140;176;316
2019;April;16;2019-04-16 00:00;24;151;176;327
2019;April;16;2019-04-16 00:00;25;177;175;352
2019;April;16;2019-04-16 00:00;26;178;206;384
2019;April;16;2019-04-16 00:00;27;189;184;373
2019;April;16;2019-04-16 00:00;28;185;242;427
2019;April;16;2019-04-16 00:00;29;206;226;432
2019;April;16;2019-04-16 00:00;30;183;210;393
2019;April;16;2019-04-16 00:00;31;204;200;404
2019;April;16;2019-04-16 00:00;32;215;208;423
2019;April;16;2019-04-16 00:00;33;191;198;389
2019;April;16;2019-04-16 00:00;34;196;221;417
2019;April;16;2019-04-16 00:00;35;206;210;416
2019;April;16;2019-04-16 00:00;36;224;187;411
2019;April;16;2019-04-16 00:00;37;219;213;432
2019;April;16;2019-04-16 00:00;38;177;197;374
2019;April;16;2019-04-16 00:00;39;239;216;455
2019;April;16;2019-04-16 00:00;40;214;186;400
2019;April;16;2019-04-16 00:00;41;205;213;418
2019;April;16;2019-04-16 00:00;42;198;216;414
2019;April;16;2019-04-16 00:00;43;228;218;446
2019;April;16;2019-04-16 00:00;44;222;240;462
2019;April;16;2019-04-16 00:00;45;228;282;510
2019;April;16;2019-04-16 00:00;46;209;220;429
2019;April;16;2019-04-16 00:00;47;223;255;478
2019;April;16;2019-04-16 00:00;48;217;224;441
2019;April;16;2019-04-16 00:00;49;205;222;427
2019;April;16;2019-04-16 00:00;50;197;199;396
2019;April;16;2019-04-16 00:00;51;206;222;428
2019;April;16;2019-04-16 00:00;52;238;231;469
2019;April;16;2019-04-16 00:00;53;186;215;401
2019;April;16;2019-04-16 00:00;54;198;219;417
2019;April;16;2019-04-16 00:00;55;189;218;407
2019;April;16;2019-04-16 00:00;56;178;217;395
2019;April;16;2019-04-16 00:00;57;185;184;369
2019;April;16;2019-04-16 00:00;58;149;168;317
2019;April;16;2019-04-16 00:00;59;156;154;310
2019;April;16;2019-04-16 00:00;60;152;161;313
2019;April;16;2019-04-16 00:00;61;146;154;300
2019;April;16;2019-04-16 00:00;62;145;152;297
2019;April;16;2019-04-16 00:00;63;149;157;306
2019;April;16;2019-04-16 00:00;64;133;117;250
2019;April;16;2019-04-16 00:00;65;133;139;272
2019;April;16;2019-04-16 00:00;66;145;135;280
2019;April;16;2019-04-16 00:00;67;138;150;288
2019;April;16;2019-04-16 00:00;68;141;129;270
2019;April;16;2019-04-16 00:00;69;138;155;293
2019;April;16;2019-04-16 00:00;70;149;160;309
2019;April;16;2019-04-16 00:00;71;172;161;333
2019;April;16;2019-04-16 00:00;72;159;150;309
2019;April;16;2019-04-16 00:00;73;179;146;325
2019;April;16;2019-04-16 00:00;74;178;171;349
2019;April;16;2019-04-16 00:00;75;150;156;306
2019;April;16;2019-04-16 00:00;76;151;159;310
2019;April;16;2019-04-16 00:00;77;135;131;266
2019;April;16;2019-04-16 00:00;78;106;97;203
2019;April;16;2019-04-16 00:00;79;84;119;203
2019;April;16;2019-04-16 00:00;80;84;86;170
2019;April;16;2019-04-16 00:00;81;93;76;169
2019;April;16;2019-04-16 00:00;82;78;67;145
2019;April;16;2019-04-16 00:00;83;88;59;147
2019;April;16;2019-04-16 00:00;84;55;60;115
2019;April;16;2019-04-16 00:00;85;58;42;100
2019;April;16;2019-04-16 00:00;86;50;42;92
2019;April;16;2019-04-16 00:00;87;30;34;64
2019;April;16;2019-04-16 00:00;88;38;26;64
2019;April;16;2019-04-16 00:00;89;39;21;60
2019;April;16;2019-04-16 00:00;90;33;22;55
2019;April;16;2019-04-16 00:00;91;23;13;36
2019;April;16;2019-04-16 00:00;92;25;8;33
2019;April;16;2019-04-16 00:00;93;17;8;25
2019;April;16;2019-04-16 00:00;94;17;5;22
2019;April;16;2019-04-16 00:00;95;11;3;14
2019;April;16;2019-04-16 00:00;96;5;4;9
2019;April;16;2019-04-16 00:00;97;8;1;9
2019;April;16;2019-04-16 00:00;98;2;2;4
2019;April;16;2019-04-16 00:00;99;1;2;3
2019;April;16;2019-04-16 00:00;100;0;1;1
2019;April;16;2019-04-16 00:00;107;1;0;1
2019;April;17;2019-04-23 00:00;0;48;54;102
2019;April;17;2019-04-23 00:00;1;199;221;420
2019;April;17;2019-04-23 00:00;2;214;209;423
2019;April;17;2019-04-23 00:00;3;191;219;410
2019;April;17;2019-04-23 00:00;4;200;221;421
2019;April;17;2019-04-23 00:00;5;184;242;426
2019;April;17;2019-04-23 00:00;6;213;235;448
2019;April;17;2019-04-23 00:00;7;196;206;402
2019;April;17;2019-04-23 00:00;8;223;237;460
2019;April;17;2019-04-23 00:00;9;230;236;466
2019;April;17;2019-04-23 00:00;10;212;231;443
2019;April;17;2019-04-23 00:00;11;206;205;411
2019;April;17;2019-04-23 00:00;12;189;209;398
2019;April;17;2019-04-23 00:00;13;225;208;433
2019;April;17;2019-04-23 00:00;14;192;218;410
2019;April;17;2019-04-23 00:00;15;190;204;394
2019;April;17;2019-04-23 00:00;16;178;188;366
2019;April;17;2019-04-23 00:00;17;182;225;407
2019;April;17;2019-04-23 00:00;18;142;185;327
2019;April;17;2019-04-23 00:00;19;178;198;376
2019;April;17;2019-04-23 00:00;20;171;197;368
2019;April;17;2019-04-23 00:00;21;142;175;317
2019;April;17;2019-04-23 00:00;22;134;182;316
2019;April;17;2019-04-23 00:00;23;140;176;316
2019;April;17;2019-04-23 00:00;24;152;175;327
2019;April;17;2019-04-23 00:00;25;177;176;353
2019;April;17;2019-04-23 00:00;26;177;207;384
2019;April;17;2019-04-23 00:00;27;187;184;371
2019;April;17;2019-04-23 00:00;28;185;242;427
2019;April;17;2019-04-23 00:00;29;206;224;430
2019;April;17;2019-04-23 00:00;30;185;211;396
2019;April;17;2019-04-23 00:00;31;206;201;407
2019;April;17;2019-04-23 00:00;32;215;208;423
2019;April;17;2019-04-23 00:00;33;191;197;388
2019;April;17;2019-04-23 00:00;34;196;221;417
2019;April;17;2019-04-23 00:00;35;207;210;417
2019;April;17;2019-04-23 00:00;36;224;188;412
2019;April;17;2019-04-23 00:00;37;219;213;432
2019;April;17;2019-04-23 00:00;38;177;198;375
2019;April;17;2019-04-23 00:00;39;240;216;456
2019;April;17;2019-04-23 00:00;40;214;185;399
2019;April;17;2019-04-23 00:00;41;205;213;418
2019;April;17;2019-04-23 00:00;42;198;216;414
2019;April;17;2019-04-23 00:00;43;227;218;445
2019;April;17;2019-04-23 00:00;44;221;241;462
2019;April;17;2019-04-23 00:00;45;228;282;510
2019;April;17;2019-04-23 00:00;46;209;220;429
2019;April;17;2019-04-23 00:00;47;223;255;478
2019;April;17;2019-04-23 00:00;48;217;224;441
2019;April;17;2019-04-23 00:00;49;204;223;427
2019;April;17;2019-04-23 00:00;50;196;199;395
2019;April;17;2019-04-23 00:00;51;206;222;428
2019;April;17;2019-04-23 00:00;52;238;232;470
2019;April;17;2019-04-23 00:00;53;186;215;401
2019;April;17;2019-04-23 00:00;54;197;220;417
2019;April;17;2019-04-23 00:00;55;189;217;406
2019;April;17;2019-04-23 00:00;56;178;217;395
2019;April;17;2019-04-23 00:00;57;185;184;369
2019;April;17;2019-04-23 00:00;58;149;168;317
2019;April;17;2019-04-23 00:00;59;156;154;310
2019;April;17;2019-04-23 00:00;60;153;161;314
2019;April;17;2019-04-23 00:00;61;146;154;300
2019;April;17;2019-04-23 00:00;62;145;152;297
2019;April;17;2019-04-23 00:00;63;149;157;306
2019;April;17;2019-04-23 00:00;64;133;117;250
2019;April;17;2019-04-23 00:00;65;133;140;273
2019;April;17;2019-04-23 00:00;66;145;134;279
2019;April;17;2019-04-23 00:00;67;138;150;288
2019;April;17;2019-04-23 00:00;68;141;129;270
2019;April;17;2019-04-23 00:00;69;138;155;293
2019;April;17;2019-04-23 00:00;70;149;160;309
2019;April;17;2019-04-23 00:00;71;172;161;333
2019;April;17;2019-04-23 00:00;72;159;150;309
2019;April;17;2019-04-23 00:00;73;179;146;325
2019;April;17;2019-04-23 00:00;74;178;171;349
2019;April;17;2019-04-23 00:00;75;150;155;305
2019;April;17;2019-04-23 00:00;76;151;159;310
2019;April;17;2019-04-23 00:00;77;135;131;266
2019;April;17;2019-04-23 00:00;78;106;97;203
2019;April;17;2019-04-23 00:00;79;84;119;203
2019;April;17;2019-04-23 00:00;80;85;86;171
2019;April;17;2019-04-23 00:00;81;93;76;169
2019;April;17;2019-04-23 00:00;82;78;67;145
2019;April;17;2019-04-23 00:00;83;87;57;144
2019;April;17;2019-04-23 00:00;84;55;59;114
2019;April;17;2019-04-23 00:00;85;58;42;100
2019;April;17;2019-04-23 00:00;86;50;42;92
2019;April;17;2019-04-23 00:00;87;30;34;64
2019;April;17;2019-04-23 00:00;88;38;26;64
2019;April;17;2019-04-23 00:00;89;39;21;60
2019;April;17;2019-04-23 00:00;90;33;21;54
2019;April;17;2019-04-23 00:00;91;23;13;36
2019;April;17;2019-04-23 00:00;92;25;8;33
2019;April;17;2019-04-23 00:00;93;17;8;25
2019;April;17;2019-04-23 00:00;94;17;5;22
2019;April;17;2019-04-23 00:00;95;11;3;14
2019;April;17;2019-04-23 00:00;96;5;4;9
2019;April;17;2019-04-23 00:00;97;8;1;9
2019;April;17;2019-04-23 00:00;98;2;2;4
2019;April;17;2019-04-23 00:00;99;1;2;3
2019;April;17;2019-04-23 00:00;100;0;1;1
2019;April;17;2019-04-23 00:00;107;1;0;1
2019;April;18;2019-04-30 00:00;0;49;57;106
2019;April;18;2019-04-30 00:00;1;199;221;420
2019;April;18;2019-04-30 00:00;2;214;210;424
2019;April;18;2019-04-30 00:00;3;191;219;410
2019;April;18;2019-04-30 00:00;4;200;222;422
2019;April;18;2019-04-30 00:00;5;185;242;427
2019;April;18;2019-04-30 00:00;6;213;235;448
2019;April;18;2019-04-30 00:00;7;197;206;403
2019;April;18;2019-04-30 00:00;8;223;237;460
2019;April;18;2019-04-30 00:00;9;230;236;466
2019;April;18;2019-04-30 00:00;10;212;231;443
2019;April;18;2019-04-30 00:00;11;206;205;411
2019;April;18;2019-04-30 00:00;12;189;209;398
2019;April;18;2019-04-30 00:00;13;225;207;432
2019;April;18;2019-04-30 00:00;14;192;218;410
2019;April;18;2019-04-30 00:00;15;190;205;395
2019;April;18;2019-04-30 00:00;16;178;188;366
2019;April;18;2019-04-30 00:00;17;183;226;409
2019;April;18;2019-04-30 00:00;18;142;185;327
2019;April;18;2019-04-30 00:00;19;178;198;376
2019;April;18;2019-04-30 00:00;20;171;196;367
2019;April;18;2019-04-30 00:00;21;142;175;317
2019;April;18;2019-04-30 00:00;22;134;182;316
2019;April;18;2019-04-30 00:00;23;141;176;317
2019;April;18;2019-04-30 00:00;24;151;176;327
2019;April;18;2019-04-30 00:00;25;177;177;354
2019;April;18;2019-04-30 00:00;26;177;207;384
2019;April;18;2019-04-30 00:00;27;188;184;372
2019;April;18;2019-04-30 00:00;28;185;243;428
2019;April;18;2019-04-30 00:00;29;205;226;431
2019;April;18;2019-04-30 00:00;30;185;211;396
2019;April;18;2019-04-30 00:00;31;207;203;410
2019;April;18;2019-04-30 00:00;32;215;208;423
2019;April;18;2019-04-30 00:00;33;192;200;392
2019;April;18;2019-04-30 00:00;34;197;221;418
2019;April;18;2019-04-30 00:00;35;207;210;417
2019;April;18;2019-04-30 00:00;36;224;188;412
2019;April;18;2019-04-30 00:00;37;219;212;431
2019;April;18;2019-04-30 00:00;38;177;198;375
2019;April;18;2019-04-30 00:00;39;240;216;456
2019;April;18;2019-04-30 00:00;40;215;185;400
2019;April;18;2019-04-30 00:00;41;205;213;418
2019;April;18;2019-04-30 00:00;42;198;216;414
2019;April;18;2019-04-30 00:00;43;227;219;446
2019;April;18;2019-04-30 00:00;44;221;241;462
2019;April;18;2019-04-30 00:00;45;228;282;510
2019;April;18;2019-04-30 00:00;46;209;220;429
2019;April;18;2019-04-30 00:00;47;223;255;478
2019;April;18;2019-04-30 00:00;48;217;224;441
2019;April;18;2019-04-30 00:00;49;204;223;427
2019;April;18;2019-04-30 00:00;50;196;199;395
2019;April;18;2019-04-30 00:00;51;206;222;428
2019;April;18;2019-04-30 00:00;52;238;231;469
2019;April;18;2019-04-30 00:00;53;186;215;401
2019;April;18;2019-04-30 00:00;54;197;220;417
2019;April;18;2019-04-30 00:00;55;189;217;406
2019;April;18;2019-04-30 00:00;56;178;216;394
2019;April;18;2019-04-30 00:00;57;184;184;368
2019;April;18;2019-04-30 00:00;58;149;168;317
2019;April;18;2019-04-30 00:00;59;156;153;309
2019;April;18;2019-04-30 00:00;60;153;161;314
2019;April;18;2019-04-30 00:00;61;145;154;299
2019;April;18;2019-04-30 00:00;62;145;152;297
2019;April;18;2019-04-30 00:00;63;149;158;307
2019;April;18;2019-04-30 00:00;64;133;117;250
2019;April;18;2019-04-30 00:00;65;133;140;273
2019;April;18;2019-04-30 00:00;66;145;134;279
2019;April;18;2019-04-30 00:00;67;138;150;288
2019;April;18;2019-04-30 00:00;68;141;130;271
2019;April;18;2019-04-30 00:00;69;138;155;293
2019;April;18;2019-04-30 00:00;70;149;160;309
2019;April;18;2019-04-30 00:00;71;172;161;333
2019;April;18;2019-04-30 00:00;72;159;150;309
2019;April;18;2019-04-30 00:00;73;179;146;325
2019;April;18;2019-04-30 00:00;74;178;170;348
2019;April;18;2019-04-30 00:00;75;150;154;304
2019;April;18;2019-04-30 00:00;76;151;159;310
2019;April;18;2019-04-30 00:00;77;135;131;266
2019;April;18;2019-04-30 00:00;78;106;97;203
2019;April;18;2019-04-30 00:00;79;84;119;203
2019;April;18;2019-04-30 00:00;80;85;86;171
2019;April;18;2019-04-30 00:00;81;92;76;168
2019;April;18;2019-04-30 00:00;82;78;67;145
2019;April;18;2019-04-30 00:00;83;87;57;144
2019;April;18;2019-04-30 00:00;84;55;59;114
2019;April;18;2019-04-30 00:00;85;58;42;100
2019;April;18;2019-04-30 00:00;86;50;42;92
2019;April;18;2019-04-30 00:00;87;30;34;64
2019;April;18;2019-04-30 00:00;88;38;25;63
2019;April;18;2019-04-30 00:00;89;39;21;60
2019;April;18;2019-04-30 00:00;90;33;21;54
2019;April;18;2019-04-30 00:00;91;22;13;35
2019;April;18;2019-04-30 00:00;92;25;8;33
2019;April;18;2019-04-30 00:00;93;17;8;25
2019;April;18;2019-04-30 00:00;94;17;5;22
2019;April;18;2019-04-30 00:00;95;11;3;14
2019;April;18;2019-04-30 00:00;96;5;4;9
2019;April;18;2019-04-30 00:00;97;8;1;9
2019;April;18;2019-04-30 00:00;98;2;2;4
2019;April;18;2019-04-30 00:00;99;1;2;3
2019;April;18;2019-04-30 00:00;100;0;1;1
2019;April;18;2019-04-30 00:00;107;1;0;1
2019;May;19;2019-05-07 00:00;0;58;61;119
2019;May;19;2019-05-07 00:00;1;200;222;422
2019;May;19;2019-05-07 00:00;2;214;210;424
2019;May;19;2019-05-07 00:00;3;192;219;411
2019;May;19;2019-05-07 00:00;4;198;221;419
2019;May;19;2019-05-07 00:00;5;185;242;427
2019;May;19;2019-05-07 00:00;6;212;235;447
2019;May;19;2019-05-07 00:00;7;197;204;401
2019;May;19;2019-05-07 00:00;8;221;237;458
2019;May;19;2019-05-07 00:00;9;230;236;466
2019;May;19;2019-05-07 00:00;10;212;230;442
2019;May;19;2019-05-07 00:00;11;206;206;412
2019;May;19;2019-05-07 00:00;12;189;209;398
2019;May;19;2019-05-07 00:00;13;224;207;431
2019;May;19;2019-05-07 00:00;14;192;218;410
2019;May;19;2019-05-07 00:00;15;190;204;394
2019;May;19;2019-05-07 00:00;16;178;188;366
2019;May;19;2019-05-07 00:00;17;183;226;409
2019;May;19;2019-05-07 00:00;18;142;185;327
2019;May;19;2019-05-07 00:00;19;178;198;376
2019;May;19;2019-05-07 00:00;20;172;198;370
2019;May;19;2019-05-07 00:00;21;140;176;316
2019;May;19;2019-05-07 00:00;22;132;183;315
2019;May;19;2019-05-07 00:00;23;142;176;318
2019;May;19;2019-05-07 00:00;24;151;176;327
2019;May;19;2019-05-07 00:00;25;177;180;357
2019;May;19;2019-05-07 00:00;26;177;206;383
2019;May;19;2019-05-07 00:00;27;189;183;372
2019;May;19;2019-05-07 00:00;28;185;243;428
2019;May;19;2019-05-07 00:00;29;206;225;431
2019;May;19;2019-05-07 00:00;30;185;213;398
2019;May;19;2019-05-07 00:00;31;206;201;407
2019;May;19;2019-05-07 00:00;32;215;208;423
2019;May;19;2019-05-07 00:00;33;193;200;393
2019;May;19;2019-05-07 00:00;34;197;221;418
2019;May;19;2019-05-07 00:00;35;206;210;416
2019;May;19;2019-05-07 00:00;36;223;189;412
2019;May;19;2019-05-07 00:00;37;217;211;428
2019;May;19;2019-05-07 00:00;38;177;198;375
2019;May;19;2019-05-07 00:00;39;240;216;456
2019;May;19;2019-05-07 00:00;40;215;184;399
2019;May;19;2019-05-07 00:00;41;205;212;417
2019;May;19;2019-05-07 00:00;42;199;216;415
2019;May;19;2019-05-07 00:00;43;226;219;445
2019;May;19;2019-05-07 00:00;44;221;240;461
2019;May;19;2019-05-07 00:00;45;228;280;508
2019;May;19;2019-05-07 00:00;46;209;219;428
2019;May;19;2019-05-07 00:00;47;223;256;479
2019;May;19;2019-05-07 00:00;48;216;224;440
2019;May;19;2019-05-07 00:00;49;204;223;427
2019;May;19;2019-05-07 00:00;50;195;198;393
2019;May;19;2019-05-07 00:00;51;206;222;428
2019;May;19;2019-05-07 00:00;52;239;230;469
2019;May;19;2019-05-07 00:00;53;186;215;401
2019;May;19;2019-05-07 00:00;54;197;220;417
2019;May;19;2019-05-07 00:00;55;189;217;406
2019;May;19;2019-05-07 00:00;56;178;216;394
2019;May;19;2019-05-07 00:00;57;184;183;367
2019;May;19;2019-05-07 00:00;58;149;168;317
2019;May;19;2019-05-07 00:00;59;156;153;309
2019;May;19;2019-05-07 00:00;60;153;160;313
2019;May;19;2019-05-07 00:00;61;145;154;299
2019;May;19;2019-05-07 00:00;62;145;152;297
2019;May;19;2019-05-07 00:00;63;149;158;307
2019;May;19;2019-05-07 00:00;64;133;117;250
2019;May;19;2019-05-07 00:00;65;133;140;273
2019;May;19;2019-05-07 00:00;66;144;134;278
2019;May;19;2019-05-07 00:00;67;138;150;288
2019;May;19;2019-05-07 00:00;68;140;130;270
2019;May;19;2019-05-07 00:00;69;138;155;293
2019;May;19;2019-05-07 00:00;70;149;159;308
2019;May;19;2019-05-07 00:00;71;173;162;335
2019;May;19;2019-05-07 00:00;72;158;150;308
2019;May;19;2019-05-07 00:00;73;180;146;326
2019;May;19;2019-05-07 00:00;74;178;170;348
2019;May;19;2019-05-07 00:00;75;150;154;304
2019;May;19;2019-05-07 00:00;76;151;158;309
2019;May;19;2019-05-07 00:00;77;134;131;265
2019;May;19;2019-05-07 00:00;78;106;97;203
2019;May;19;2019-05-07 00:00;79;84;119;203
2019;May;19;2019-05-07 00:00;80;85;86;171
2019;May;19;2019-05-07 00:00;81;92;76;168
2019;May;19;2019-05-07 00:00;82;78;67;145
2019;May;19;2019-05-07 00:00;83;87;57;144
2019;May;19;2019-05-07 00:00;84;54;59;113
2019;May;19;2019-05-07 00:00;85;58;42;100
2019;May;19;2019-05-07 00:00;86;50;42;92
2019;May;19;2019-05-07 00:00;87;29;34;63
2019;May;19;2019-05-07 00:00;88;37;25;62
2019;May;19;2019-05-07 00:00;89;39;21;60
2019;May;19;2019-05-07 00:00;90;33;21;54
2019;May;19;2019-05-07 00:00;91;22;13;35
2019;May;19;2019-05-07 00:00;92;25;8;33
2019;May;19;2019-05-07 00:00;93;17;8;25
2019;May;19;2019-05-07 00:00;94;17;5;22
2019;May;19;2019-05-07 00:00;95;11;3;14
2019;May;19;2019-05-07 00:00;96;5;4;9
2019;May;19;2019-05-07 00:00;97;8;1;9
2019;May;19;2019-05-07 00:00;98;2;2;4
2019;May;19;2019-05-07 00:00;99;1;2;3
2019;May;19;2019-05-07 00:00;100;0;1;1
2019;May;19;2019-05-07 00:00;107;1;0;1
2019;May;20;2019-05-14 00:00;0;60;64;124
2019;May;20;2019-05-14 00:00;1;200;222;422
2019;May;20;2019-05-14 00:00;2;214;211;425
2019;May;20;2019-05-14 00:00;3;192;218;410
2019;May;20;2019-05-14 00:00;4;199;221;420
2019;May;20;2019-05-14 00:00;5;185;242;427
2019;May;20;2019-05-14 00:00;6;212;235;447
2019;May;20;2019-05-14 00:00;7;197;205;402
2019;May;20;2019-05-14 00:00;8;221;237;458
2019;May;20;2019-05-14 00:00;9;230;237;467
2019;May;20;2019-05-14 00:00;10;212;230;442
2019;May;20;2019-05-14 00:00;11;206;206;412
2019;May;20;2019-05-14 00:00;12;189;208;397
2019;May;20;2019-05-14 00:00;13;224;207;431
2019;May;20;2019-05-14 00:00;14;192;219;411
2019;May;20;2019-05-14 00:00;15;190;204;394
2019;May;20;2019-05-14 00:00;16;178;188;366
2019;May;20;2019-05-14 00:00;17;184;226;410
2019;May;20;2019-05-14 00:00;18;142;185;327
2019;May;20;2019-05-14 00:00;19;178;197;375
2019;May;20;2019-05-14 00:00;20;172;199;371
2019;May;20;2019-05-14 00:00;21;140;174;314
2019;May;20;2019-05-14 00:00;22;132;184;316
2019;May;20;2019-05-14 00:00;23;143;177;320
2019;May;20;2019-05-14 00:00;24;152;175;327
2019;May;20;2019-05-14 00:00;25;178;180;358
2019;May;20;2019-05-14 00:00;26;176;206;382
2019;May;20;2019-05-14 00:00;27;188;183;371
2019;May;20;2019-05-14 00:00;28;185;244;429
2019;May;20;2019-05-14 00:00;29;206;225;431
2019;May;20;2019-05-14 00:00;30;186;212;398
2019;May;20;2019-05-14 00:00;31;208;200;408
2019;May;20;2019-05-14 00:00;32;215;208;423
2019;May;20;2019-05-14 00:00;33;193;199;392
2019;May;20;2019-05-14 00:00;34;197;222;419
2019;May;20;2019-05-14 00:00;35;206;210;416
2019;May;20;2019-05-14 00:00;36;224;190;414
2019;May;20;2019-05-14 00:00;37;217;211;428
2019;May;20;2019-05-14 00:00;38;177;198;375
2019;May;20;2019-05-14 00:00;39;241;218;459
2019;May;20;2019-05-14 00:00;40;216;184;400
2019;May;20;2019-05-14 00:00;41;205;212;417
2019;May;20;2019-05-14 00:00;42;199;216;415
2019;May;20;2019-05-14 00:00;43;226;219;445
2019;May;20;2019-05-14 00:00;44;221;240;461
2019;May;20;2019-05-14 00:00;45;228;281;509
2019;May;20;2019-05-14 00:00;46;209;219;428
2019;May;20;2019-05-14 00:00;47;222;256;478
2019;May;20;2019-05-14 00:00;48;216;224;440
2019;May;20;2019-05-14 00:00;49;204;223;427
2019;May;20;2019-05-14 00:00;50;195;198;393
2019;May;20;2019-05-14 00:00;51;206;221;427
2019;May;20;2019-05-14 00:00;52;239;230;469
2019;May;20;2019-05-14 00:00;53;186;214;400
2019;May;20;2019-05-14 00:00;54;197;220;417
2019;May;20;2019-05-14 00:00;55;189;217;406
2019;May;20;2019-05-14 00:00;56;178;217;395
2019;May;20;2019-05-14 00:00;57;184;183;367
2019;May;20;2019-05-14 00:00;58;149;168;317
2019;May;20;2019-05-14 00:00;59;156;153;309
2019;May;20;2019-05-14 00:00;60;152;160;312
2019;May;20;2019-05-14 00:00;61;145;154;299
2019;May;20;2019-05-14 00:00;62;145;152;297
2019;May;20;2019-05-14 00:00;63;150;158;308
2019;May;20;2019-05-14 00:00;64;133;117;250
2019;May;20;2019-05-14 00:00;65;133;140;273
2019;May;20;2019-05-14 00:00;66;146;134;280
2019;May;20;2019-05-14 00:00;67;138;150;288
2019;May;20;2019-05-14 00:00;68;140;130;270
2019;May;20;2019-05-14 00:00;69;138;155;293
2019;May;20;2019-05-14 00:00;70;149;159;308
2019;May;20;2019-05-14 00:00;71;173;162;335
2019;May;20;2019-05-14 00:00;72;158;150;308
2019;May;20;2019-05-14 00:00;73;180;145;325
2019;May;20;2019-05-14 00:00;74;178;170;348
2019;May;20;2019-05-14 00:00;75;150;154;304
2019;May;20;2019-05-14 00:00;76;151;158;309
2019;May;20;2019-05-14 00:00;77;134;131;265
2019;May;20;2019-05-14 00:00;78;106;97;203
2019;May;20;2019-05-14 00:00;79;84;119;203
2019;May;20;2019-05-14 00:00;80;85;86;171
2019;May;20;2019-05-14 00:00;81;92;76;168
2019;May;20;2019-05-14 00:00;82;77;67;144
2019;May;20;2019-05-14 00:00;83;87;57;144
2019;May;20;2019-05-14 00:00;84;54;59;113
2019;May;20;2019-05-14 00:00;85;58;42;100
2019;May;20;2019-05-14 00:00;86;50;42;92
2019;May;20;2019-05-14 00:00;87;29;34;63
2019;May;20;2019-05-14 00:00;88;37;24;61
2019;May;20;2019-05-14 00:00;89;39;21;60
2019;May;20;2019-05-14 00:00;90;33;21;54
2019;May;20;2019-05-14 00:00;91;22;13;35
2019;May;20;2019-05-14 00:00;92;25;8;33
2019;May;20;2019-05-14 00:00;93;17;8;25
2019;May;20;2019-05-14 00:00;94;16;5;21
2019;May;20;2019-05-14 00:00;95;11;3;14
2019;May;20;2019-05-14 00:00;96;5;4;9
2019;May;20;2019-05-14 00:00;97;8;1;9
2019;May;20;2019-05-14 00:00;98;2;2;4
2019;May;20;2019-05-14 00:00;99;1;2;3
2019;May;20;2019-05-14 00:00;100;0;1;1
2019;May;20;2019-05-14 00:00;107;1;0;1
2019;May;21;2019-05-21 00:00;0;63;67;130
2019;May;21;2019-05-21 00:00;1;201;222;423
2019;May;21;2019-05-21 00:00;2;214;211;425
2019;May;21;2019-05-21 00:00;3;193;218;411
2019;May;21;2019-05-21 00:00;4;199;221;420
2019;May;21;2019-05-21 00:00;5;185;243;428
2019;May;21;2019-05-21 00:00;6;212;235;447
2019;May;21;2019-05-21 00:00;7;197;205;402
2019;May;21;2019-05-21 00:00;8;222;238;460
2019;May;21;2019-05-21 00:00;9;229;237;466
2019;May;21;2019-05-21 00:00;10;212;230;442
2019;May;21;2019-05-21 00:00;11;206;206;412
2019;May;21;2019-05-21 00:00;12;188;208;396
2019;May;21;2019-05-21 00:00;13;224;207;431
2019;May;21;2019-05-21 00:00;14;192;219;411
2019;May;21;2019-05-21 00:00;15;190;205;395
2019;May;21;2019-05-21 00:00;16;178;188;366
2019;May;21;2019-05-21 00:00;17;184;227;411
2019;May;21;2019-05-21 00:00;18;142;185;327
2019;May;21;2019-05-21 00:00;19;178;197;375
2019;May;21;2019-05-21 00:00;20;172;201;373
2019;May;21;2019-05-21 00:00;21;138;175;313
2019;May;21;2019-05-21 00:00;22;132;184;316
2019;May;21;2019-05-21 00:00;23;144;177;321
2019;May;21;2019-05-21 00:00;24;154;176;330
2019;May;21;2019-05-21 00:00;25;178;178;356
2019;May;21;2019-05-21 00:00;26;175;206;381
2019;May;21;2019-05-21 00:00;27;190;182;372
2019;May;21;2019-05-21 00:00;28;185;245;430
2019;May;21;2019-05-21 00:00;29;206;226;432
2019;May;21;2019-05-21 00:00;30;186;211;397
2019;May;21;2019-05-21 00:00;31;207;199;406
2019;May;21;2019-05-21 00:00;32;215;209;424
2019;May;21;2019-05-21 00:00;33;193;197;390
2019;May;21;2019-05-21 00:00;34;197;223;420
2019;May;21;2019-05-21 00:00;35;205;209;414
2019;May;21;2019-05-21 00:00;36;224;190;414
2019;May;21;2019-05-21 00:00;37;217;211;428
2019;May;21;2019-05-21 00:00;38;177;197;374
2019;May;21;2019-05-21 00:00;39;240;218;458
2019;May;21;2019-05-21 00:00;40;216;184;400
2019;May;21;2019-05-21 00:00;41;205;214;419
2019;May;21;2019-05-21 00:00;42;199;216;415
2019;May;21;2019-05-21 00:00;43;226;219;445
2019;May;21;2019-05-21 00:00;44;221;240;461
2019;May;21;2019-05-21 00:00;45;228;281;509
2019;May;21;2019-05-21 00:00;46;209;219;428
2019;May;21;2019-05-21 00:00;47;222;256;478
2019;May;21;2019-05-21 00:00;48;217;224;441
2019;May;21;2019-05-21 00:00;49;204;223;427
2019;May;21;2019-05-21 00:00;50;195;198;393
2019;May;21;2019-05-21 00:00;51;206;221;427
2019;May;21;2019-05-21 00:00;52;239;230;469
2019;May;21;2019-05-21 00:00;53;187;214;401
2019;May;21;2019-05-21 00:00;54;197;220;417
2019;May;21;2019-05-21 00:00;55;189;217;406
2019;May;21;2019-05-21 00:00;56;178;217;395
2019;May;21;2019-05-21 00:00;57;184;183;367
2019;May;21;2019-05-21 00:00;58;149;169;318
2019;May;21;2019-05-21 00:00;59;156;153;309
2019;May;21;2019-05-21 00:00;60;152;160;312
2019;May;21;2019-05-21 00:00;61;145;154;299
2019;May;21;2019-05-21 00:00;62;145;152;297
2019;May;21;2019-05-21 00:00;63;150;158;308
2019;May;21;2019-05-21 00:00;64;133;116;249
2019;May;21;2019-05-21 00:00;65;133;140;273
2019;May;21;2019-05-21 00:00;66;146;134;280
2019;May;21;2019-05-21 00:00;67;138;150;288
2019;May;21;2019-05-21 00:00;68;140;130;270
2019;May;21;2019-05-21 00:00;69;138;155;293
2019;May;21;2019-05-21 00:00;70;149;159;308
2019;May;21;2019-05-21 00:00;71;173;162;335
2019;May;21;2019-05-21 00:00;72;158;150;308
2019;May;21;2019-05-21 00:00;73;180;145;325
2019;May;21;2019-05-21 00:00;74;178;170;348
2019;May;21;2019-05-21 00:00;75;150;154;304
2019;May;21;2019-05-21 00:00;76;151;158;309
2019;May;21;2019-05-21 00:00;77;134;131;265
2019;May;21;2019-05-21 00:00;78;106;97;203
2019;May;21;2019-05-21 00:00;79;84;119;203
2019;May;21;2019-05-21 00:00;80;85;86;171
2019;May;21;2019-05-21 00:00;81;92;76;168
2019;May;21;2019-05-21 00:00;82;77;66;143
2019;May;21;2019-05-21 00:00;83;87;57;144
2019;May;21;2019-05-21 00:00;84;54;59;113
2019;May;21;2019-05-21 00:00;85;58;42;100
2019;May;21;2019-05-21 00:00;86;49;42;91
2019;May;21;2019-05-21 00:00;87;29;34;63
2019;May;21;2019-05-21 00:00;88;37;24;61
2019;May;21;2019-05-21 00:00;89;38;21;59
2019;May;21;2019-05-21 00:00;90;33;21;54
2019;May;21;2019-05-21 00:00;91;22;13;35
2019;May;21;2019-05-21 00:00;92;25;8;33
2019;May;21;2019-05-21 00:00;93;17;8;25
2019;May;21;2019-05-21 00:00;94;16;5;21
2019;May;21;2019-05-21 00:00;95;11;3;14
2019;May;21;2019-05-21 00:00;96;5;4;9
2019;May;21;2019-05-21 00:00;97;8;1;9
2019;May;21;2019-05-21 00:00;98;2;2;4
2019;May;21;2019-05-21 00:00;99;1;2;3
2019;May;21;2019-05-21 00:00;100;0;1;1
2019;May;21;2019-05-21 00:00;107;1;0;1
2019;May;22;2019-05-28 00:00;0;64;73;137
2019;May;22;2019-05-28 00:00;1;201;222;423
2019;May;22;2019-05-28 00:00;2;214;210;424
2019;May;22;2019-05-28 00:00;3;193;218;411
2019;May;22;2019-05-28 00:00;4;199;221;420
2019;May;22;2019-05-28 00:00;5;185;243;428
2019;May;22;2019-05-28 00:00;6;212;235;447
2019;May;22;2019-05-28 00:00;7;197;205;402
2019;May;22;2019-05-28 00:00;8;222;238;460
2019;May;22;2019-05-28 00:00;9;229;237;466
2019;May;22;2019-05-28 00:00;10;212;230;442
2019;May;22;2019-05-28 00:00;11;206;206;412
2019;May;22;2019-05-28 00:00;12;188;208;396
2019;May;22;2019-05-28 00:00;13;224;207;431
2019;May;22;2019-05-28 00:00;14;192;219;411
2019;May;22;2019-05-28 00:00;15;190;205;395
2019;May;22;2019-05-28 00:00;16;178;188;366
2019;May;22;2019-05-28 00:00;17;184;227;411
2019;May;22;2019-05-28 00:00;18;142;184;326
2019;May;22;2019-05-28 00:00;19;178;197;375
2019;May;22;2019-05-28 00:00;20;172;200;372
2019;May;22;2019-05-28 00:00;21;139;176;315
2019;May;22;2019-05-28 00:00;22;131;185;316
2019;May;22;2019-05-28 00:00;23;143;178;321
2019;May;22;2019-05-28 00:00;24;153;176;329
2019;May;22;2019-05-28 00:00;25;176;178;354
2019;May;22;2019-05-28 00:00;26;173;206;379
2019;May;22;2019-05-28 00:00;27;190;181;371
2019;May;22;2019-05-28 00:00;28;185;243;428
2019;May;22;2019-05-28 00:00;29;206;226;432
2019;May;22;2019-05-28 00:00;30;186;211;397
2019;May;22;2019-05-28 00:00;31;207;199;406
2019;May;22;2019-05-28 00:00;32;216;208;424
2019;May;22;2019-05-28 00:00;33;192;196;388
2019;May;22;2019-05-28 00:00;34;197;223;420
2019;May;22;2019-05-28 00:00;35;205;210;415
2019;May;22;2019-05-28 00:00;36;224;190;414
2019;May;22;2019-05-28 00:00;37;217;211;428
2019;May;22;2019-05-28 00:00;38;177;197;374
2019;May;22;2019-05-28 00:00;39;241;217;458
2019;May;22;2019-05-28 00:00;40;216;184;400
2019;May;22;2019-05-28 00:00;41;204;214;418
2019;May;22;2019-05-28 00:00;42;199;217;416
2019;May;22;2019-05-28 00:00;43;227;218;445
2019;May;22;2019-05-28 00:00;44;221;240;461
2019;May;22;2019-05-28 00:00;45;228;281;509
2019;May;22;2019-05-28 00:00;46;209;219;428
2019;May;22;2019-05-28 00:00;47;222;255;477
2019;May;22;2019-05-28 00:00;48;217;224;441
2019;May;22;2019-05-28 00:00;49;204;223;427
2019;May;22;2019-05-28 00:00;50;195;198;393
2019;May;22;2019-05-28 00:00;51;206;221;427
2019;May;22;2019-05-28 00:00;52;239;230;469
2019;May;22;2019-05-28 00:00;53;188;214;402
2019;May;22;2019-05-28 00:00;54;197;219;416
2019;May;22;2019-05-28 00:00;55;189;217;406
2019;May;22;2019-05-28 00:00;56;178;217;395
2019;May;22;2019-05-28 00:00;57;183;183;366
2019;May;22;2019-05-28 00:00;58;149;169;318
2019;May;22;2019-05-28 00:00;59;156;154;310
2019;May;22;2019-05-28 00:00;60;152;160;312
2019;May;22;2019-05-28 00:00;61;145;154;299
2019;May;22;2019-05-28 00:00;62;145;152;297
2019;May;22;2019-05-28 00:00;63;150;158;308
2019;May;22;2019-05-28 00:00;64;133;116;249
2019;May;22;2019-05-28 00:00;65;133;140;273
2019;May;22;2019-05-28 00:00;66;146;134;280
2019;May;22;2019-05-28 00:00;67;137;150;287
2019;May;22;2019-05-28 00:00;68;140;130;270
2019;May;22;2019-05-28 00:00;69;138;155;293
2019;May;22;2019-05-28 00:00;70;149;159;308
2019;May;22;2019-05-28 00:00;71;173;162;335
2019;May;22;2019-05-28 00:00;72;158;150;308
2019;May;22;2019-05-28 00:00;73;180;145;325
2019;May;22;2019-05-28 00:00;74;178;170;348
2019;May;22;2019-05-28 00:00;75;150;154;304
2019;May;22;2019-05-28 00:00;76;151;158;309
2019;May;22;2019-05-28 00:00;77;134;131;265
2019;May;22;2019-05-28 00:00;78;106;97;203
2019;May;22;2019-05-28 00:00;79;84;119;203
2019;May;22;2019-05-28 00:00;80;85;85;170
2019;May;22;2019-05-28 00:00;81;92;76;168
2019;May;22;2019-05-28 00:00;82;75;66;141
2019;May;22;2019-05-28 00:00;83;87;57;144
2019;May;22;2019-05-28 00:00;84;54;59;113
2019;May;22;2019-05-28 00:00;85;58;42;100
2019;May;22;2019-05-28 00:00;86;49;42;91
2019;May;22;2019-05-28 00:00;87;29;33;62
2019;May;22;2019-05-28 00:00;88;37;24;61
2019;May;22;2019-05-28 00:00;89;37;21;58
2019;May;22;2019-05-28 00:00;90;33;21;54
2019;May;22;2019-05-28 00:00;91;22;13;35
2019;May;22;2019-05-28 00:00;92;25;8;33
2019;May;22;2019-05-28 00:00;93;17;8;25
2019;May;22;2019-05-28 00:00;94;16;5;21
2019;May;22;2019-05-28 00:00;95;11;3;14
2019;May;22;2019-05-28 00:00;96;5;4;9
2019;May;22;2019-05-28 00:00;97;8;1;9
2019;May;22;2019-05-28 00:00;98;1;2;3
2019;May;22;2019-05-28 00:00;99;1;2;3
2019;May;22;2019-05-28 00:00;100;0;1;1
2019;May;22;2019-05-28 00:00;107;1;0;1
2019;June;23;2019-06-04 00:00;0;70;83;153
2019;June;23;2019-06-04 00:00;1;202;224;426
2019;June;23;2019-06-04 00:00;2;214;211;425
2019;June;23;2019-06-04 00:00;3;194;218;412
2019;June;23;2019-06-04 00:00;4;199;222;421
2019;June;23;2019-06-04 00:00;5;187;245;432
2019;June;23;2019-06-04 00:00;6;212;237;449
2019;June;23;2019-06-04 00:00;7;197;205;402
2019;June;23;2019-06-04 00:00;8;222;238;460
2019;June;23;2019-06-04 00:00;9;230;237;467
2019;June;23;2019-06-04 00:00;10;212;230;442
2019;June;23;2019-06-04 00:00;11;206;206;412
2019;June;23;2019-06-04 00:00;12;189;208;397
2019;June;23;2019-06-04 00:00;13;224;207;431
2019;June;23;2019-06-04 00:00;14;192;219;411
2019;June;23;2019-06-04 00:00;15;190;205;395
2019;June;23;2019-06-04 00:00;16;178;188;366
2019;June;23;2019-06-04 00:00;17;184;227;411
2019;June;23;2019-06-04 00:00;18;142;184;326
2019;June;23;2019-06-04 00:00;19;176;198;374
2019;June;23;2019-06-04 00:00;20;173;201;374
2019;June;23;2019-06-04 00:00;21;138;174;312
2019;June;23;2019-06-04 00:00;22;134;186;320
2019;June;23;2019-06-04 00:00;23;143;180;323
2019;June;23;2019-06-04 00:00;24;154;175;329
2019;June;23;2019-06-04 00:00;25;175;178;353
2019;June;23;2019-06-04 00:00;26;172;208;380
2019;June;23;2019-06-04 00:00;27;189;181;370
2019;June;23;2019-06-04 00:00;28;186;245;431
2019;June;23;2019-06-04 00:00;29;208;224;432
2019;June;23;2019-06-04 00:00;30;185;208;393
2019;June;23;2019-06-04 00:00;31;207;200;407
2019;June;23;2019-06-04 00:00;32;216;208;424
2019;June;23;2019-06-04 00:00;33;192;197;389
2019;June;23;2019-06-04 00:00;34;199;222;421
2019;June;23;2019-06-04 00:00;35;205;209;414
2019;June;23;2019-06-04 00:00;36;224;190;414
2019;June;23;2019-06-04 00:00;37;217;210;427
2019;June;23;2019-06-04 00:00;38;178;197;375
2019;June;23;2019-06-04 00:00;39;242;217;459
2019;June;23;2019-06-04 00:00;40;216;184;400
2019;June;23;2019-06-04 00:00;41;204;214;418
2019;June;23;2019-06-04 00:00;42;200;217;417
2019;June;23;2019-06-04 00:00;43;228;219;447
2019;June;23;2019-06-04 00:00;44;221;240;461
2019;June;23;2019-06-04 00:00;45;228;282;510
2019;June;23;2019-06-04 00:00;46;209;220;429
2019;June;23;2019-06-04 00:00;47;222;255;477
2019;June;23;2019-06-04 00:00;48;217;224;441
2019;June;23;2019-06-04 00:00;49;204;221;425
2019;June;23;2019-06-04 00:00;50;195;199;394
2019;June;23;2019-06-04 00:00;51;207;222;429
2019;June;23;2019-06-04 00:00;52;239;230;469
2019;June;23;2019-06-04 00:00;53;187;214;401
2019;June;23;2019-06-04 00:00;54;197;220;417
2019;June;23;2019-06-04 00:00;55;189;217;406
2019;June;23;2019-06-04 00:00;56;178;217;395
2019;June;23;2019-06-04 00:00;57;183;183;366
2019;June;23;2019-06-04 00:00;58;148;169;317
2019;June;23;2019-06-04 00:00;59;156;155;311
2019;June;23;2019-06-04 00:00;60;152;160;312
2019;June;23;2019-06-04 00:00;61;144;151;295
2019;June;23;2019-06-04 00:00;62;145;152;297
2019;June;23;2019-06-04 00:00;63;150;157;307
2019;June;23;2019-06-04 00:00;64;132;116;248
2019;June;23;2019-06-04 00:00;65;133;140;273
2019;June;23;2019-06-04 00:00;66;146;134;280
2019;June;23;2019-06-04 00:00;67;136;150;286
2019;June;23;2019-06-04 00:00;68;140;130;270
2019;June;23;2019-06-04 00:00;69;137;155;292
2019;June;23;2019-06-04 00:00;70;148;158;306
2019;June;23;2019-06-04 00:00;71;173;162;335
2019;June;23;2019-06-04 00:00;72;158;149;307
2019;June;23;2019-06-04 00:00;73;180;144;324
2019;June;23;2019-06-04 00:00;74;178;170;348
2019;June;23;2019-06-04 00:00;75;150;154;304
2019;June;23;2019-06-04 00:00;76;151;158;309
2019;June;23;2019-06-04 00:00;77;134;131;265
2019;June;23;2019-06-04 00:00;78;106;97;203
2019;June;23;2019-06-04 00:00;79;84;119;203
2019;June;23;2019-06-04 00:00;80;86;85;171
2019;June;23;2019-06-04 00:00;81;92;76;168
2019;June;23;2019-06-04 00:00;82;74;66;140
2019;June;23;2019-06-04 00:00;83;86;56;142
2019;June;23;2019-06-04 00:00;84;54;59;113
2019;June;23;2019-06-04 00:00;85;58;42;100
2019;June;23;2019-06-04 00:00;86;49;41;90
2019;June;23;2019-06-04 00:00;87;29;32;61
2019;June;23;2019-06-04 00:00;88;37;24;61
2019;June;23;2019-06-04 00:00;89;37;21;58
2019;June;23;2019-06-04 00:00;90;33;21;54
2019;June;23;2019-06-04 00:00;91;22;13;35
2019;June;23;2019-06-04 00:00;92;25;8;33
2019;June;23;2019-06-04 00:00;93;17;8;25
2019;June;23;2019-06-04 00:00;94;16;5;21
2019;June;23;2019-06-04 00:00;95;11;3;14
2019;June;23;2019-06-04 00:00;96;5;4;9
2019;June;23;2019-06-04 00:00;97;8;1;9
2019;June;23;2019-06-04 00:00;98;1;2;3
2019;June;23;2019-06-04 00:00;99;1;2;3
2019;June;23;2019-06-04 00:00;100;0;1;1
2019;June;23;2019-06-04 00:00;107;1;0;1
2019;June;24;2019-06-11 00:00;0;75;88;163
2019;June;24;2019-06-11 00:00;1;202;224;426
2019;June;24;2019-06-11 00:00;2;214;211;425
2019;June;24;2019-06-11 00:00;3;194;218;412
2019;June;24;2019-06-11 00:00;4;199;222;421
2019;June;24;2019-06-11 00:00;5;188;245;433
2019;June;24;2019-06-11 00:00;6;212;238;450
2019;June;24;2019-06-11 00:00;7;197;205;402
2019;June;24;2019-06-11 00:00;8;222;238;460
2019;June;24;2019-06-11 00:00;9;230;237;467
2019;June;24;2019-06-11 00:00;10;212;231;443
2019;June;24;2019-06-11 00:00;11;206;206;412
2019;June;24;2019-06-11 00:00;12;189;208;397
2019;June;24;2019-06-11 00:00;13;224;206;430
2019;June;24;2019-06-11 00:00;14;193;220;413
2019;June;24;2019-06-11 00:00;15;190;205;395
2019;June;24;2019-06-11 00:00;16;179;188;367
2019;June;24;2019-06-11 00:00;17;184;227;411
2019;June;24;2019-06-11 00:00;18;142;184;326
2019;June;24;2019-06-11 00:00;19;175;198;373
2019;June;24;2019-06-11 00:00;20;174;203;377
2019;June;24;2019-06-11 00:00;21;138;174;312
2019;June;24;2019-06-11 00:00;22;134;187;321
2019;June;24;2019-06-11 00:00;23;143;179;322
2019;June;24;2019-06-11 00:00;24;154;175;329
2019;June;24;2019-06-11 00:00;25;175;178;353
2019;June;24;2019-06-11 00:00;26;173;207;380
2019;June;24;2019-06-11 00:00;27;187;182;369
2019;June;24;2019-06-11 00:00;28;187;244;431
2019;June;24;2019-06-11 00:00;29;207;222;429
2019;June;24;2019-06-11 00:00;30;182;208;390
2019;June;24;2019-06-11 00:00;31;207;201;408
2019;June;24;2019-06-11 00:00;32;216;208;424
2019;June;24;2019-06-11 00:00;33;191;197;388
2019;June;24;2019-06-11 00:00;34;199;222;421
2019;June;24;2019-06-11 00:00;35;203;209;412
2019;June;24;2019-06-11 00:00;36;224;190;414
2019;June;24;2019-06-11 00:00;37;218;211;429
2019;June;24;2019-06-11 00:00;38;179;196;375
2019;June;24;2019-06-11 00:00;39;242;217;459
2019;June;24;2019-06-11 00:00;40;217;185;402
2019;June;24;2019-06-11 00:00;41;204;215;419
2019;June;24;2019-06-11 00:00;42;200;217;417
2019;June;24;2019-06-11 00:00;43;228;220;448
2019;June;24;2019-06-11 00:00;44;221;240;461
2019;June;24;2019-06-11 00:00;45;228;282;510
2019;June;24;2019-06-11 00:00;46;210;221;431
2019;June;24;2019-06-11 00:00;47;221;255;476
2019;June;24;2019-06-11 00:00;48;217;224;441
2019;June;24;2019-06-11 00:00;49;204;221;425
2019;June;24;2019-06-11 00:00;50;195;199;394
2019;June;24;2019-06-11 00:00;51;207;221;428
2019;June;24;2019-06-11 00:00;52;239;230;469
2019;June;24;2019-06-11 00:00;53;187;214;401
2019;June;24;2019-06-11 00:00;54;197;220;417
2019;June;24;2019-06-11 00:00;55;189;217;406
2019;June;24;2019-06-11 00:00;56;178;216;394
2019;June;24;2019-06-11 00:00;57;181;182;363
2019;June;24;2019-06-11 00:00;58;148;169;317
2019;June;24;2019-06-11 00:00;59;155;155;310
2019;June;24;2019-06-11 00:00;60;152;160;312
2019;June;24;2019-06-11 00:00;61;144;151;295
2019;June;24;2019-06-11 00:00;62;145;152;297
2019;June;24;2019-06-11 00:00;63;150;157;307
2019;June;24;2019-06-11 00:00;64;132;116;248
2019;June;24;2019-06-11 00:00;65;133;140;273
2019;June;24;2019-06-11 00:00;66;146;134;280
2019;June;24;2019-06-11 00:00;67;136;150;286
2019;June;24;2019-06-11 00:00;68;140;130;270
2019;June;24;2019-06-11 00:00;69;137;155;292
2019;June;24;2019-06-11 00:00;70;148;158;306
2019;June;24;2019-06-11 00:00;71;173;162;335
2019;June;24;2019-06-11 00:00;72;158;149;307
2019;June;24;2019-06-11 00:00;73;180;144;324
2019;June;24;2019-06-11 00:00;74;178;169;347
2019;June;24;2019-06-11 00:00;75;150;154;304
2019;June;24;2019-06-11 00:00;76;151;158;309
2019;June;24;2019-06-11 00:00;77;134;131;265
2019;June;24;2019-06-11 00:00;78;106;97;203
2019;June;24;2019-06-11 00:00;79;84;119;203
2019;June;24;2019-06-11 00:00;80;86;85;171
2019;June;24;2019-06-11 00:00;81;92;76;168
2019;June;24;2019-06-11 00:00;82;74;66;140
2019;June;24;2019-06-11 00:00;83;86;56;142
2019;June;24;2019-06-11 00:00;84;54;59;113
2019;June;24;2019-06-11 00:00;85;58;42;100
2019;June;24;2019-06-11 00:00;86;49;41;90
2019;June;24;2019-06-11 00:00;87;29;32;61
2019;June;24;2019-06-11 00:00;88;37;24;61
2019;June;24;2019-06-11 00:00;89;37;21;58
2019;June;24;2019-06-11 00:00;90;33;21;54
2019;June;24;2019-06-11 00:00;91;21;13;34
2019;June;24;2019-06-11 00:00;92;25;8;33
2019;June;24;2019-06-11 00:00;93;17;8;25
2019;June;24;2019-06-11 00:00;94;16;5;21
2019;June;24;2019-06-11 00:00;95;11;3;14
2019;June;24;2019-06-11 00:00;96;5;4;9
2019;June;24;2019-06-11 00:00;97;8;1;9
2019;June;24;2019-06-11 00:00;98;1;2;3
2019;June;24;2019-06-11 00:00;99;1;2;3
2019;June;24;2019-06-11 00:00;100;0;1;1
2019;June;24;2019-06-11 00:00;107;1;0;1
2019;June;25;2019-06-18 00:00;0;75;88;163
2019;June;25;2019-06-18 00:00;1;202;224;426
2019;June;25;2019-06-18 00:00;2;214;211;425
2019;June;25;2019-06-18 00:00;3;194;218;412
2019;June;25;2019-06-18 00:00;4;199;222;421
2019;June;25;2019-06-18 00:00;5;188;245;433
2019;June;25;2019-06-18 00:00;6;212;238;450
2019;June;25;2019-06-18 00:00;7;197;205;402
2019;June;25;2019-06-18 00:00;8;222;238;460
2019;June;25;2019-06-18 00:00;9;230;237;467
2019;June;25;2019-06-18 00:00;10;212;231;443
2019;June;25;2019-06-18 00:00;11;206;206;412
2019;June;25;2019-06-18 00:00;12;189;208;397
2019;June;25;2019-06-18 00:00;13;224;206;430
2019;June;25;2019-06-18 00:00;14;193;220;413
2019;June;25;2019-06-18 00:00;15;190;205;395
2019;June;25;2019-06-18 00:00;16;179;188;367
2019;June;25;2019-06-18 00:00;17;184;227;411
2019;June;25;2019-06-18 00:00;18;142;184;326
2019;June;25;2019-06-18 00:00;19;175;198;373
2019;June;25;2019-06-18 00:00;20;174;203;377
2019;June;25;2019-06-18 00:00;21;138;174;312
2019;June;25;2019-06-18 00:00;22;134;187;321
2019;June;25;2019-06-18 00:00;23;143;179;322
2019;June;25;2019-06-18 00:00;24;154;175;329
2019;June;25;2019-06-18 00:00;25;175;178;353
2019;June;25;2019-06-18 00:00;26;173;207;380
2019;June;25;2019-06-18 00:00;27;187;182;369
2019;June;25;2019-06-18 00:00;28;187;244;431
2019;June;25;2019-06-18 00:00;29;207;222;429
2019;June;25;2019-06-18 00:00;30;182;208;390
2019;June;25;2019-06-18 00:00;31;207;201;408
2019;June;25;2019-06-18 00:00;32;216;208;424
2019;June;25;2019-06-18 00:00;33;191;197;388
2019;June;25;2019-06-18 00:00;34;199;222;421
2019;June;25;2019-06-18 00:00;35;203;209;412
2019;June;25;2019-06-18 00:00;36;224;190;414
2019;June;25;2019-06-18 00:00;37;218;211;429
2019;June;25;2019-06-18 00:00;38;179;196;375
2019;June;25;2019-06-18 00:00;39;242;217;459
2019;June;25;2019-06-18 00:00;40;217;185;402
2019;June;25;2019-06-18 00:00;41;204;215;419
2019;June;25;2019-06-18 00:00;42;200;217;417
2019;June;25;2019-06-18 00:00;43;228;220;448
2019;June;25;2019-06-18 00:00;44;221;240;461
2019;June;25;2019-06-18 00:00;45;228;282;510
2019;June;25;2019-06-18 00:00;46;210;221;431
2019;June;25;2019-06-18 00:00;47;221;255;476
2019;June;25;2019-06-18 00:00;48;217;224;441
2019;June;25;2019-06-18 00:00;49;204;221;425
2019;June;25;2019-06-18 00:00;50;195;199;394
2019;June;25;2019-06-18 00:00;51;207;221;428
2019;June;25;2019-06-18 00:00;52;239;230;469
2019;June;25;2019-06-18 00:00;53;187;214;401
2019;June;25;2019-06-18 00:00;54;197;220;417
2019;June;25;2019-06-18 00:00;55;189;217;406
2019;June;25;2019-06-18 00:00;56;178;216;394
2019;June;25;2019-06-18 00:00;57;181;182;363
2019;June;25;2019-06-18 00:00;58;148;169;317
2019;June;25;2019-06-18 00:00;59;155;155;310
2019;June;25;2019-06-18 00:00;60;152;160;312
2019;June;25;2019-06-18 00:00;61;144;151;295
2019;June;25;2019-06-18 00:00;62;145;152;297
2019;June;25;2019-06-18 00:00;63;150;157;307
2019;June;25;2019-06-18 00:00;64;132;116;248
2019;June;25;2019-06-18 00:00;65;133;140;273
2019;June;25;2019-06-18 00:00;66;146;134;280
2019;June;25;2019-06-18 00:00;67;136;150;286
2019;June;25;2019-06-18 00:00;68;140;130;270
2019;June;25;2019-06-18 00:00;69;137;155;292
2019;June;25;2019-06-18 00:00;70;148;158;306
2019;June;25;2019-06-18 00:00;71;173;162;335
2019;June;25;2019-06-18 00:00;72;158;149;307
2019;June;25;2019-06-18 00:00;73;180;144;324
2019;June;25;2019-06-18 00:00;74;178;169;347
2019;June;25;2019-06-18 00:00;75;150;154;304
2019;June;25;2019-06-18 00:00;76;151;158;309
2019;June;25;2019-06-18 00:00;77;134;131;265
2019;June;25;2019-06-18 00:00;78;106;97;203
2019;June;25;2019-06-18 00:00;79;84;119;203
2019;June;25;2019-06-18 00:00;80;86;85;171
2019;June;25;2019-06-18 00:00;81;92;76;168
2019;June;25;2019-06-18 00:00;82;74;66;140
2019;June;25;2019-06-18 00:00;83;86;56;142
2019;June;25;2019-06-18 00:00;84;54;59;113
2019;June;25;2019-06-18 00:00;85;58;42;100
2019;June;25;2019-06-18 00:00;86;49;41;90
2019;June;25;2019-06-18 00:00;87;29;32;61
2019;June;25;2019-06-18 00:00;88;37;24;61
2019;June;25;2019-06-18 00:00;89;37;21;58
2019;June;25;2019-06-18 00:00;90;33;21;54
2019;June;25;2019-06-18 00:00;91;21;13;34
2019;June;25;2019-06-18 00:00;92;25;8;33
2019;June;25;2019-06-18 00:00;93;17;8;25
2019;June;25;2019-06-18 00:00;94;16;5;21
2019;June;25;2019-06-18 00:00;95;11;3;14
2019;June;25;2019-06-18 00:00;96;5;4;9
2019;June;25;2019-06-18 00:00;97;8;1;9
2019;June;25;2019-06-18 00:00;98;1;2;3
2019;June;25;2019-06-18 00:00;99;1;2;3
2019;June;25;2019-06-18 00:00;100;0;1;1
2019;June;25;2019-06-18 00:00;107;1;0;1
2019;June;26;2019-06-25 00:00;0;82;92;174
2019;June;26;2019-06-25 00:00;1;204;225;429
2019;June;26;2019-06-25 00:00;2;215;213;428
2019;June;26;2019-06-25 00:00;3;196;219;415
2019;June;26;2019-06-25 00:00;4;199;222;421
2019;June;26;2019-06-25 00:00;5;188;244;432
2019;June;26;2019-06-25 00:00;6;213;237;450
2019;June;26;2019-06-25 00:00;7;198;205;403
2019;June;26;2019-06-25 00:00;8;222;238;460
2019;June;26;2019-06-25 00:00;9;230;237;467
2019;June;26;2019-06-25 00:00;10;213;232;445
2019;June;26;2019-06-25 00:00;11;206;207;413
2019;June;26;2019-06-25 00:00;12;189;208;397
2019;June;26;2019-06-25 00:00;13;224;206;430
2019;June;26;2019-06-25 00:00;14;193;220;413
2019;June;26;2019-06-25 00:00;15;189;205;394
2019;June;26;2019-06-25 00:00;16;177;190;367
2019;June;26;2019-06-25 00:00;17;184;226;410
2019;June;26;2019-06-25 00:00;18;143;184;327
2019;June;26;2019-06-25 00:00;19;176;199;375
2019;June;26;2019-06-25 00:00;20;174;203;377
2019;June;26;2019-06-25 00:00;21;138;176;314
2019;June;26;2019-06-25 00:00;22;134;188;322
2019;June;26;2019-06-25 00:00;23;144;180;324
2019;June;26;2019-06-25 00:00;24;156;176;332
2019;June;26;2019-06-25 00:00;25;177;177;354
2019;June;26;2019-06-25 00:00;26;173;208;381
2019;June;26;2019-06-25 00:00;27;188;185;373
2019;June;26;2019-06-25 00:00;28;187;245;432
2019;June;26;2019-06-25 00:00;29;211;223;434
2019;June;26;2019-06-25 00:00;30;186;210;396
2019;June;26;2019-06-25 00:00;31;206;202;408
2019;June;26;2019-06-25 00:00;32;216;210;426
2019;June;26;2019-06-25 00:00;33;191;197;388
2019;June;26;2019-06-25 00:00;34;200;221;421
2019;June;26;2019-06-25 00:00;35;206;209;415
2019;June;26;2019-06-25 00:00;36;224;190;414
2019;June;26;2019-06-25 00:00;37;217;213;430
2019;June;26;2019-06-25 00:00;38;179;195;374
2019;June;26;2019-06-25 00:00;39;242;217;459
2019;June;26;2019-06-25 00:00;40;216;185;401
2019;June;26;2019-06-25 00:00;41;204;216;420
2019;June;26;2019-06-25 00:00;42;200;217;417
2019;June;26;2019-06-25 00:00;43;227;219;446
2019;June;26;2019-06-25 00:00;44;220;240;460
2019;June;26;2019-06-25 00:00;45;228;282;510
2019;June;26;2019-06-25 00:00;46;210;221;431
2019;June;26;2019-06-25 00:00;47;222;255;477
2019;June;26;2019-06-25 00:00;48;216;223;439
2019;June;26;2019-06-25 00:00;49;204;221;425
2019;June;26;2019-06-25 00:00;50;195;199;394
2019;June;26;2019-06-25 00:00;51;207;221;428
2019;June;26;2019-06-25 00:00;52;239;230;469
2019;June;26;2019-06-25 00:00;53;187;214;401
2019;June;26;2019-06-25 00:00;54;198;221;419
2019;June;26;2019-06-25 00:00;55;189;218;407
2019;June;26;2019-06-25 00:00;56;178;216;394
2019;June;26;2019-06-25 00:00;57;181;182;363
2019;June;26;2019-06-25 00:00;58;148;169;317
2019;June;26;2019-06-25 00:00;59;155;155;310
2019;June;26;2019-06-25 00:00;60;152;160;312
2019;June;26;2019-06-25 00:00;61;144;152;296
2019;June;26;2019-06-25 00:00;62;144;152;296
2019;June;26;2019-06-25 00:00;63;149;157;306
2019;June;26;2019-06-25 00:00;64;132;116;248
2019;June;26;2019-06-25 00:00;65;133;139;272
2019;June;26;2019-06-25 00:00;66;146;134;280
2019;June;26;2019-06-25 00:00;67;136;150;286
2019;June;26;2019-06-25 00:00;68;140;130;270
2019;June;26;2019-06-25 00:00;69;137;155;292
2019;June;26;2019-06-25 00:00;70;147;158;305
2019;June;26;2019-06-25 00:00;71;173;162;335
2019;June;26;2019-06-25 00:00;72;158;149;307
2019;June;26;2019-06-25 00:00;73;180;144;324
2019;June;26;2019-06-25 00:00;74;178;169;347
2019;June;26;2019-06-25 00:00;75;150;154;304
2019;June;26;2019-06-25 00:00;76;151;158;309
2019;June;26;2019-06-25 00:00;77;134;131;265
2019;June;26;2019-06-25 00:00;78;106;97;203
2019;June;26;2019-06-25 00:00;79;84;119;203
2019;June;26;2019-06-25 00:00;80;86;85;171
2019;June;26;2019-06-25 00:00;81;92;76;168
2019;June;26;2019-06-25 00:00;82;74;66;140
2019;June;26;2019-06-25 00:00;83;86;56;142
2019;June;26;2019-06-25 00:00;84;54;58;112
2019;June;26;2019-06-25 00:00;85;58;42;100
2019;June;26;2019-06-25 00:00;86;49;41;90
2019;June;26;2019-06-25 00:00;87;29;32;61
2019;June;26;2019-06-25 00:00;88;37;23;60
2019;June;26;2019-06-25 00:00;89;37;21;58
2019;June;26;2019-06-25 00:00;90;33;21;54
2019;June;26;2019-06-25 00:00;91;21;13;34
2019;June;26;2019-06-25 00:00;92;25;8;33
2019;June;26;2019-06-25 00:00;93;17;8;25
2019;June;26;2019-06-25 00:00;94;16;5;21
2019;June;26;2019-06-25 00:00;95;10;3;13
2019;June;26;2019-06-25 00:00;96;5;4;9
2019;June;26;2019-06-25 00:00;97;8;1;9
2019;June;26;2019-06-25 00:00;98;1;2;3
2019;June;26;2019-06-25 00:00;99;1;2;3
2019;June;26;2019-06-25 00:00;100;0;1;1
2019;June;26;2019-06-25 00:00;107;1;0;1
2019;July;27;2019-07-02 00:00;0;85;93;178
2019;July;27;2019-07-02 00:00;1;205;226;431
2019;July;27;2019-07-02 00:00;2;214;214;428
2019;July;27;2019-07-02 00:00;3;198;219;417
2019;July;27;2019-07-02 00:00;4;201;223;424
2019;July;27;2019-07-02 00:00;5;188;247;435
2019;July;27;2019-07-02 00:00;6;213;237;450
2019;July;27;2019-07-02 00:00;7;199;205;404
2019;July;27;2019-07-02 00:00;8;222;238;460
2019;July;27;2019-07-02 00:00;9;232;238;470
2019;July;27;2019-07-02 00:00;10;213;231;444
2019;July;27;2019-07-02 00:00;11;207;208;415
2019;July;27;2019-07-02 00:00;12;189;208;397
2019;July;27;2019-07-02 00:00;13;225;206;431
2019;July;27;2019-07-02 00:00;14;193;220;413
2019;July;27;2019-07-02 00:00;15;189;205;394
2019;July;27;2019-07-02 00:00;16;177;189;366
2019;July;27;2019-07-02 00:00;17;184;226;410
2019;July;27;2019-07-02 00:00;18;143;184;327
2019;July;27;2019-07-02 00:00;19;176;198;374
2019;July;27;2019-07-02 00:00;20;174;202;376
2019;July;27;2019-07-02 00:00;21;140;175;315
2019;July;27;2019-07-02 00:00;22;134;188;322
2019;July;27;2019-07-02 00:00;23;145;179;324
2019;July;27;2019-07-02 00:00;24;154;176;330
2019;July;27;2019-07-02 00:00;25;177;176;353
2019;July;27;2019-07-02 00:00;26;174;207;381
2019;July;27;2019-07-02 00:00;27;188;183;371
2019;July;27;2019-07-02 00:00;28;187;245;432
2019;July;27;2019-07-02 00:00;29;213;224;437
2019;July;27;2019-07-02 00:00;30;187;210;397
2019;July;27;2019-07-02 00:00;31;206;203;409
2019;July;27;2019-07-02 00:00;32;215;210;425
2019;July;27;2019-07-02 00:00;33;188;195;383
2019;July;27;2019-07-02 00:00;34;202;222;424
2019;July;27;2019-07-02 00:00;35;205;209;414
2019;July;27;2019-07-02 00:00;36;224;192;416
2019;July;27;2019-07-02 00:00;37;216;217;433
2019;July;27;2019-07-02 00:00;38;182;199;381
2019;July;27;2019-07-02 00:00;39;243;216;459
2019;July;27;2019-07-02 00:00;40;216;184;400
2019;July;27;2019-07-02 00:00;41;206;214;420
2019;July;27;2019-07-02 00:00;42;200;218;418
2019;July;27;2019-07-02 00:00;43;227;219;446
2019;July;27;2019-07-02 00:00;44;223;240;463
2019;July;27;2019-07-02 00:00;45;228;282;510
2019;July;27;2019-07-02 00:00;46;210;223;433
2019;July;27;2019-07-02 00:00;47;222;255;477
2019;July;27;2019-07-02 00:00;48;216;223;439
2019;July;27;2019-07-02 00:00;49;204;221;425
2019;July;27;2019-07-02 00:00;50;195;199;394
2019;July;27;2019-07-02 00:00;51;207;221;428
2019;July;27;2019-07-02 00:00;52;240;231;471
2019;July;27;2019-07-02 00:00;53;187;214;401
2019;July;27;2019-07-02 00:00;54;198;222;420
2019;July;27;2019-07-02 00:00;55;190;218;408
2019;July;27;2019-07-02 00:00;56;177;216;393
2019;July;27;2019-07-02 00:00;57;181;182;363
2019;July;27;2019-07-02 00:00;58;148;171;319
2019;July;27;2019-07-02 00:00;59;155;154;309
2019;July;27;2019-07-02 00:00;60;152;160;312
2019;July;27;2019-07-02 00:00;61;144;151;295
2019;July;27;2019-07-02 00:00;62;142;152;294
2019;July;27;2019-07-02 00:00;63;149;157;306
2019;July;27;2019-07-02 00:00;64;132;116;248
2019;July;27;2019-07-02 00:00;65;132;138;270
2019;July;27;2019-07-02 00:00;66;146;134;280
2019;July;27;2019-07-02 00:00;67;136;150;286
2019;July;27;2019-07-02 00:00;68;140;130;270
2019;July;27;2019-07-02 00:00;69;137;155;292
2019;July;27;2019-07-02 00:00;70;147;157;304
2019;July;27;2019-07-02 00:00;71;173;162;335
2019;July;27;2019-07-02 00:00;72;158;149;307
2019;July;27;2019-07-02 00:00;73;180;144;324
2019;July;27;2019-07-02 00:00;74;178;169;347
2019;July;27;2019-07-02 00:00;75;149;154;303
2019;July;27;2019-07-02 00:00;76;150;158;308
2019;July;27;2019-07-02 00:00;77;134;130;264
2019;July;27;2019-07-02 00:00;78;106;98;204
2019;July;27;2019-07-02 00:00;79;84;119;203
2019;July;27;2019-07-02 00:00;80;86;85;171
2019;July;27;2019-07-02 00:00;81;92;76;168
2019;July;27;2019-07-02 00:00;82;74;66;140
2019;July;27;2019-07-02 00:00;83;86;56;142
2019;July;27;2019-07-02 00:00;84;54;58;112
2019;July;27;2019-07-02 00:00;85;58;42;100
2019;July;27;2019-07-02 00:00;86;49;41;90
2019;July;27;2019-07-02 00:00;87;29;32;61
2019;July;27;2019-07-02 00:00;88;37;23;60
2019;July;27;2019-07-02 00:00;89;37;21;58
2019;July;27;2019-07-02 00:00;90;32;21;53
2019;July;27;2019-07-02 00:00;91;21;13;34
2019;July;27;2019-07-02 00:00;92;25;8;33
2019;July;27;2019-07-02 00:00;93;17;8;25
2019;July;27;2019-07-02 00:00;94;16;5;21
2019;July;27;2019-07-02 00:00;95;10;2;12
2019;July;27;2019-07-02 00:00;96;5;4;9
2019;July;27;2019-07-02 00:00;97;8;1;9
2019;July;27;2019-07-02 00:00;98;1;2;3
2019;July;27;2019-07-02 00:00;99;1;2;3
2019;July;27;2019-07-02 00:00;100;0;1;1
2019;July;27;2019-07-02 00:00;107;1;0;1
2019;July;28;2019-07-09 00:00;0;88;98;186
2019;July;28;2019-07-09 00:00;1;205;226;431
2019;July;28;2019-07-09 00:00;2;215;214;429
2019;July;28;2019-07-09 00:00;3;198;219;417
2019;July;28;2019-07-09 00:00;4;201;223;424
2019;July;28;2019-07-09 00:00;5;188;247;435
2019;July;28;2019-07-09 00:00;6;214;236;450
2019;July;28;2019-07-09 00:00;7;198;205;403
2019;July;28;2019-07-09 00:00;8;222;237;459
2019;July;28;2019-07-09 00:00;9;231;238;469
2019;July;28;2019-07-09 00:00;10;214;231;445
2019;July;28;2019-07-09 00:00;11;206;208;414
2019;July;28;2019-07-09 00:00;12;190;208;398
2019;July;28;2019-07-09 00:00;13;225;207;432
2019;July;28;2019-07-09 00:00;14;193;220;413
2019;July;28;2019-07-09 00:00;15;190;205;395
2019;July;28;2019-07-09 00:00;16;177;189;366
2019;July;28;2019-07-09 00:00;17;184;226;410
2019;July;28;2019-07-09 00:00;18;143;184;327
2019;July;28;2019-07-09 00:00;19;177;199;376
2019;July;28;2019-07-09 00:00;20;174;202;376
2019;July;28;2019-07-09 00:00;21;141;174;315
2019;July;28;2019-07-09 00:00;22;135;189;324
2019;July;28;2019-07-09 00:00;23;144;179;323
2019;July;28;2019-07-09 00:00;24;155;176;331
2019;July;28;2019-07-09 00:00;25;177;176;353
2019;July;28;2019-07-09 00:00;26;174;207;381
2019;July;28;2019-07-09 00:00;27;190;181;371
2019;July;28;2019-07-09 00:00;28;187;245;432
2019;July;28;2019-07-09 00:00;29;212;224;436
2019;July;28;2019-07-09 00:00;30;186;212;398
2019;July;28;2019-07-09 00:00;31;206;204;410
2019;July;28;2019-07-09 00:00;32;217;209;426
2019;July;28;2019-07-09 00:00;33;190;195;385
2019;July;28;2019-07-09 00:00;34;203;222;425
2019;July;28;2019-07-09 00:00;35;205;209;414
2019;July;28;2019-07-09 00:00;36;222;192;414
2019;July;28;2019-07-09 00:00;37;216;215;431
2019;July;28;2019-07-09 00:00;38;182;199;381
2019;July;28;2019-07-09 00:00;39;243;215;458
2019;July;28;2019-07-09 00:00;40;216;184;400
2019;July;28;2019-07-09 00:00;41;205;214;419
2019;July;28;2019-07-09 00:00;42;200;218;418
2019;July;28;2019-07-09 00:00;43;227;219;446
2019;July;28;2019-07-09 00:00;44;223;240;463
2019;July;28;2019-07-09 00:00;45;228;282;510
2019;July;28;2019-07-09 00:00;46;210;224;434
2019;July;28;2019-07-09 00:00;47;222;255;477
2019;July;28;2019-07-09 00:00;48;216;225;441
2019;July;28;2019-07-09 00:00;49;204;221;425
2019;July;28;2019-07-09 00:00;50;195;199;394
2019;July;28;2019-07-09 00:00;51;207;221;428
2019;July;28;2019-07-09 00:00;52;240;231;471
2019;July;28;2019-07-09 00:00;53;187;214;401
2019;July;28;2019-07-09 00:00;54;198;221;419
2019;July;28;2019-07-09 00:00;55;190;218;408
2019;July;28;2019-07-09 00:00;56;177;215;392
2019;July;28;2019-07-09 00:00;57;181;181;362
2019;July;28;2019-07-09 00:00;58;148;171;319
2019;July;28;2019-07-09 00:00;59;155;154;309
2019;July;28;2019-07-09 00:00;60;152;160;312
2019;July;28;2019-07-09 00:00;61;144;151;295
2019;July;28;2019-07-09 00:00;62;142;152;294
2019;July;28;2019-07-09 00:00;63;149;157;306
2019;July;28;2019-07-09 00:00;64;132;116;248
2019;July;28;2019-07-09 00:00;65;132;138;270
2019;July;28;2019-07-09 00:00;66;145;133;278
2019;July;28;2019-07-09 00:00;67;136;150;286
2019;July;28;2019-07-09 00:00;68;140;130;270
2019;July;28;2019-07-09 00:00;69;137;155;292
2019;July;28;2019-07-09 00:00;70;147;156;303
2019;July;28;2019-07-09 00:00;71;173;162;335
2019;July;28;2019-07-09 00:00;72;158;148;306
2019;July;28;2019-07-09 00:00;73;180;144;324
2019;July;28;2019-07-09 00:00;74;177;169;346
2019;July;28;2019-07-09 00:00;75;149;154;303
2019;July;28;2019-07-09 00:00;76;150;158;308
2019;July;28;2019-07-09 00:00;77;133;128;261
2019;July;28;2019-07-09 00:00;78;106;98;204
2019;July;28;2019-07-09 00:00;79;84;119;203
2019;July;28;2019-07-09 00:00;80;86;85;171
2019;July;28;2019-07-09 00:00;81;92;76;168
2019;July;28;2019-07-09 00:00;82;74;66;140
2019;July;28;2019-07-09 00:00;83;86;56;142
2019;July;28;2019-07-09 00:00;84;54;58;112
2019;July;28;2019-07-09 00:00;85;58;43;101
2019;July;28;2019-07-09 00:00;86;49;41;90
2019;July;28;2019-07-09 00:00;87;29;32;61
2019;July;28;2019-07-09 00:00;88;37;23;60
2019;July;28;2019-07-09 00:00;89;37;21;58
2019;July;28;2019-07-09 00:00;90;31;21;52
2019;July;28;2019-07-09 00:00;91;21;13;34
2019;July;28;2019-07-09 00:00;92;25;8;33
2019;July;28;2019-07-09 00:00;93;17;8;25
2019;July;28;2019-07-09 00:00;94;16;5;21
2019;July;28;2019-07-09 00:00;95;10;2;12
2019;July;28;2019-07-09 00:00;96;5;4;9
2019;July;28;2019-07-09 00:00;97;8;1;9
2019;July;28;2019-07-09 00:00;98;1;2;3
2019;July;28;2019-07-09 00:00;99;1;2;3
2019;July;28;2019-07-09 00:00;100;0;1;1
2019;July;28;2019-07-09 00:00;107;1;0;1
2019;July;29;2019-07-16 00:00;0;95;99;194
2019;July;29;2019-07-16 00:00;1;206;225;431
2019;July;29;2019-07-16 00:00;2;215;214;429
2019;July;29;2019-07-16 00:00;3;199;219;418
2019;July;29;2019-07-16 00:00;4;201;223;424
2019;July;29;2019-07-16 00:00;5;188;247;435
2019;July;29;2019-07-16 00:00;6;214;236;450
2019;July;29;2019-07-16 00:00;7;198;205;403
2019;July;29;2019-07-16 00:00;8;220;237;457
2019;July;29;2019-07-16 00:00;9;230;237;467
2019;July;29;2019-07-16 00:00;10;214;231;445
2019;July;29;2019-07-16 00:00;11;206;208;414
2019;July;29;2019-07-16 00:00;12;191;208;399
2019;July;29;2019-07-16 00:00;13;225;207;432
2019;July;29;2019-07-16 00:00;14;193;219;412
2019;July;29;2019-07-16 00:00;15;191;205;396
2019;July;29;2019-07-16 00:00;16;177;189;366
2019;July;29;2019-07-16 00:00;17;185;226;411
2019;July;29;2019-07-16 00:00;18;143;184;327
2019;July;29;2019-07-16 00:00;19;177;199;376
2019;July;29;2019-07-16 00:00;20;173;202;375
2019;July;29;2019-07-16 00:00;21;140;174;314
2019;July;29;2019-07-16 00:00;22;134;189;323
2019;July;29;2019-07-16 00:00;23;145;179;324
2019;July;29;2019-07-16 00:00;24;153;176;329
2019;July;29;2019-07-16 00:00;25;176;176;352
2019;July;29;2019-07-16 00:00;26;174;207;381
2019;July;29;2019-07-16 00:00;27;191;181;372
2019;July;29;2019-07-16 00:00;28;185;246;431
2019;July;29;2019-07-16 00:00;29;211;224;435
2019;July;29;2019-07-16 00:00;30;187;213;400
2019;July;29;2019-07-16 00:00;31;205;203;408
2019;July;29;2019-07-16 00:00;32;217;209;426
2019;July;29;2019-07-16 00:00;33;190;195;385
2019;July;29;2019-07-16 00:00;34;203;222;425
2019;July;29;2019-07-16 00:00;35;205;208;413
2019;July;29;2019-07-16 00:00;36;222;191;413
2019;July;29;2019-07-16 00:00;37;216;215;431
2019;July;29;2019-07-16 00:00;38;183;199;382
2019;July;29;2019-07-16 00:00;39;243;215;458
2019;July;29;2019-07-16 00:00;40;215;184;399
2019;July;29;2019-07-16 00:00;41;205;213;418
2019;July;29;2019-07-16 00:00;42;200;218;418
2019;July;29;2019-07-16 00:00;43;227;218;445
2019;July;29;2019-07-16 00:00;44;223;240;463
2019;July;29;2019-07-16 00:00;45;229;282;511
2019;July;29;2019-07-16 00:00;46;210;224;434
2019;July;29;2019-07-16 00:00;47;222;254;476
2019;July;29;2019-07-16 00:00;48;216;225;441
2019;July;29;2019-07-16 00:00;49;203;220;423
2019;July;29;2019-07-16 00:00;50;195;199;394
2019;July;29;2019-07-16 00:00;51;208;221;429
2019;July;29;2019-07-16 00:00;52;240;231;471
2019;July;29;2019-07-16 00:00;53;187;214;401
2019;July;29;2019-07-16 00:00;54;197;221;418
2019;July;29;2019-07-16 00:00;55;189;218;407
2019;July;29;2019-07-16 00:00;56;177;216;393
2019;July;29;2019-07-16 00:00;57;181;181;362
2019;July;29;2019-07-16 00:00;58;148;171;319
2019;July;29;2019-07-16 00:00;59;155;153;308
2019;July;29;2019-07-16 00:00;60;152;160;312
2019;July;29;2019-07-16 00:00;61;144;150;294
2019;July;29;2019-07-16 00:00;62;142;152;294
2019;July;29;2019-07-16 00:00;63;149;157;306
2019;July;29;2019-07-16 00:00;64;132;116;248
2019;July;29;2019-07-16 00:00;65;132;138;270
2019;July;29;2019-07-16 00:00;66;145;133;278
2019;July;29;2019-07-16 00:00;67;136;150;286
2019;July;29;2019-07-16 00:00;68;140;130;270
2019;July;29;2019-07-16 00:00;69;137;155;292
2019;July;29;2019-07-16 00:00;70;147;156;303
2019;July;29;2019-07-16 00:00;71;173;162;335
2019;July;29;2019-07-16 00:00;72;158;147;305
2019;July;29;2019-07-16 00:00;73;180;144;324
2019;July;29;2019-07-16 00:00;74;177;168;345
2019;July;29;2019-07-16 00:00;75;149;154;303
2019;July;29;2019-07-16 00:00;76;150;158;308
2019;July;29;2019-07-16 00:00;77;133;128;261
2019;July;29;2019-07-16 00:00;78;106;98;204
2019;July;29;2019-07-16 00:00;79;84;119;203
2019;July;29;2019-07-16 00:00;80;86;85;171
2019;July;29;2019-07-16 00:00;81;92;76;168
2019;July;29;2019-07-16 00:00;82;74;66;140
2019;July;29;2019-07-16 00:00;83;86;56;142
2019;July;29;2019-07-16 00:00;84;54;58;112
2019;July;29;2019-07-16 00:00;85;58;43;101
2019;July;29;2019-07-16 00:00;86;49;41;90
2019;July;29;2019-07-16 00:00;87;29;32;61
2019;July;29;2019-07-16 00:00;88;37;23;60
2019;July;29;2019-07-16 00:00;89;37;21;58
2019;July;29;2019-07-16 00:00;90;31;21;52
2019;July;29;2019-07-16 00:00;91;21;13;34
2019;July;29;2019-07-16 00:00;92;25;8;33
2019;July;29;2019-07-16 00:00;93;17;7;24
2019;July;29;2019-07-16 00:00;94;16;5;21
2019;July;29;2019-07-16 00:00;95;10;2;12
2019;July;29;2019-07-16 00:00;96;5;4;9
2019;July;29;2019-07-16 00:00;97;8;1;9
2019;July;29;2019-07-16 00:00;98;1;2;3
2019;July;29;2019-07-16 00:00;99;1;2;3
2019;July;29;2019-07-16 00:00;100;0;1;1
2019;July;29;2019-07-16 00:00;107;1;0;1
2019;July;30;2019-07-23 00:00;0;99;102;201
2019;July;30;2019-07-23 00:00;1;207;225;432
2019;July;30;2019-07-23 00:00;2;216;214;430
2019;July;30;2019-07-23 00:00;3;199;220;419
2019;July;30;2019-07-23 00:00;4;202;224;426
2019;July;30;2019-07-23 00:00;5;189;247;436
2019;July;30;2019-07-23 00:00;6;214;236;450
2019;July;30;2019-07-23 00:00;7;198;206;404
2019;July;30;2019-07-23 00:00;8;220;237;457
2019;July;30;2019-07-23 00:00;9;231;237;468
2019;July;30;2019-07-23 00:00;10;214;231;445
2019;July;30;2019-07-23 00:00;11;206;209;415
2019;July;30;2019-07-23 00:00;12;192;208;400
2019;July;30;2019-07-23 00:00;13;225;207;432
2019;July;30;2019-07-23 00:00;14;193;219;412
2019;July;30;2019-07-23 00:00;15;191;205;396
2019;July;30;2019-07-23 00:00;16;177;189;366
2019;July;30;2019-07-23 00:00;17;185;226;411
2019;July;30;2019-07-23 00:00;18;143;184;327
2019;July;30;2019-07-23 00:00;19;176;200;376
2019;July;30;2019-07-23 00:00;20;171;204;375
2019;July;30;2019-07-23 00:00;21;139;174;313
2019;July;30;2019-07-23 00:00;22;134;188;322
2019;July;30;2019-07-23 00:00;23;146;180;326
2019;July;30;2019-07-23 00:00;24;155;176;331
2019;July;30;2019-07-23 00:00;25;175;176;351
2019;July;30;2019-07-23 00:00;26;174;205;379
2019;July;30;2019-07-23 00:00;27;188;181;369
2019;July;30;2019-07-23 00:00;28;188;246;434
2019;July;30;2019-07-23 00:00;29;210;225;435
2019;July;30;2019-07-23 00:00;30;187;212;399
2019;July;30;2019-07-23 00:00;31;205;203;408
2019;July;30;2019-07-23 00:00;32;217;209;426
2019;July;30;2019-07-23 00:00;33;191;195;386
2019;July;30;2019-07-23 00:00;34;203;223;426
2019;July;30;2019-07-23 00:00;35;205;208;413
2019;July;30;2019-07-23 00:00;36;222;191;413
2019;July;30;2019-07-23 00:00;37;215;216;431
2019;July;30;2019-07-23 00:00;38;183;199;382
2019;July;30;2019-07-23 00:00;39;243;215;458
2019;July;30;2019-07-23 00:00;40;215;185;400
2019;July;30;2019-07-23 00:00;41;205;212;417
2019;July;30;2019-07-23 00:00;42;200;218;418
2019;July;30;2019-07-23 00:00;43;228;218;446
2019;July;30;2019-07-23 00:00;44;223;240;463
2019;July;30;2019-07-23 00:00;45;229;282;511
2019;July;30;2019-07-23 00:00;46;210;224;434
2019;July;30;2019-07-23 00:00;47;222;254;476
2019;July;30;2019-07-23 00:00;48;216;226;442
2019;July;30;2019-07-23 00:00;49;202;220;422
2019;July;30;2019-07-23 00:00;50;194;199;393
2019;July;30;2019-07-23 00:00;51;208;221;429
2019;July;30;2019-07-23 00:00;52;240;231;471
2019;July;30;2019-07-23 00:00;53;188;214;402
2019;July;30;2019-07-23 00:00;54;197;221;418
2019;July;30;2019-07-23 00:00;55;189;218;407
2019;July;30;2019-07-23 00:00;56;177;216;393
2019;July;30;2019-07-23 00:00;57;181;181;362
2019;July;30;2019-07-23 00:00;58;148;171;319
2019;July;30;2019-07-23 00:00;59;155;153;308
2019;July;30;2019-07-23 00:00;60;152;160;312
2019;July;30;2019-07-23 00:00;61;144;150;294
2019;July;30;2019-07-23 00:00;62;142;152;294
2019;July;30;2019-07-23 00:00;63;149;157;306
2019;July;30;2019-07-23 00:00;64;132;116;248
2019;July;30;2019-07-23 00:00;65;132;138;270
2019;July;30;2019-07-23 00:00;66;145;133;278
2019;July;30;2019-07-23 00:00;67;136;150;286
2019;July;30;2019-07-23 00:00;68;139;130;269
2019;July;30;2019-07-23 00:00;69;137;155;292
2019;July;30;2019-07-23 00:00;70;147;156;303
2019;July;30;2019-07-23 00:00;71;173;162;335
2019;July;30;2019-07-23 00:00;72;158;148;306
2019;July;30;2019-07-23 00:00;73;180;144;324
2019;July;30;2019-07-23 00:00;74;177;168;345
2019;July;30;2019-07-23 00:00;75;149;154;303
2019;July;30;2019-07-23 00:00;76;150;158;308
2019;July;30;2019-07-23 00:00;77;133;128;261
2019;July;30;2019-07-23 00:00;78;106;97;203
2019;July;30;2019-07-23 00:00;79;84;118;202
2019;July;30;2019-07-23 00:00;80;86;85;171
2019;July;30;2019-07-23 00:00;81;92;76;168
2019;July;30;2019-07-23 00:00;82;74;66;140
2019;July;30;2019-07-23 00:00;83;86;56;142
2019;July;30;2019-07-23 00:00;84;54;58;112
2019;July;30;2019-07-23 00:00;85;58;43;101
2019;July;30;2019-07-23 00:00;86;49;41;90
2019;July;30;2019-07-23 00:00;87;29;32;61
2019;July;30;2019-07-23 00:00;88;37;23;60
2019;July;30;2019-07-23 00:00;89;37;21;58
2019;July;30;2019-07-23 00:00;90;31;21;52
2019;July;30;2019-07-23 00:00;91;21;12;33
2019;July;30;2019-07-23 00:00;92;25;8;33
2019;July;30;2019-07-23 00:00;93;17;7;24
2019;July;30;2019-07-23 00:00;94;16;5;21
2019;July;30;2019-07-23 00:00;95;10;2;12
2019;July;30;2019-07-23 00:00;96;5;4;9
2019;July;30;2019-07-23 00:00;97;8;1;9
2019;July;30;2019-07-23 00:00;98;1;2;3
2019;July;30;2019-07-23 00:00;99;1;2;3
2019;July;30;2019-07-23 00:00;100;0;1;1
2019;July;30;2019-07-23 00:00;107;1;0;1
2019;July;31;2019-07-30 00:00;0;102;105;207
2019;July;31;2019-07-30 00:00;1;206;223;429
2019;July;31;2019-07-30 00:00;2;216;214;430
2019;July;31;2019-07-30 00:00;3;199;220;419
2019;July;31;2019-07-30 00:00;4;202;224;426
2019;July;31;2019-07-30 00:00;5;189;247;436
2019;July;31;2019-07-30 00:00;6;214;236;450
2019;July;31;2019-07-30 00:00;7;198;206;404
2019;July;31;2019-07-30 00:00;8;220;237;457
2019;July;31;2019-07-30 00:00;9;231;237;468
2019;July;31;2019-07-30 00:00;10;214;231;445
2019;July;31;2019-07-30 00:00;11;206;208;414
2019;July;31;2019-07-30 00:00;12;191;209;400
2019;July;31;2019-07-30 00:00;13;225;207;432
2019;July;31;2019-07-30 00:00;14;193;219;412
2019;July;31;2019-07-30 00:00;15;191;205;396
2019;July;31;2019-07-30 00:00;16;177;189;366
2019;July;31;2019-07-30 00:00;17;182;226;408
2019;July;31;2019-07-30 00:00;18;144;183;327
2019;July;31;2019-07-30 00:00;19;176;201;377
2019;July;31;2019-07-30 00:00;20;171;206;377
2019;July;31;2019-07-30 00:00;21;141;172;313
2019;July;31;2019-07-30 00:00;22;134;187;321
2019;July;31;2019-07-30 00:00;23;147;179;326
2019;July;31;2019-07-30 00:00;24;155;176;331
2019;July;31;2019-07-30 00:00;25;175;176;351
2019;July;31;2019-07-30 00:00;26;174;205;379
2019;July;31;2019-07-30 00:00;27;188;182;370
2019;July;31;2019-07-30 00:00;28;186;246;432
2019;July;31;2019-07-30 00:00;29;210;226;436
2019;July;31;2019-07-30 00:00;30;188;209;397
2019;July;31;2019-07-30 00:00;31;204;203;407
2019;July;31;2019-07-30 00:00;32;216;210;426
2019;July;31;2019-07-30 00:00;33;191;195;386
2019;July;31;2019-07-30 00:00;34;203;223;426
2019;July;31;2019-07-30 00:00;35;205;209;414
2019;July;31;2019-07-30 00:00;36;220;190;410
2019;July;31;2019-07-30 00:00;37;216;216;432
2019;July;31;2019-07-30 00:00;38;183;201;384
2019;July;31;2019-07-30 00:00;39;243;215;458
2019;July;31;2019-07-30 00:00;40;215;185;400
2019;July;31;2019-07-30 00:00;41;205;212;417
2019;July;31;2019-07-30 00:00;42;200;218;418
2019;July;31;2019-07-30 00:00;43;227;218;445
2019;July;31;2019-07-30 00:00;44;223;239;462
2019;July;31;2019-07-30 00:00;45;230;282;512
2019;July;31;2019-07-30 00:00;46;210;224;434
2019;July;31;2019-07-30 00:00;47;222;254;476
2019;July;31;2019-07-30 00:00;48;216;226;442
2019;July;31;2019-07-30 00:00;49;201;220;421
2019;July;31;2019-07-30 00:00;50;194;199;393
2019;July;31;2019-07-30 00:00;51;208;221;429
2019;July;31;2019-07-30 00:00;52;240;231;471
2019;July;31;2019-07-30 00:00;53;188;216;404
2019;July;31;2019-07-30 00:00;54;196;220;416
2019;July;31;2019-07-30 00:00;55;189;219;408
2019;July;31;2019-07-30 00:00;56;177;214;391
2019;July;31;2019-07-30 00:00;57;181;181;362
2019;July;31;2019-07-30 00:00;58;148;171;319
2019;July;31;2019-07-30 00:00;59;155;153;308
2019;July;31;2019-07-30 00:00;60;152;160;312
2019;July;31;2019-07-30 00:00;61;144;149;293
2019;July;31;2019-07-30 00:00;62;141;152;293
2019;July;31;2019-07-30 00:00;63;149;157;306
2019;July;31;2019-07-30 00:00;64;132;116;248
2019;July;31;2019-07-30 00:00;65;132;138;270
2019;July;31;2019-07-30 00:00;66;145;133;278
2019;July;31;2019-07-30 00:00;67;136;150;286
2019;July;31;2019-07-30 00:00;68;139;130;269
2019;July;31;2019-07-30 00:00;69;137;155;292
2019;July;31;2019-07-30 00:00;70;147;156;303
2019;July;31;2019-07-30 00:00;71;173;162;335
2019;July;31;2019-07-30 00:00;72;157;148;305
2019;July;31;2019-07-30 00:00;73;180;144;324
2019;July;31;2019-07-30 00:00;74;176;167;343
2019;July;31;2019-07-30 00:00;75;149;154;303
2019;July;31;2019-07-30 00:00;76;150;158;308
2019;July;31;2019-07-30 00:00;77;133;128;261
2019;July;31;2019-07-30 00:00;78;106;97;203
2019;July;31;2019-07-30 00:00;79;84;118;202
2019;July;31;2019-07-30 00:00;80;86;85;171
2019;July;31;2019-07-30 00:00;81;92;76;168
2019;July;31;2019-07-30 00:00;82;74;66;140
2019;July;31;2019-07-30 00:00;83;86;56;142
2019;July;31;2019-07-30 00:00;84;54;58;112
2019;July;31;2019-07-30 00:00;85;58;43;101
2019;July;31;2019-07-30 00:00;86;49;41;90
2019;July;31;2019-07-30 00:00;87;29;32;61
2019;July;31;2019-07-30 00:00;88;37;23;60
2019;July;31;2019-07-30 00:00;89;37;20;57
2019;July;31;2019-07-30 00:00;90;31;21;52
2019;July;31;2019-07-30 00:00;91;21;12;33
2019;July;31;2019-07-30 00:00;92;25;8;33
2019;July;31;2019-07-30 00:00;93;17;7;24
2019;July;31;2019-07-30 00:00;94;16;5;21
2019;July;31;2019-07-30 00:00;95;10;2;12
2019;July;31;2019-07-30 00:00;96;5;4;9
2019;July;31;2019-07-30 00:00;97;8;1;9
2019;July;31;2019-07-30 00:00;98;1;2;3
2019;July;31;2019-07-30 00:00;99;1;2;3
2019;July;31;2019-07-30 00:00;100;0;1;1
2019;July;31;2019-07-30 00:00;107;1;0;1
2019;August;32;2019-08-07 00:00;0;104;107;211
2019;August;32;2019-08-07 00:00;1;207;222;429
2019;August;32;2019-08-07 00:00;2;214;213;427
2019;August;32;2019-08-07 00:00;3;199;220;419
2019;August;32;2019-08-07 00:00;4;202;223;425
2019;August;32;2019-08-07 00:00;5;189;246;435
2019;August;32;2019-08-07 00:00;6;215;235;450
2019;August;32;2019-08-07 00:00;7;198;208;406
2019;August;32;2019-08-07 00:00;8;219;236;455
2019;August;32;2019-08-07 00:00;9;231;237;468
2019;August;32;2019-08-07 00:00;10;213;231;444
2019;August;32;2019-08-07 00:00;11;204;209;413
2019;August;32;2019-08-07 00:00;12;192;209;401
2019;August;32;2019-08-07 00:00;13;225;206;431
2019;August;32;2019-08-07 00:00;14;193;219;412
2019;August;32;2019-08-07 00:00;15;191;205;396
2019;August;32;2019-08-07 00:00;16;177;190;367
2019;August;32;2019-08-07 00:00;17;182;226;408
2019;August;32;2019-08-07 00:00;18;145;183;328
2019;August;32;2019-08-07 00:00;19;175;201;376
2019;August;32;2019-08-07 00:00;20;169;205;374
2019;August;32;2019-08-07 00:00;21;139;173;312
2019;August;32;2019-08-07 00:00;22;134;187;321
2019;August;32;2019-08-07 00:00;23;148;178;326
2019;August;32;2019-08-07 00:00;24;157;174;331
2019;August;32;2019-08-07 00:00;25;176;175;351
2019;August;32;2019-08-07 00:00;26;172;208;380
2019;August;32;2019-08-07 00:00;27;189;183;372
2019;August;32;2019-08-07 00:00;28;186;245;431
2019;August;32;2019-08-07 00:00;29;209;226;435
2019;August;32;2019-08-07 00:00;30;187;210;397
2019;August;32;2019-08-07 00:00;31;207;204;411
2019;August;32;2019-08-07 00:00;32;216;210;426
2019;August;32;2019-08-07 00:00;33;190;197;387
2019;August;32;2019-08-07 00:00;34;204;224;428
2019;August;32;2019-08-07 00:00;35;205;208;413
2019;August;32;2019-08-07 00:00;36;220;190;410
2019;August;32;2019-08-07 00:00;37;217;215;432
2019;August;32;2019-08-07 00:00;38;182;202;384
2019;August;32;2019-08-07 00:00;39;243;213;456
2019;August;32;2019-08-07 00:00;40;214;183;397
2019;August;32;2019-08-07 00:00;41;204;213;417
2019;August;32;2019-08-07 00:00;42;201;219;420
2019;August;32;2019-08-07 00:00;43;227;218;445
2019;August;32;2019-08-07 00:00;44;223;239;462
2019;August;32;2019-08-07 00:00;45;230;284;514
2019;August;32;2019-08-07 00:00;46;209;223;432
2019;August;32;2019-08-07 00:00;47;222;255;477
2019;August;32;2019-08-07 00:00;48;216;225;441
2019;August;32;2019-08-07 00:00;49;201;220;421
2019;August;32;2019-08-07 00:00;50;194;199;393
2019;August;32;2019-08-07 00:00;51;207;221;428
2019;August;32;2019-08-07 00:00;52;240;231;471
2019;August;32;2019-08-07 00:00;53;188;217;405
2019;August;32;2019-08-07 00:00;54;196;220;416
2019;August;32;2019-08-07 00:00;55;189;219;408
2019;August;32;2019-08-07 00:00;56;177;213;390
2019;August;32;2019-08-07 00:00;57;182;181;363
2019;August;32;2019-08-07 00:00;58;150;171;321
2019;August;32;2019-08-07 00:00;59;156;154;310
2019;August;32;2019-08-07 00:00;60;152;160;312
2019;August;32;2019-08-07 00:00;61;146;148;294
2019;August;32;2019-08-07 00:00;62;141;152;293
2019;August;32;2019-08-07 00:00;63;149;157;306
2019;August;32;2019-08-07 00:00;64;133;116;249
2019;August;32;2019-08-07 00:00;65;132;138;270
2019;August;32;2019-08-07 00:00;66;145;133;278
2019;August;32;2019-08-07 00:00;67;136;150;286
2019;August;32;2019-08-07 00:00;68;139;130;269
2019;August;32;2019-08-07 00:00;69;137;155;292
2019;August;32;2019-08-07 00:00;70;147;155;302
2019;August;32;2019-08-07 00:00;71;173;161;334
2019;August;32;2019-08-07 00:00;72;156;148;304
2019;August;32;2019-08-07 00:00;73;181;144;325
2019;August;32;2019-08-07 00:00;74;176;167;343
2019;August;32;2019-08-07 00:00;75;149;154;303
2019;August;32;2019-08-07 00:00;76;150;158;308
2019;August;32;2019-08-07 00:00;77;133;128;261
2019;August;32;2019-08-07 00:00;78;105;97;202
2019;August;32;2019-08-07 00:00;79;84;118;202
2019;August;32;2019-08-07 00:00;80;87;85;172
2019;August;32;2019-08-07 00:00;81;91;76;167
2019;August;32;2019-08-07 00:00;82;74;66;140
2019;August;32;2019-08-07 00:00;83;86;56;142
2019;August;32;2019-08-07 00:00;84;54;58;112
2019;August;32;2019-08-07 00:00;85;58;43;101
2019;August;32;2019-08-07 00:00;86;49;41;90
2019;August;32;2019-08-07 00:00;87;29;32;61
2019;August;32;2019-08-07 00:00;88;37;23;60
2019;August;32;2019-08-07 00:00;89;36;20;56
2019;August;32;2019-08-07 00:00;90;31;21;52
2019;August;32;2019-08-07 00:00;91;21;12;33
2019;August;32;2019-08-07 00:00;92;25;8;33
2019;August;32;2019-08-07 00:00;93;17;7;24
2019;August;32;2019-08-07 00:00;94;16;5;21
2019;August;32;2019-08-07 00:00;95;10;2;12
2019;August;32;2019-08-07 00:00;96;4;4;8
2019;August;32;2019-08-07 00:00;97;8;1;9
2019;August;32;2019-08-07 00:00;98;1;2;3
2019;August;32;2019-08-07 00:00;99;1;2;3
2019;August;32;2019-08-07 00:00;100;0;1;1
2019;August;32;2019-08-07 00:00;107;1;0;1
2019;August;33;2019-08-13 00:00;0;105;110;215
2019;August;33;2019-08-13 00:00;1;208;220;428
2019;August;33;2019-08-13 00:00;2;214;212;426
2019;August;33;2019-08-13 00:00;3;198;220;418
2019;August;33;2019-08-13 00:00;4;202;223;425
2019;August;33;2019-08-13 00:00;5;189;245;434
2019;August;33;2019-08-13 00:00;6;215;237;452
2019;August;33;2019-08-13 00:00;7;198;207;405
2019;August;33;2019-08-13 00:00;8;219;236;455
2019;August;33;2019-08-13 00:00;9;231;237;468
2019;August;33;2019-08-13 00:00;10;213;230;443
2019;August;33;2019-08-13 00:00;11;204;209;413
2019;August;33;2019-08-13 00:00;12;192;209;401
2019;August;33;2019-08-13 00:00;13;225;207;432
2019;August;33;2019-08-13 00:00;14;193;219;412
2019;August;33;2019-08-13 00:00;15;191;205;396
2019;August;33;2019-08-13 00:00;16;178;191;369
2019;August;33;2019-08-13 00:00;17;182;226;408
2019;August;33;2019-08-13 00:00;18;144;182;326
2019;August;33;2019-08-13 00:00;19;175;201;376
2019;August;33;2019-08-13 00:00;20;169;203;372
2019;August;33;2019-08-13 00:00;21;140;175;315
2019;August;33;2019-08-13 00:00;22;134;187;321
2019;August;33;2019-08-13 00:00;23;147;177;324
2019;August;33;2019-08-13 00:00;24;156;174;330
2019;August;33;2019-08-13 00:00;25;177;174;351
2019;August;33;2019-08-13 00:00;26;170;207;377
2019;August;33;2019-08-13 00:00;27;190;183;373
2019;August;33;2019-08-13 00:00;28;186;246;432
2019;August;33;2019-08-13 00:00;29;207;225;432
2019;August;33;2019-08-13 00:00;30;187;210;397
2019;August;33;2019-08-13 00:00;31;206;207;413
2019;August;33;2019-08-13 00:00;32;216;209;425
2019;August;33;2019-08-13 00:00;33;191;196;387
2019;August;33;2019-08-13 00:00;34;204;223;427
2019;August;33;2019-08-13 00:00;35;204;208;412
2019;August;33;2019-08-13 00:00;36;220;189;409
2019;August;33;2019-08-13 00:00;37;217;214;431
2019;August;33;2019-08-13 00:00;38;181;202;383
2019;August;33;2019-08-13 00:00;39;242;213;455
2019;August;33;2019-08-13 00:00;40;214;183;397
2019;August;33;2019-08-13 00:00;41;204;213;417
2019;August;33;2019-08-13 00:00;42;201;219;420
2019;August;33;2019-08-13 00:00;43;227;218;445
2019;August;33;2019-08-13 00:00;44;224;239;463
2019;August;33;2019-08-13 00:00;45;230;284;514
2019;August;33;2019-08-13 00:00;46;211;222;433
2019;August;33;2019-08-13 00:00;47;223;255;478
2019;August;33;2019-08-13 00:00;48;216;224;440
2019;August;33;2019-08-13 00:00;49;201;220;421
2019;August;33;2019-08-13 00:00;50;194;199;393
2019;August;33;2019-08-13 00:00;51;208;221;429
2019;August;33;2019-08-13 00:00;52;240;231;471
2019;August;33;2019-08-13 00:00;53;188;217;405
2019;August;33;2019-08-13 00:00;54;196;220;416
2019;August;33;2019-08-13 00:00;55;189;218;407
2019;August;33;2019-08-13 00:00;56;176;214;390
2019;August;33;2019-08-13 00:00;57;182;180;362
2019;August;33;2019-08-13 00:00;58;150;171;321
2019;August;33;2019-08-13 00:00;59;156;154;310
2019;August;33;2019-08-13 00:00;60;152;158;310
2019;August;33;2019-08-13 00:00;61;146;147;293
2019;August;33;2019-08-13 00:00;62;141;152;293
2019;August;33;2019-08-13 00:00;63;149;157;306
2019;August;33;2019-08-13 00:00;64;132;116;248
2019;August;33;2019-08-13 00:00;65;132;138;270
2019;August;33;2019-08-13 00:00;66;145;133;278
2019;August;33;2019-08-13 00:00;67;136;150;286
2019;August;33;2019-08-13 00:00;68;139;130;269
2019;August;33;2019-08-13 00:00;69;137;155;292
2019;August;33;2019-08-13 00:00;70;147;155;302
2019;August;33;2019-08-13 00:00;71;173;161;334
2019;August;33;2019-08-13 00:00;72;156;148;304
2019;August;33;2019-08-13 00:00;73;181;144;325
2019;August;33;2019-08-13 00:00;74;176;167;343
2019;August;33;2019-08-13 00:00;75;149;154;303
2019;August;33;2019-08-13 00:00;76;150;157;307
2019;August;33;2019-08-13 00:00;77;133;128;261
2019;August;33;2019-08-13 00:00;78;105;97;202
2019;August;33;2019-08-13 00:00;79;84;118;202
2019;August;33;2019-08-13 00:00;80;87;85;172
2019;August;33;2019-08-13 00:00;81;91;76;167
2019;August;33;2019-08-13 00:00;82;74;66;140
2019;August;33;2019-08-13 00:00;83;86;56;142
2019;August;33;2019-08-13 00:00;84;54;58;112
2019;August;33;2019-08-13 00:00;85;58;43;101
2019;August;33;2019-08-13 00:00;86;49;41;90
2019;August;33;2019-08-13 00:00;87;29;32;61
2019;August;33;2019-08-13 00:00;88;36;23;59
2019;August;33;2019-08-13 00:00;89;36;20;56
2019;August;33;2019-08-13 00:00;90;31;21;52
2019;August;33;2019-08-13 00:00;91;21;12;33
2019;August;33;2019-08-13 00:00;92;25;8;33
2019;August;33;2019-08-13 00:00;93;17;7;24
2019;August;33;2019-08-13 00:00;94;16;5;21
2019;August;33;2019-08-13 00:00;95;10;2;12
2019;August;33;2019-08-13 00:00;96;4;4;8
2019;August;33;2019-08-13 00:00;97;8;1;9
2019;August;33;2019-08-13 00:00;98;1;2;3
2019;August;33;2019-08-13 00:00;99;1;2;3
2019;August;33;2019-08-13 00:00;100;0;1;1
2019;August;33;2019-08-13 00:00;107;1;0;1
2019;August;34;2019-08-20 00:00;0;109;114;223
2019;August;34;2019-08-20 00:00;1;208;220;428
2019;August;34;2019-08-20 00:00;2;214;212;426
2019;August;34;2019-08-20 00:00;3;199;221;420
2019;August;34;2019-08-20 00:00;4;202;222;424
2019;August;34;2019-08-20 00:00;5;190;246;436
2019;August;34;2019-08-20 00:00;6;215;237;452
2019;August;34;2019-08-20 00:00;7;199;207;406
2019;August;34;2019-08-20 00:00;8;219;236;455
2019;August;34;2019-08-20 00:00;9;231;238;469
2019;August;34;2019-08-20 00:00;10;213;230;443
2019;August;34;2019-08-20 00:00;11;204;209;413
2019;August;34;2019-08-20 00:00;12;193;209;402
2019;August;34;2019-08-20 00:00;13;226;207;433
2019;August;34;2019-08-20 00:00;14;193;219;412
2019;August;34;2019-08-20 00:00;15;191;205;396
2019;August;34;2019-08-20 00:00;16;179;191;370
2019;August;34;2019-08-20 00:00;17;182;226;408
2019;August;34;2019-08-20 00:00;18;144;182;326
2019;August;34;2019-08-20 00:00;19;173;201;374
2019;August;34;2019-08-20 00:00;20;167;202;369
2019;August;34;2019-08-20 00:00;21;139;174;313
2019;August;34;2019-08-20 00:00;22;136;184;320
2019;August;34;2019-08-20 00:00;23;147;178;325
2019;August;34;2019-08-20 00:00;24;157;174;331
2019;August;34;2019-08-20 00:00;25;177;174;351
2019;August;34;2019-08-20 00:00;26;171;207;378
2019;August;34;2019-08-20 00:00;27;190;182;372
2019;August;34;2019-08-20 00:00;28;184;245;429
2019;August;34;2019-08-20 00:00;29;210;225;435
2019;August;34;2019-08-20 00:00;30;187;211;398
2019;August;34;2019-08-20 00:00;31;206;207;413
2019;August;34;2019-08-20 00:00;32;217;210;427
2019;August;34;2019-08-20 00:00;33;190;197;387
2019;August;34;2019-08-20 00:00;34;205;222;427
2019;August;34;2019-08-20 00:00;35;204;208;412
2019;August;34;2019-08-20 00:00;36;220;190;410
2019;August;34;2019-08-20 00:00;37;217;214;431
2019;August;34;2019-08-20 00:00;38;183;202;385
2019;August;34;2019-08-20 00:00;39;243;213;456
2019;August;34;2019-08-20 00:00;40;214;183;397
2019;August;34;2019-08-20 00:00;41;204;213;417
2019;August;34;2019-08-20 00:00;42;201;220;421
2019;August;34;2019-08-20 00:00;43;227;218;445
2019;August;34;2019-08-20 00:00;44;225;239;464
2019;August;34;2019-08-20 00:00;45;231;285;516
2019;August;34;2019-08-20 00:00;46;211;222;433
2019;August;34;2019-08-20 00:00;47;223;255;478
2019;August;34;2019-08-20 00:00;48;215;224;439
2019;August;34;2019-08-20 00:00;49;202;220;422
2019;August;34;2019-08-20 00:00;50;194;199;393
2019;August;34;2019-08-20 00:00;51;208;221;429
2019;August;34;2019-08-20 00:00;52;240;231;471
2019;August;34;2019-08-20 00:00;53;187;216;403
2019;August;34;2019-08-20 00:00;54;196;219;415
2019;August;34;2019-08-20 00:00;55;189;218;407
2019;August;34;2019-08-20 00:00;56;176;214;390
2019;August;34;2019-08-20 00:00;57;182;180;362
2019;August;34;2019-08-20 00:00;58;150;171;321
2019;August;34;2019-08-20 00:00;59;156;153;309
2019;August;34;2019-08-20 00:00;60;152;159;311
2019;August;34;2019-08-20 00:00;61;145;147;292
2019;August;34;2019-08-20 00:00;62;141;152;293
2019;August;34;2019-08-20 00:00;63;148;157;305
2019;August;34;2019-08-20 00:00;64;132;116;248
2019;August;34;2019-08-20 00:00;65;132;138;270
2019;August;34;2019-08-20 00:00;66;145;131;276
2019;August;34;2019-08-20 00:00;67;136;150;286
2019;August;34;2019-08-20 00:00;68;139;130;269
2019;August;34;2019-08-20 00:00;69;137;155;292
2019;August;34;2019-08-20 00:00;70;147;155;302
2019;August;34;2019-08-20 00:00;71;173;161;334
2019;August;34;2019-08-20 00:00;72;155;148;303
2019;August;34;2019-08-20 00:00;73;181;144;325
2019;August;34;2019-08-20 00:00;74;176;167;343
2019;August;34;2019-08-20 00:00;75;149;154;303
2019;August;34;2019-08-20 00:00;76;150;157;307
2019;August;34;2019-08-20 00:00;77;133;127;260
2019;August;34;2019-08-20 00:00;78;105;97;202
2019;August;34;2019-08-20 00:00;79;84;118;202
2019;August;34;2019-08-20 00:00;80;87;85;172
2019;August;34;2019-08-20 00:00;81;91;76;167
2019;August;34;2019-08-20 00:00;82;73;66;139
2019;August;34;2019-08-20 00:00;83;86;56;142
2019;August;34;2019-08-20 00:00;84;54;58;112
2019;August;34;2019-08-20 00:00;85;58;43;101
2019;August;34;2019-08-20 00:00;86;49;40;89
2019;August;34;2019-08-20 00:00;87;29;32;61
2019;August;34;2019-08-20 00:00;88;36;23;59
2019;August;34;2019-08-20 00:00;89;36;20;56
2019;August;34;2019-08-20 00:00;90;31;21;52
2019;August;34;2019-08-20 00:00;91;21;12;33
2019;August;34;2019-08-20 00:00;92;25;8;33
2019;August;34;2019-08-20 00:00;93;17;7;24
2019;August;34;2019-08-20 00:00;94;16;5;21
2019;August;34;2019-08-20 00:00;95;10;2;12
2019;August;34;2019-08-20 00:00;96;4;4;8
2019;August;34;2019-08-20 00:00;97;8;1;9
2019;August;34;2019-08-20 00:00;98;1;2;3
2019;August;34;2019-08-20 00:00;99;1;2;3
2019;August;34;2019-08-20 00:00;100;0;1;1
2019;August;34;2019-08-20 00:00;107;1;0;1
2019;August;35;2019-08-27 00:00;0;111;116;227
2019;August;35;2019-08-27 00:00;1;209;220;429
2019;August;35;2019-08-27 00:00;2;216;212;428
2019;August;35;2019-08-27 00:00;3;200;221;421
2019;August;35;2019-08-27 00:00;4;205;222;427
2019;August;35;2019-08-27 00:00;5;190;247;437
2019;August;35;2019-08-27 00:00;6;215;237;452
2019;August;35;2019-08-27 00:00;7;199;207;406
2019;August;35;2019-08-27 00:00;8;219;236;455
2019;August;35;2019-08-27 00:00;9;233;238;471
2019;August;35;2019-08-27 00:00;10;213;231;444
2019;August;35;2019-08-27 00:00;11;205;209;414
2019;August;35;2019-08-27 00:00;12;193;209;402
2019;August;35;2019-08-27 00:00;13;226;208;434
2019;August;35;2019-08-27 00:00;14;193;219;412
2019;August;35;2019-08-27 00:00;15;191;205;396
2019;August;35;2019-08-27 00:00;16;179;190;369
2019;August;35;2019-08-27 00:00;17;182;225;407
2019;August;35;2019-08-27 00:00;18;144;182;326
2019;August;35;2019-08-27 00:00;19;171;200;371
2019;August;35;2019-08-27 00:00;20;167;202;369
2019;August;35;2019-08-27 00:00;21;138;172;310
2019;August;35;2019-08-27 00:00;22;135;183;318
2019;August;35;2019-08-27 00:00;23;146;180;326
2019;August;35;2019-08-27 00:00;24;157;174;331
2019;August;35;2019-08-27 00:00;25;175;175;350
2019;August;35;2019-08-27 00:00;26;172;207;379
2019;August;35;2019-08-27 00:00;27;192;183;375
2019;August;35;2019-08-27 00:00;28;184;245;429
2019;August;35;2019-08-27 00:00;29;212;225;437
2019;August;35;2019-08-27 00:00;30;188;212;400
2019;August;35;2019-08-27 00:00;31;205;205;410
2019;August;35;2019-08-27 00:00;32;219;211;430
2019;August;35;2019-08-27 00:00;33;191;198;389
2019;August;35;2019-08-27 00:00;34;205;223;428
2019;August;35;2019-08-27 00:00;35;204;210;414
2019;August;35;2019-08-27 00:00;36;220;190;410
2019;August;35;2019-08-27 00:00;37;217;214;431
2019;August;35;2019-08-27 00:00;38;183;202;385
2019;August;35;2019-08-27 00:00;39;243;213;456
2019;August;35;2019-08-27 00:00;40;214;184;398
2019;August;35;2019-08-27 00:00;41;205;213;418
2019;August;35;2019-08-27 00:00;42;201;220;421
2019;August;35;2019-08-27 00:00;43;227;218;445
2019;August;35;2019-08-27 00:00;44;225;239;464
2019;August;35;2019-08-27 00:00;45;231;285;516
2019;August;35;2019-08-27 00:00;46;212;223;435
2019;August;35;2019-08-27 00:00;47;223;255;478
2019;August;35;2019-08-27 00:00;48;215;224;439
2019;August;35;2019-08-27 00:00;49;203;220;423
2019;August;35;2019-08-27 00:00;50;194;199;393
2019;August;35;2019-08-27 00:00;51;208;221;429
2019;August;35;2019-08-27 00:00;52;240;231;471
2019;August;35;2019-08-27 00:00;53;187;214;401
2019;August;35;2019-08-27 00:00;54;196;219;415
2019;August;35;2019-08-27 00:00;55;189;218;407
2019;August;35;2019-08-27 00:00;56;176;214;390
2019;August;35;2019-08-27 00:00;57;182;180;362
2019;August;35;2019-08-27 00:00;58;150;171;321
2019;August;35;2019-08-27 00:00;59;156;153;309
2019;August;35;2019-08-27 00:00;60;152;160;312
2019;August;35;2019-08-27 00:00;61;146;147;293
2019;August;35;2019-08-27 00:00;62;140;152;292
2019;August;35;2019-08-27 00:00;63;148;157;305
2019;August;35;2019-08-27 00:00;64;132;116;248
2019;August;35;2019-08-27 00:00;65;132;138;270
2019;August;35;2019-08-27 00:00;66;145;131;276
2019;August;35;2019-08-27 00:00;67;136;150;286
2019;August;35;2019-08-27 00:00;68;139;130;269
2019;August;35;2019-08-27 00:00;69;137;155;292
2019;August;35;2019-08-27 00:00;70;147;155;302
2019;August;35;2019-08-27 00:00;71;173;161;334
2019;August;35;2019-08-27 00:00;72;155;148;303
2019;August;35;2019-08-27 00:00;73;181;144;325
2019;August;35;2019-08-27 00:00;74;176;167;343
2019;August;35;2019-08-27 00:00;75;149;154;303
2019;August;35;2019-08-27 00:00;76;150;157;307
2019;August;35;2019-08-27 00:00;77;133;127;260
2019;August;35;2019-08-27 00:00;78;105;97;202
2019;August;35;2019-08-27 00:00;79;84;118;202
2019;August;35;2019-08-27 00:00;80;87;84;171
2019;August;35;2019-08-27 00:00;81;91;76;167
2019;August;35;2019-08-27 00:00;82;73;66;139
2019;August;35;2019-08-27 00:00;83;86;56;142
2019;August;35;2019-08-27 00:00;84;54;58;112
2019;August;35;2019-08-27 00:00;85;58;43;101
2019;August;35;2019-08-27 00:00;86;49;40;89
2019;August;35;2019-08-27 00:00;87;29;32;61
2019;August;35;2019-08-27 00:00;88;35;23;58
2019;August;35;2019-08-27 00:00;89;36;20;56
2019;August;35;2019-08-27 00:00;90;31;21;52
2019;August;35;2019-08-27 00:00;91;21;12;33
2019;August;35;2019-08-27 00:00;92;25;8;33
2019;August;35;2019-08-27 00:00;93;17;7;24
2019;August;35;2019-08-27 00:00;94;16;5;21
2019;August;35;2019-08-27 00:00;95;10;2;12
2019;August;35;2019-08-27 00:00;96;4;4;8
2019;August;35;2019-08-27 00:00;97;8;1;9
2019;August;35;2019-08-27 00:00;98;1;2;3
2019;August;35;2019-08-27 00:00;99;1;2;3
2019;August;35;2019-08-27 00:00;100;0;1;1
2019;August;35;2019-08-27 00:00;107;1;0;1
2019;September;36;2019-09-03 00:00;0;114;124;238
2019;September;36;2019-09-03 00:00;1;208;220;428
2019;September;36;2019-09-03 00:00;2;217;213;430
2019;September;36;2019-09-03 00:00;3;200;221;421
2019;September;36;2019-09-03 00:00;4;206;223;429
2019;September;36;2019-09-03 00:00;5;190;248;438
2019;September;36;2019-09-03 00:00;6;216;237;453
2019;September;36;2019-09-03 00:00;7;199;207;406
2019;September;36;2019-09-03 00:00;8;219;236;455
2019;September;36;2019-09-03 00:00;9;232;238;470
2019;September;36;2019-09-03 00:00;10;212;231;443
2019;September;36;2019-09-03 00:00;11;205;210;415
2019;September;36;2019-09-03 00:00;12;193;209;402
2019;September;36;2019-09-03 00:00;13;226;208;434
2019;September;36;2019-09-03 00:00;14;193;219;412
2019;September;36;2019-09-03 00:00;15;190;205;395
2019;September;36;2019-09-03 00:00;16;179;190;369
2019;September;36;2019-09-03 00:00;17;182;224;406
2019;September;36;2019-09-03 00:00;18;143;183;326
2019;September;36;2019-09-03 00:00;19;171;201;372
2019;September;36;2019-09-03 00:00;20;167;202;369
2019;September;36;2019-09-03 00:00;21;135;173;308
2019;September;36;2019-09-03 00:00;22;135;181;316
2019;September;36;2019-09-03 00:00;23;145;181;326
2019;September;36;2019-09-03 00:00;24;160;174;334
2019;September;36;2019-09-03 00:00;25;175;177;352
2019;September;36;2019-09-03 00:00;26;170;207;377
2019;September;36;2019-09-03 00:00;27;193;182;375
2019;September;36;2019-09-03 00:00;28;188;244;432
2019;September;36;2019-09-03 00:00;29;213;227;440
2019;September;36;2019-09-03 00:00;30;187;212;399
2019;September;36;2019-09-03 00:00;31;205;201;406
2019;September;36;2019-09-03 00:00;32;221;211;432
2019;September;36;2019-09-03 00:00;33;195;199;394
2019;September;36;2019-09-03 00:00;34;205;222;427
2019;September;36;2019-09-03 00:00;35;205;211;416
2019;September;36;2019-09-03 00:00;36;220;191;411
2019;September;36;2019-09-03 00:00;37;217;213;430
2019;September;36;2019-09-03 00:00;38;184;202;386
2019;September;36;2019-09-03 00:00;39;242;214;456
2019;September;36;2019-09-03 00:00;40;213;185;398
2019;September;36;2019-09-03 00:00;41;205;212;417
2019;September;36;2019-09-03 00:00;42;201;219;420
2019;September;36;2019-09-03 00:00;43;226;218;444
2019;September;36;2019-09-03 00:00;44;225;239;464
2019;September;36;2019-09-03 00:00;45;231;285;516
2019;September;36;2019-09-03 00:00;46;212;224;436
2019;September;36;2019-09-03 00:00;47;223;255;478
2019;September;36;2019-09-03 00:00;48;215;223;438
2019;September;36;2019-09-03 00:00;49;203;220;423
2019;September;36;2019-09-03 00:00;50;195;200;395
2019;September;36;2019-09-03 00:00;51;207;221;428
2019;September;36;2019-09-03 00:00;52;240;230;470
2019;September;36;2019-09-03 00:00;53;186;214;400
2019;September;36;2019-09-03 00:00;54;196;219;415
2019;September;36;2019-09-03 00:00;55;188;218;406
2019;September;36;2019-09-03 00:00;56;176;215;391
2019;September;36;2019-09-03 00:00;57;182;180;362
2019;September;36;2019-09-03 00:00;58;150;170;320
2019;September;36;2019-09-03 00:00;59;157;153;310
2019;September;36;2019-09-03 00:00;60;151;159;310
2019;September;36;2019-09-03 00:00;61;146;147;293
2019;September;36;2019-09-03 00:00;62;140;152;292
2019;September;36;2019-09-03 00:00;63;148;157;305
2019;September;36;2019-09-03 00:00;64;132;116;248
2019;September;36;2019-09-03 00:00;65;132;138;270
2019;September;36;2019-09-03 00:00;66;145;131;276
2019;September;36;2019-09-03 00:00;67;136;150;286
2019;September;36;2019-09-03 00:00;68;139;130;269
2019;September;36;2019-09-03 00:00;69;137;155;292
2019;September;36;2019-09-03 00:00;70;147;155;302
2019;September;36;2019-09-03 00:00;71;173;161;334
2019;September;36;2019-09-03 00:00;72;155;147;302
2019;September;36;2019-09-03 00:00;73;180;145;325
2019;September;36;2019-09-03 00:00;74;176;168;344
2019;September;36;2019-09-03 00:00;75;149;154;303
2019;September;36;2019-09-03 00:00;76;150;156;306
2019;September;36;2019-09-03 00:00;77;133;127;260
2019;September;36;2019-09-03 00:00;78;104;97;201
2019;September;36;2019-09-03 00:00;79;84;118;202
2019;September;36;2019-09-03 00:00;80;87;84;171
2019;September;36;2019-09-03 00:00;81;91;76;167
2019;September;36;2019-09-03 00:00;82;73;66;139
2019;September;36;2019-09-03 00:00;83;86;56;142
2019;September;36;2019-09-03 00:00;84;54;58;112
2019;September;36;2019-09-03 00:00;85;58;42;100
2019;September;36;2019-09-03 00:00;86;49;40;89
2019;September;36;2019-09-03 00:00;87;30;32;62
2019;September;36;2019-09-03 00:00;88;35;23;58
2019;September;36;2019-09-03 00:00;89;36;20;56
2019;September;36;2019-09-03 00:00;90;31;21;52
2019;September;36;2019-09-03 00:00;91;21;12;33
2019;September;36;2019-09-03 00:00;92;25;8;33
2019;September;36;2019-09-03 00:00;93;17;7;24
2019;September;36;2019-09-03 00:00;94;16;5;21
2019;September;36;2019-09-03 00:00;95;10;2;12
2019;September;36;2019-09-03 00:00;96;4;4;8
2019;September;36;2019-09-03 00:00;97;8;1;9
2019;September;36;2019-09-03 00:00;98;1;2;3
2019;September;36;2019-09-03 00:00;99;1;2;3
2019;September;36;2019-09-03 00:00;100;0;1;1
2019;September;36;2019-09-03 00:00;107;1;0;1
2019;September;37;2019-09-10 00:00;0;117;134;251
2019;September;37;2019-09-10 00:00;1;208;220;428
2019;September;37;2019-09-10 00:00;2;217;212;429
2019;September;37;2019-09-10 00:00;3;199;222;421
2019;September;37;2019-09-10 00:00;4;205;224;429
2019;September;37;2019-09-10 00:00;5;189;248;437
2019;September;37;2019-09-10 00:00;6;218;237;455
2019;September;37;2019-09-10 00:00;7;199;207;406
2019;September;37;2019-09-10 00:00;8;219;236;455
2019;September;37;2019-09-10 00:00;9;233;239;472
2019;September;37;2019-09-10 00:00;10;212;231;443
2019;September;37;2019-09-10 00:00;11;205;210;415
2019;September;37;2019-09-10 00:00;12;193;210;403
2019;September;37;2019-09-10 00:00;13;226;208;434
2019;September;37;2019-09-10 00:00;14;193;219;412
2019;September;37;2019-09-10 00:00;15;191;207;398
2019;September;37;2019-09-10 00:00;16;179;190;369
2019;September;37;2019-09-10 00:00;17;183;224;407
2019;September;37;2019-09-10 00:00;18;142;183;325
2019;September;37;2019-09-10 00:00;19;170;202;372
2019;September;37;2019-09-10 00:00;20;168;201;369
2019;September;37;2019-09-10 00:00;21;135;174;309
2019;September;37;2019-09-10 00:00;22;134;180;314
2019;September;37;2019-09-10 00:00;23;145;180;325
2019;September;37;2019-09-10 00:00;24;160;174;334
2019;September;37;2019-09-10 00:00;25;178;178;356
2019;September;37;2019-09-10 00:00;26;169;206;375
2019;September;37;2019-09-10 00:00;27;193;182;375
2019;September;37;2019-09-10 00:00;28;188;244;432
2019;September;37;2019-09-10 00:00;29;216;225;441
2019;September;37;2019-09-10 00:00;30;187;214;401
2019;September;37;2019-09-10 00:00;31;205;202;407
2019;September;37;2019-09-10 00:00;32;221;211;432
2019;September;37;2019-09-10 00:00;33;195;198;393
2019;September;37;2019-09-10 00:00;34;204;222;426
2019;September;37;2019-09-10 00:00;35;205;211;416
2019;September;37;2019-09-10 00:00;36;220;190;410
2019;September;37;2019-09-10 00:00;37;217;213;430
2019;September;37;2019-09-10 00:00;38;184;202;386
2019;September;37;2019-09-10 00:00;39;242;215;457
2019;September;37;2019-09-10 00:00;40;213;185;398
2019;September;37;2019-09-10 00:00;41;203;212;415
2019;September;37;2019-09-10 00:00;42;202;217;419
2019;September;37;2019-09-10 00:00;43;226;218;444
2019;September;37;2019-09-10 00:00;44;225;239;464
2019;September;37;2019-09-10 00:00;45;232;285;517
2019;September;37;2019-09-10 00:00;46;212;223;435
2019;September;37;2019-09-10 00:00;47;223;255;478
2019;September;37;2019-09-10 00:00;48;215;224;439
2019;September;37;2019-09-10 00:00;49;203;220;423
2019;September;37;2019-09-10 00:00;50;195;200;395
2019;September;37;2019-09-10 00:00;51;207;221;428
2019;September;37;2019-09-10 00:00;52;240;230;470
2019;September;37;2019-09-10 00:00;53;185;214;399
2019;September;37;2019-09-10 00:00;54;196;218;414
2019;September;37;2019-09-10 00:00;55;188;218;406
2019;September;37;2019-09-10 00:00;56;176;215;391
2019;September;37;2019-09-10 00:00;57;182;180;362
2019;September;37;2019-09-10 00:00;58;150;170;320
2019;September;37;2019-09-10 00:00;59;157;153;310
2019;September;37;2019-09-10 00:00;60;151;158;309
2019;September;37;2019-09-10 00:00;61;146;147;293
2019;September;37;2019-09-10 00:00;62;139;152;291
2019;September;37;2019-09-10 00:00;63;148;157;305
2019;September;37;2019-09-10 00:00;64;132;116;248
2019;September;37;2019-09-10 00:00;65;132;138;270
2019;September;37;2019-09-10 00:00;66;145;131;276
2019;September;37;2019-09-10 00:00;67;136;150;286
2019;September;37;2019-09-10 00:00;68;139;130;269
2019;September;37;2019-09-10 00:00;69;137;155;292
2019;September;37;2019-09-10 00:00;70;147;155;302
2019;September;37;2019-09-10 00:00;71;173;161;334
2019;September;37;2019-09-10 00:00;72;155;147;302
2019;September;37;2019-09-10 00:00;73;180;145;325
2019;September;37;2019-09-10 00:00;74;176;168;344
2019;September;37;2019-09-10 00:00;75;149;154;303
2019;September;37;2019-09-10 00:00;76;149;156;305
2019;September;37;2019-09-10 00:00;77;133;126;259
2019;September;37;2019-09-10 00:00;78;104;97;201
2019;September;37;2019-09-10 00:00;79;84;118;202
2019;September;37;2019-09-10 00:00;80;87;84;171
2019;September;37;2019-09-10 00:00;81;91;76;167
2019;September;37;2019-09-10 00:00;82;73;66;139
2019;September;37;2019-09-10 00:00;83;85;56;141
2019;September;37;2019-09-10 00:00;84;54;57;111
2019;September;37;2019-09-10 00:00;85;58;42;100
2019;September;37;2019-09-10 00:00;86;49;40;89
2019;September;37;2019-09-10 00:00;87;30;32;62
2019;September;37;2019-09-10 00:00;88;35;23;58
2019;September;37;2019-09-10 00:00;89;36;20;56
2019;September;37;2019-09-10 00:00;90;31;21;52
2019;September;37;2019-09-10 00:00;91;21;12;33
2019;September;37;2019-09-10 00:00;92;25;8;33
2019;September;37;2019-09-10 00:00;93;17;7;24
2019;September;37;2019-09-10 00:00;94;16;5;21
2019;September;37;2019-09-10 00:00;95;10;2;12
2019;September;37;2019-09-10 00:00;96;4;4;8
2019;September;37;2019-09-10 00:00;97;8;1;9
2019;September;37;2019-09-10 00:00;98;1;2;3
2019;September;37;2019-09-10 00:00;99;1;2;3
2019;September;37;2019-09-10 00:00;100;0;1;1
2019;September;37;2019-09-10 00:00;107;1;0;1
2019;September;38;2019-09-17 00:00;0;123;137;260
2019;September;38;2019-09-17 00:00;1;209;220;429
2019;September;38;2019-09-17 00:00;2;217;212;429
2019;September;38;2019-09-17 00:00;3;200;222;422
2019;September;38;2019-09-17 00:00;4;205;222;427
2019;September;38;2019-09-17 00:00;5;190;248;438
2019;September;38;2019-09-17 00:00;6;217;237;454
2019;September;38;2019-09-17 00:00;7;199;207;406
2019;September;38;2019-09-17 00:00;8;219;236;455
2019;September;38;2019-09-17 00:00;9;232;239;471
2019;September;38;2019-09-17 00:00;10;211;230;441
2019;September;38;2019-09-17 00:00;11;205;210;415
2019;September;38;2019-09-17 00:00;12;193;210;403
2019;September;38;2019-09-17 00:00;13;226;208;434
2019;September;38;2019-09-17 00:00;14;194;219;413
2019;September;38;2019-09-17 00:00;15;191;207;398
2019;September;38;2019-09-17 00:00;16;179;190;369
2019;September;38;2019-09-17 00:00;17;183;224;407
2019;September;38;2019-09-17 00:00;18;143;183;326
2019;September;38;2019-09-17 00:00;19;170;204;374
2019;September;38;2019-09-17 00:00;20;168;201;369
2019;September;38;2019-09-17 00:00;21;134;172;306
2019;September;38;2019-09-17 00:00;22;135;180;315
2019;September;38;2019-09-17 00:00;23;145;180;325
2019;September;38;2019-09-17 00:00;24;160;175;335
2019;September;38;2019-09-17 00:00;25;176;176;352
2019;September;38;2019-09-17 00:00;26;169;205;374
2019;September;38;2019-09-17 00:00;27;192;182;374
2019;September;38;2019-09-17 00:00;28;191;244;435
2019;September;38;2019-09-17 00:00;29;218;225;443
2019;September;38;2019-09-17 00:00;30;188;214;402
2019;September;38;2019-09-17 00:00;31;205;202;407
2019;September;38;2019-09-17 00:00;32;222;212;434
2019;September;38;2019-09-17 00:00;33;196;199;395
2019;September;38;2019-09-17 00:00;34;204;222;426
2019;September;38;2019-09-17 00:00;35;205;211;416
2019;September;38;2019-09-17 00:00;36;220;190;410
2019;September;38;2019-09-17 00:00;37;217;212;429
2019;September;38;2019-09-17 00:00;38;184;201;385
2019;September;38;2019-09-17 00:00;39;241;215;456
2019;September;38;2019-09-17 00:00;40;212;185;397
2019;September;38;2019-09-17 00:00;41;202;211;413
2019;September;38;2019-09-17 00:00;42;202;218;420
2019;September;38;2019-09-17 00:00;43;226;218;444
2019;September;38;2019-09-17 00:00;44;225;239;464
2019;September;38;2019-09-17 00:00;45;232;284;516
2019;September;38;2019-09-17 00:00;46;212;223;435
2019;September;38;2019-09-17 00:00;47;223;255;478
2019;September;38;2019-09-17 00:00;48;214;224;438
2019;September;38;2019-09-17 00:00;49;203;220;423
2019;September;38;2019-09-17 00:00;50;196;200;396
2019;September;38;2019-09-17 00:00;51;207;220;427
2019;September;38;2019-09-17 00:00;52;240;229;469
2019;September;38;2019-09-17 00:00;53;185;214;399
2019;September;38;2019-09-17 00:00;54;197;218;415
2019;September;38;2019-09-17 00:00;55;188;218;406
2019;September;38;2019-09-17 00:00;56;176;215;391
2019;September;38;2019-09-17 00:00;57;182;180;362
2019;September;38;2019-09-17 00:00;58;150;170;320
2019;September;38;2019-09-17 00:00;59;157;153;310
2019;September;38;2019-09-17 00:00;60;151;158;309
2019;September;38;2019-09-17 00:00;61;146;147;293
2019;September;38;2019-09-17 00:00;62;139;152;291
2019;September;38;2019-09-17 00:00;63;148;157;305
2019;September;38;2019-09-17 00:00;64;132;116;248
2019;September;38;2019-09-17 00:00;65;131;138;269
2019;September;38;2019-09-17 00:00;66;144;131;275
2019;September;38;2019-09-17 00:00;67;136;149;285
2019;September;38;2019-09-17 00:00;68;139;130;269
2019;September;38;2019-09-17 00:00;69;137;155;292
2019;September;38;2019-09-17 00:00;70;147;155;302
2019;September;38;2019-09-17 00:00;71;173;161;334
2019;September;38;2019-09-17 00:00;72;155;147;302
2019;September;38;2019-09-17 00:00;73;179;145;324
2019;September;38;2019-09-17 00:00;74;177;168;345
2019;September;38;2019-09-17 00:00;75;149;153;302
2019;September;38;2019-09-17 00:00;76;149;156;305
2019;September;38;2019-09-17 00:00;77;133;125;258
2019;September;38;2019-09-17 00:00;78;104;97;201
2019;September;38;2019-09-17 00:00;79;84;118;202
2019;September;38;2019-09-17 00:00;80;87;84;171
2019;September;38;2019-09-17 00:00;81;90;76;166
2019;September;38;2019-09-17 00:00;82;73;66;139
2019;September;38;2019-09-17 00:00;83;85;56;141
2019;September;38;2019-09-17 00:00;84;54;57;111
2019;September;38;2019-09-17 00:00;85;58;42;100
2019;September;38;2019-09-17 00:00;86;49;40;89
2019;September;38;2019-09-17 00:00;87;30;32;62
2019;September;38;2019-09-17 00:00;88;35;23;58
2019;September;38;2019-09-17 00:00;89;36;20;56
2019;September;38;2019-09-17 00:00;90;31;21;52
2019;September;38;2019-09-17 00:00;91;21;12;33
2019;September;38;2019-09-17 00:00;92;25;8;33
2019;September;38;2019-09-17 00:00;93;17;7;24
2019;September;38;2019-09-17 00:00;94;16;5;21
2019;September;38;2019-09-17 00:00;95;10;2;12
2019;September;38;2019-09-17 00:00;96;4;4;8
2019;September;38;2019-09-17 00:00;97;8;1;9
2019;September;38;2019-09-17 00:00;98;1;2;3
2019;September;38;2019-09-17 00:00;99;1;2;3
2019;September;38;2019-09-17 00:00;100;0;1;1
2019;September;38;2019-09-17 00:00;107;1;0;1
2019;September;39;2019-09-24 00:00;0;127;142;269
2019;September;39;2019-09-24 00:00;1;209;220;429
2019;September;39;2019-09-24 00:00;2;217;213;430
2019;September;39;2019-09-24 00:00;3;200;222;422
2019;September;39;2019-09-24 00:00;4;205;222;427
2019;September;39;2019-09-24 00:00;5;190;249;439
2019;September;39;2019-09-24 00:00;6;218;237;455
2019;September;39;2019-09-24 00:00;7;200;207;407
2019;September;39;2019-09-24 00:00;8;219;236;455
2019;September;39;2019-09-24 00:00;9;232;239;471
2019;September;39;2019-09-24 00:00;10;211;230;441
2019;September;39;2019-09-24 00:00;11;205;210;415
2019;September;39;2019-09-24 00:00;12;193;211;404
2019;September;39;2019-09-24 00:00;13;226;209;435
2019;September;39;2019-09-24 00:00;14;195;219;414
2019;September;39;2019-09-24 00:00;15;191;207;398
2019;September;39;2019-09-24 00:00;16;179;190;369
2019;September;39;2019-09-24 00:00;17;183;223;406
2019;September;39;2019-09-24 00:00;18;143;182;325
2019;September;39;2019-09-24 00:00;19;170;204;374
2019;September;39;2019-09-24 00:00;20;168;202;370
2019;September;39;2019-09-24 00:00;21;134;172;306
2019;September;39;2019-09-24 00:00;22;136;181;317
2019;September;39;2019-09-24 00:00;23;144;180;324
2019;September;39;2019-09-24 00:00;24;159;177;336
2019;September;39;2019-09-24 00:00;25;177;175;352
2019;September;39;2019-09-24 00:00;26;168;204;372
2019;September;39;2019-09-24 00:00;27;191;181;372
2019;September;39;2019-09-24 00:00;28;191;243;434
2019;September;39;2019-09-24 00:00;29;218;224;442
2019;September;39;2019-09-24 00:00;30;187;213;400
2019;September;39;2019-09-24 00:00;31;206;202;408
2019;September;39;2019-09-24 00:00;32;223;213;436
2019;September;39;2019-09-24 00:00;33;196;200;396
2019;September;39;2019-09-24 00:00;34;205;223;428
2019;September;39;2019-09-24 00:00;35;205;211;416
2019;September;39;2019-09-24 00:00;36;219;191;410
2019;September;39;2019-09-24 00:00;37;217;212;429
2019;September;39;2019-09-24 00:00;38;184;202;386
2019;September;39;2019-09-24 00:00;39;241;215;456
2019;September;39;2019-09-24 00:00;40;212;185;397
2019;September;39;2019-09-24 00:00;41;202;211;413
2019;September;39;2019-09-24 00:00;42;202;218;420
2019;September;39;2019-09-24 00:00;43;226;218;444
2019;September;39;2019-09-24 00:00;44;226;240;466
2019;September;39;2019-09-24 00:00;45;232;284;516
2019;September;39;2019-09-24 00:00;46;212;223;435
2019;September;39;2019-09-24 00:00;47;224;255;479
2019;September;39;2019-09-24 00:00;48;213;224;437
2019;September;39;2019-09-24 00:00;49;203;220;423
2019;September;39;2019-09-24 00:00;50;197;200;397
2019;September;39;2019-09-24 00:00;51;207;221;428
2019;September;39;2019-09-24 00:00;52;240;229;469
2019;September;39;2019-09-24 00:00;53;185;214;399
2019;September;39;2019-09-24 00:00;54;197;218;415
2019;September;39;2019-09-24 00:00;55;188;218;406
2019;September;39;2019-09-24 00:00;56;176;216;392
2019;September;39;2019-09-24 00:00;57;182;180;362
2019;September;39;2019-09-24 00:00;58;151;170;321
2019;September;39;2019-09-24 00:00;59;157;153;310
2019;September;39;2019-09-24 00:00;60;151;158;309
2019;September;39;2019-09-24 00:00;61;146;148;294
2019;September;39;2019-09-24 00:00;62;139;152;291
2019;September;39;2019-09-24 00:00;63;148;158;306
2019;September;39;2019-09-24 00:00;64;132;116;248
2019;September;39;2019-09-24 00:00;65;131;138;269
2019;September;39;2019-09-24 00:00;66;144;131;275
2019;September;39;2019-09-24 00:00;67;136;149;285
2019;September;39;2019-09-24 00:00;68;139;130;269
2019;September;39;2019-09-24 00:00;69;137;155;292
2019;September;39;2019-09-24 00:00;70;147;155;302
2019;September;39;2019-09-24 00:00;71;173;161;334
2019;September;39;2019-09-24 00:00;72;155;147;302
2019;September;39;2019-09-24 00:00;73;179;145;324
2019;September;39;2019-09-24 00:00;74;176;168;344
2019;September;39;2019-09-24 00:00;75;149;152;301
2019;September;39;2019-09-24 00:00;76;149;155;304
2019;September;39;2019-09-24 00:00;77;133;125;258
2019;September;39;2019-09-24 00:00;78;104;97;201
2019;September;39;2019-09-24 00:00;79;84;118;202
2019;September;39;2019-09-24 00:00;80;87;84;171
2019;September;39;2019-09-24 00:00;81;90;76;166
2019;September;39;2019-09-24 00:00;82;73;66;139
2019;September;39;2019-09-24 00:00;83;85;56;141
2019;September;39;2019-09-24 00:00;84;54;57;111
2019;September;39;2019-09-24 00:00;85;58;42;100
2019;September;39;2019-09-24 00:00;86;49;40;89
2019;September;39;2019-09-24 00:00;87;30;32;62
2019;September;39;2019-09-24 00:00;88;35;23;58
2019;September;39;2019-09-24 00:00;89;36;20;56
2019;September;39;2019-09-24 00:00;90;31;21;52
2019;September;39;2019-09-24 00:00;91;21;12;33
2019;September;39;2019-09-24 00:00;92;25;8;33
2019;September;39;2019-09-24 00:00;93;17;7;24
2019;September;39;2019-09-24 00:00;94;16;5;21
2019;September;39;2019-09-24 00:00;95;9;2;11
2019;September;39;2019-09-24 00:00;96;4;4;8
2019;September;39;2019-09-24 00:00;97;8;1;9
2019;September;39;2019-09-24 00:00;98;1;2;3
2019;September;39;2019-09-24 00:00;99;1;2;3
2019;September;39;2019-09-24 00:00;100;0;1;1
2019;September;39;2019-09-24 00:00;107;1;0;1
2019;October;40;2019-10-01 00:00;0;130;144;274
2019;October;40;2019-10-01 00:00;1;208;219;427
2019;October;40;2019-10-01 00:00;2;217;214;431
2019;October;40;2019-10-01 00:00;3;200;223;423
2019;October;40;2019-10-01 00:00;4;205;223;428
2019;October;40;2019-10-01 00:00;5;191;248;439
2019;October;40;2019-10-01 00:00;6;218;237;455
2019;October;40;2019-10-01 00:00;7;200;207;407
2019;October;40;2019-10-01 00:00;8;219;236;455
2019;October;40;2019-10-01 00:00;9;232;239;471
2019;October;40;2019-10-01 00:00;10;211;230;441
2019;October;40;2019-10-01 00:00;11;205;210;415
2019;October;40;2019-10-01 00:00;12;193;211;404
2019;October;40;2019-10-01 00:00;13;226;209;435
2019;October;40;2019-10-01 00:00;14;195;219;414
2019;October;40;2019-10-01 00:00;15;191;207;398
2019;October;40;2019-10-01 00:00;16;179;190;369
2019;October;40;2019-10-01 00:00;17;183;223;406
2019;October;40;2019-10-01 00:00;18;144;182;326
2019;October;40;2019-10-01 00:00;19;170;203;373
2019;October;40;2019-10-01 00:00;20;169;202;371
2019;October;40;2019-10-01 00:00;21;136;172;308
2019;October;40;2019-10-01 00:00;22;135;179;314
2019;October;40;2019-10-01 00:00;23;146;179;325
2019;October;40;2019-10-01 00:00;24;157;177;334
2019;October;40;2019-10-01 00:00;25;176;177;353
2019;October;40;2019-10-01 00:00;26;167;202;369
2019;October;40;2019-10-01 00:00;27;191;180;371
2019;October;40;2019-10-01 00:00;28;190;241;431
2019;October;40;2019-10-01 00:00;29;219;223;442
2019;October;40;2019-10-01 00:00;30;188;214;402
2019;October;40;2019-10-01 00:00;31;205;202;407
2019;October;40;2019-10-01 00:00;32;222;211;433
2019;October;40;2019-10-01 00:00;33;196;201;397
2019;October;40;2019-10-01 00:00;34;207;222;429
2019;October;40;2019-10-01 00:00;35;205;211;416
2019;October;40;2019-10-01 00:00;36;219;192;411
2019;October;40;2019-10-01 00:00;37;217;212;429
2019;October;40;2019-10-01 00:00;38;185;201;386
2019;October;40;2019-10-01 00:00;39;241;214;455
2019;October;40;2019-10-01 00:00;40;212;185;397
2019;October;40;2019-10-01 00:00;41;200;210;410
2019;October;40;2019-10-01 00:00;42;201;218;419
2019;October;40;2019-10-01 00:00;43;226;219;445
2019;October;40;2019-10-01 00:00;44;226;240;466
2019;October;40;2019-10-01 00:00;45;232;285;517
2019;October;40;2019-10-01 00:00;46;212;223;435
2019;October;40;2019-10-01 00:00;47;224;255;479
2019;October;40;2019-10-01 00:00;48;213;224;437
2019;October;40;2019-10-01 00:00;49;203;220;423
2019;October;40;2019-10-01 00:00;50;197;200;397
2019;October;40;2019-10-01 00:00;51;207;221;428
2019;October;40;2019-10-01 00:00;52;240;230;470
2019;October;40;2019-10-01 00:00;53;185;214;399
2019;October;40;2019-10-01 00:00;54;198;218;416
2019;October;40;2019-10-01 00:00;55;188;218;406
2019;October;40;2019-10-01 00:00;56;176;216;392
2019;October;40;2019-10-01 00:00;57;182;180;362
2019;October;40;2019-10-01 00:00;58;151;170;321
2019;October;40;2019-10-01 00:00;59;157;153;310
2019;October;40;2019-10-01 00:00;60;152;159;311
2019;October;40;2019-10-01 00:00;61;146;148;294
2019;October;40;2019-10-01 00:00;62;139;152;291
2019;October;40;2019-10-01 00:00;63;148;158;306
2019;October;40;2019-10-01 00:00;64;132;116;248
2019;October;40;2019-10-01 00:00;65;131;138;269
2019;October;40;2019-10-01 00:00;66;144;131;275
2019;October;40;2019-10-01 00:00;67;136;149;285
2019;October;40;2019-10-01 00:00;68;139;130;269
2019;October;40;2019-10-01 00:00;69;137;155;292
2019;October;40;2019-10-01 00:00;70;147;155;302
2019;October;40;2019-10-01 00:00;71;173;161;334
2019;October;40;2019-10-01 00:00;72;155;147;302
2019;October;40;2019-10-01 00:00;73;179;145;324
2019;October;40;2019-10-01 00:00;74;176;168;344
2019;October;40;2019-10-01 00:00;75;149;152;301
2019;October;40;2019-10-01 00:00;76;149;155;304
2019;October;40;2019-10-01 00:00;77;133;125;258
2019;October;40;2019-10-01 00:00;78;104;97;201
2019;October;40;2019-10-01 00:00;79;84;118;202
2019;October;40;2019-10-01 00:00;80;87;84;171
2019;October;40;2019-10-01 00:00;81;90;76;166
2019;October;40;2019-10-01 00:00;82;73;66;139
2019;October;40;2019-10-01 00:00;83;85;56;141
2019;October;40;2019-10-01 00:00;84;54;57;111
2019;October;40;2019-10-01 00:00;85;58;42;100
2019;October;40;2019-10-01 00:00;86;49;40;89
2019;October;40;2019-10-01 00:00;87;30;32;62
2019;October;40;2019-10-01 00:00;88;35;23;58
2019;October;40;2019-10-01 00:00;89;36;20;56
2019;October;40;2019-10-01 00:00;90;31;20;51
2019;October;40;2019-10-01 00:00;91;21;12;33
2019;October;40;2019-10-01 00:00;92;25;8;33
2019;October;40;2019-10-01 00:00;93;17;7;24
2019;October;40;2019-10-01 00:00;94;16;5;21
2019;October;40;2019-10-01 00:00;95;9;2;11
2019;October;40;2019-10-01 00:00;96;4;4;8
2019;October;40;2019-10-01 00:00;97;8;1;9
2019;October;40;2019-10-01 00:00;98;1;2;3
2019;October;40;2019-10-01 00:00;99;1;2;3
2019;October;40;2019-10-01 00:00;100;0;1;1
2019;October;40;2019-10-01 00:00;107;1;0;1
2019;October;41;2019-10-08 00:00;0;136;150;286
2019;October;41;2019-10-08 00:00;1;208;218;426
2019;October;41;2019-10-08 00:00;2;215;216;431
2019;October;41;2019-10-08 00:00;3;201;223;424
2019;October;41;2019-10-08 00:00;4;206;223;429
2019;October;41;2019-10-08 00:00;5;191;248;439
2019;October;41;2019-10-08 00:00;6;219;237;456
2019;October;41;2019-10-08 00:00;7;199;207;406
2019;October;41;2019-10-08 00:00;8;218;236;454
2019;October;41;2019-10-08 00:00;9;232;240;472
2019;October;41;2019-10-08 00:00;10;211;229;440
2019;October;41;2019-10-08 00:00;11;205;210;415
2019;October;41;2019-10-08 00:00;12;193;211;404
2019;October;41;2019-10-08 00:00;13;226;209;435
2019;October;41;2019-10-08 00:00;14;195;219;414
2019;October;41;2019-10-08 00:00;15;191;207;398
2019;October;41;2019-10-08 00:00;16;179;191;370
2019;October;41;2019-10-08 00:00;17;183;223;406
2019;October;41;2019-10-08 00:00;18;144;182;326
2019;October;41;2019-10-08 00:00;19;169;201;370
2019;October;41;2019-10-08 00:00;20;168;200;368
2019;October;41;2019-10-08 00:00;21;137;172;309
2019;October;41;2019-10-08 00:00;22;135;179;314
2019;October;41;2019-10-08 00:00;23;148;178;326
2019;October;41;2019-10-08 00:00;24;157;180;337
2019;October;41;2019-10-08 00:00;25;176;176;352
2019;October;41;2019-10-08 00:00;26;166;203;369
2019;October;41;2019-10-08 00:00;27;190;179;369
2019;October;41;2019-10-08 00:00;28;189;243;432
2019;October;41;2019-10-08 00:00;29;221;223;444
2019;October;41;2019-10-08 00:00;30;189;215;404
2019;October;41;2019-10-08 00:00;31;203;201;404
2019;October;41;2019-10-08 00:00;32;222;209;431
2019;October;41;2019-10-08 00:00;33;195;203;398
2019;October;41;2019-10-08 00:00;34;208;221;429
2019;October;41;2019-10-08 00:00;35;205;210;415
2019;October;41;2019-10-08 00:00;36;216;192;408
2019;October;41;2019-10-08 00:00;37;218;212;430
2019;October;41;2019-10-08 00:00;38;186;201;387
2019;October;41;2019-10-08 00:00;39;241;215;456
2019;October;41;2019-10-08 00:00;40;212;183;395
2019;October;41;2019-10-08 00:00;41;202;211;413
2019;October;41;2019-10-08 00:00;42;201;219;420
2019;October;41;2019-10-08 00:00;43;227;220;447
2019;October;41;2019-10-08 00:00;44;227;241;468
2019;October;41;2019-10-08 00:00;45;231;287;518
2019;October;41;2019-10-08 00:00;46;212;223;435
2019;October;41;2019-10-08 00:00;47;224;255;479
2019;October;41;2019-10-08 00:00;48;214;223;437
2019;October;41;2019-10-08 00:00;49;203;220;423
2019;October;41;2019-10-08 00:00;50;196;199;395
2019;October;41;2019-10-08 00:00;51;207;222;429
2019;October;41;2019-10-08 00:00;52;240;230;470
2019;October;41;2019-10-08 00:00;53;185;215;400
2019;October;41;2019-10-08 00:00;54;198;218;416
2019;October;41;2019-10-08 00:00;55;188;218;406
2019;October;41;2019-10-08 00:00;56;176;216;392
2019;October;41;2019-10-08 00:00;57;182;180;362
2019;October;41;2019-10-08 00:00;58;152;170;322
2019;October;41;2019-10-08 00:00;59;156;153;309
2019;October;41;2019-10-08 00:00;60;152;158;310
2019;October;41;2019-10-08 00:00;61;146;148;294
2019;October;41;2019-10-08 00:00;62;139;152;291
2019;October;41;2019-10-08 00:00;63;148;157;305
2019;October;41;2019-10-08 00:00;64;132;116;248
2019;October;41;2019-10-08 00:00;65;131;138;269
2019;October;41;2019-10-08 00:00;66;144;131;275
2019;October;41;2019-10-08 00:00;67;136;149;285
2019;October;41;2019-10-08 00:00;68;139;130;269
2019;October;41;2019-10-08 00:00;69;136;155;291
2019;October;41;2019-10-08 00:00;70;146;155;301
2019;October;41;2019-10-08 00:00;71;173;160;333
2019;October;41;2019-10-08 00:00;72;154;146;300
2019;October;41;2019-10-08 00:00;73;179;145;324
2019;October;41;2019-10-08 00:00;74;176;168;344
2019;October;41;2019-10-08 00:00;75;149;151;300
2019;October;41;2019-10-08 00:00;76;149;155;304
2019;October;41;2019-10-08 00:00;77;133;125;258
2019;October;41;2019-10-08 00:00;78;104;97;201
2019;October;41;2019-10-08 00:00;79;83;118;201
2019;October;41;2019-10-08 00:00;80;86;84;170
2019;October;41;2019-10-08 00:00;81;90;76;166
2019;October;41;2019-10-08 00:00;82;73;66;139
2019;October;41;2019-10-08 00:00;83;85;56;141
2019;October;41;2019-10-08 00:00;84;54;57;111
2019;October;41;2019-10-08 00:00;85;58;42;100
2019;October;41;2019-10-08 00:00;86;49;40;89
2019;October;41;2019-10-08 00:00;87;29;32;61
2019;October;41;2019-10-08 00:00;88;35;23;58
2019;October;41;2019-10-08 00:00;89;35;20;55
2019;October;41;2019-10-08 00:00;90;31;20;51
2019;October;41;2019-10-08 00:00;91;21;12;33
2019;October;41;2019-10-08 00:00;92;25;8;33
2019;October;41;2019-10-08 00:00;93;16;7;23
2019;October;41;2019-10-08 00:00;94;16;5;21
2019;October;41;2019-10-08 00:00;95;8;2;10
2019;October;41;2019-10-08 00:00;96;4;4;8
2019;October;41;2019-10-08 00:00;97;8;1;9
2019;October;41;2019-10-08 00:00;98;1;2;3
2019;October;41;2019-10-08 00:00;99;1;2;3
2019;October;41;2019-10-08 00:00;100;0;1;1
2019;October;41;2019-10-08 00:00;107;1;0;1
2019;October;43;2019-10-22 00:00;0;139;153;292
2019;October;43;2019-10-22 00:00;1;210;218;428
2019;October;43;2019-10-22 00:00;2;215;214;429
2019;October;43;2019-10-22 00:00;3;202;223;425
2019;October;43;2019-10-22 00:00;4;206;223;429
2019;October;43;2019-10-22 00:00;5;190;248;438
2019;October;43;2019-10-22 00:00;6;219;237;456
2019;October;43;2019-10-22 00:00;7;199;207;406
2019;October;43;2019-10-22 00:00;8;218;236;454
2019;October;43;2019-10-22 00:00;9;232;240;472
2019;October;43;2019-10-22 00:00;10;211;229;440
2019;October;43;2019-10-22 00:00;11;205;210;415
2019;October;43;2019-10-22 00:00;12;193;210;403
2019;October;43;2019-10-22 00:00;13;226;209;435
2019;October;43;2019-10-22 00:00;14;195;219;414
2019;October;43;2019-10-22 00:00;15;191;206;397
2019;October;43;2019-10-22 00:00;16;179;191;370
2019;October;43;2019-10-22 00:00;17;184;223;407
2019;October;43;2019-10-22 00:00;18;145;182;327
2019;October;43;2019-10-22 00:00;19;170;201;371
2019;October;43;2019-10-22 00:00;20;168;201;369
2019;October;43;2019-10-22 00:00;21;138;173;311
2019;October;43;2019-10-22 00:00;22;136;179;315
2019;October;43;2019-10-22 00:00;23;147;178;325
2019;October;43;2019-10-22 00:00;24;158;181;339
2019;October;43;2019-10-22 00:00;25;177;176;353
2019;October;43;2019-10-22 00:00;26;165;204;369
2019;October;43;2019-10-22 00:00;27;189;178;367
2019;October;43;2019-10-22 00:00;28;189;242;431
2019;October;43;2019-10-22 00:00;29;221;222;443
2019;October;43;2019-10-22 00:00;30;188;216;404
2019;October;43;2019-10-22 00:00;31;203;200;403
2019;October;43;2019-10-22 00:00;32;223;211;434
2019;October;43;2019-10-22 00:00;33;196;204;400
2019;October;43;2019-10-22 00:00;34;207;220;427
2019;October;43;2019-10-22 00:00;35;205;210;415
2019;October;43;2019-10-22 00:00;36;216;192;408
2019;October;43;2019-10-22 00:00;37;218;212;430
2019;October;43;2019-10-22 00:00;38;185;201;386
2019;October;43;2019-10-22 00:00;39;241;215;456
2019;October;43;2019-10-22 00:00;40;213;183;396
2019;October;43;2019-10-22 00:00;41;202;211;413
2019;October;43;2019-10-22 00:00;42;203;219;422
2019;October;43;2019-10-22 00:00;43;226;220;446
2019;October;43;2019-10-22 00:00;44;228;241;469
2019;October;43;2019-10-22 00:00;45;231;286;517
2019;October;43;2019-10-22 00:00;46;212;223;435
2019;October;43;2019-10-22 00:00;47;224;255;479
2019;October;43;2019-10-22 00:00;48;214;224;438
2019;October;43;2019-10-22 00:00;49;203;220;423
2019;October;43;2019-10-22 00:00;50;196;199;395
2019;October;43;2019-10-22 00:00;51;207;221;428
2019;October;43;2019-10-22 00:00;52;240;230;470
2019;October;43;2019-10-22 00:00;53;185;215;400
2019;October;43;2019-10-22 00:00;54;199;218;417
2019;October;43;2019-10-22 00:00;55;187;217;404
2019;October;43;2019-10-22 00:00;56;176;217;393
2019;October;43;2019-10-22 00:00;57;182;180;362
2019;October;43;2019-10-22 00:00;58;152;169;321
2019;October;43;2019-10-22 00:00;59;156;153;309
2019;October;43;2019-10-22 00:00;60;152;157;309
2019;October;43;2019-10-22 00:00;61;146;149;295
2019;October;43;2019-10-22 00:00;62;139;152;291
2019;October;43;2019-10-22 00:00;63;148;156;304
2019;October;43;2019-10-22 00:00;64;132;116;248
2019;October;43;2019-10-22 00:00;65;131;138;269
2019;October;43;2019-10-22 00:00;66;144;131;275
2019;October;43;2019-10-22 00:00;67;136;149;285
2019;October;43;2019-10-22 00:00;68;139;130;269
2019;October;43;2019-10-22 00:00;69;136;153;289
2019;October;43;2019-10-22 00:00;70;146;155;301
2019;October;43;2019-10-22 00:00;71;173;160;333
2019;October;43;2019-10-22 00:00;72;154;146;300
2019;October;43;2019-10-22 00:00;73;179;145;324
2019;October;43;2019-10-22 00:00;74;176;168;344
2019;October;43;2019-10-22 00:00;75;149;151;300
2019;October;43;2019-10-22 00:00;76;149;155;304
2019;October;43;2019-10-22 00:00;77;133;125;258
2019;October;43;2019-10-22 00:00;78;104;97;201
2019;October;43;2019-10-22 00:00;79;83;118;201
2019;October;43;2019-10-22 00:00;80;86;84;170
2019;October;43;2019-10-22 00:00;81;90;76;166
2019;October;43;2019-10-22 00:00;82;73;66;139
2019;October;43;2019-10-22 00:00;83;85;55;140
2019;October;43;2019-10-22 00:00;84;54;57;111
2019;October;43;2019-10-22 00:00;85;57;41;98
2019;October;43;2019-10-22 00:00;86;50;39;89
2019;October;43;2019-10-22 00:00;87;29;32;61
2019;October;43;2019-10-22 00:00;88;35;23;58
2019;October;43;2019-10-22 00:00;89;35;20;55
2019;October;43;2019-10-22 00:00;90;31;20;51
2019;October;43;2019-10-22 00:00;91;21;12;33
2019;October;43;2019-10-22 00:00;92;25;8;33
2019;October;43;2019-10-22 00:00;93;15;7;22
2019;October;43;2019-10-22 00:00;94;16;5;21
2019;October;43;2019-10-22 00:00;95;8;2;10
2019;October;43;2019-10-22 00:00;96;4;4;8
2019;October;43;2019-10-22 00:00;97;8;1;9
2019;October;43;2019-10-22 00:00;98;1;2;3
2019;October;43;2019-10-22 00:00;99;1;2;3
2019;October;43;2019-10-22 00:00;100;0;1;1
2019;October;43;2019-10-22 00:00;107;1;0;1
2019;October;44;2019-10-29 00:00;0;144;157;301
2019;October;44;2019-10-29 00:00;1;210;219;429
2019;October;44;2019-10-29 00:00;2;215;213;428
2019;October;44;2019-10-29 00:00;3;202;223;425
2019;October;44;2019-10-29 00:00;4;206;223;429
2019;October;44;2019-10-29 00:00;5;190;248;438
2019;October;44;2019-10-29 00:00;6;219;236;455
2019;October;44;2019-10-29 00:00;7;199;208;407
2019;October;44;2019-10-29 00:00;8;218;236;454
2019;October;44;2019-10-29 00:00;9;232;240;472
2019;October;44;2019-10-29 00:00;10;211;229;440
2019;October;44;2019-10-29 00:00;11;204;210;414
2019;October;44;2019-10-29 00:00;12;193;210;403
2019;October;44;2019-10-29 00:00;13;227;208;435
2019;October;44;2019-10-29 00:00;14;196;219;415
2019;October;44;2019-10-29 00:00;15;189;206;395
2019;October;44;2019-10-29 00:00;16;179;191;370
2019;October;44;2019-10-29 00:00;17;184;223;407
2019;October;44;2019-10-29 00:00;18;145;182;327
2019;October;44;2019-10-29 00:00;19;171;199;370
2019;October;44;2019-10-29 00:00;20;168;200;368
2019;October;44;2019-10-29 00:00;21;139;174;313
2019;October;44;2019-10-29 00:00;22;137;180;317
2019;October;44;2019-10-29 00:00;23;149;178;327
2019;October;44;2019-10-29 00:00;24;159;182;341
2019;October;44;2019-10-29 00:00;25;177;175;352
2019;October;44;2019-10-29 00:00;26;163;202;365
2019;October;44;2019-10-29 00:00;27;189;178;367
2019;October;44;2019-10-29 00:00;28;188;240;428
2019;October;44;2019-10-29 00:00;29;222;223;445
2019;October;44;2019-10-29 00:00;30;188;216;404
2019;October;44;2019-10-29 00:00;31;202;198;400
2019;October;44;2019-10-29 00:00;32;223;212;435
2019;October;44;2019-10-29 00:00;33;195;204;399
2019;October;44;2019-10-29 00:00;34;207;219;426
2019;October;44;2019-10-29 00:00;35;205;209;414
2019;October;44;2019-10-29 00:00;36;216;193;409
2019;October;44;2019-10-29 00:00;37;218;212;430
2019;October;44;2019-10-29 00:00;38;183;200;383
2019;October;44;2019-10-29 00:00;39;241;215;456
2019;October;44;2019-10-29 00:00;40;213;182;395
2019;October;44;2019-10-29 00:00;41;202;211;413
2019;October;44;2019-10-29 00:00;42;203;220;423
2019;October;44;2019-10-29 00:00;43;226;221;447
2019;October;44;2019-10-29 00:00;44;228;241;469
2019;October;44;2019-10-29 00:00;45;231;286;517
2019;October;44;2019-10-29 00:00;46;211;223;434
2019;October;44;2019-10-29 00:00;47;224;255;479
2019;October;44;2019-10-29 00:00;48;214;224;438
2019;October;44;2019-10-29 00:00;49;203;219;422
2019;October;44;2019-10-29 00:00;50;196;198;394
2019;October;44;2019-10-29 00:00;51;207;221;428
2019;October;44;2019-10-29 00:00;52;239;230;469
2019;October;44;2019-10-29 00:00;53;185;215;400
2019;October;44;2019-10-29 00:00;54;199;218;417
2019;October;44;2019-10-29 00:00;55;188;217;405
2019;October;44;2019-10-29 00:00;56;175;217;392
2019;October;44;2019-10-29 00:00;57;182;180;362
2019;October;44;2019-10-29 00:00;58;152;169;321
2019;October;44;2019-10-29 00:00;59;156;152;308
2019;October;44;2019-10-29 00:00;60;152;157;309
2019;October;44;2019-10-29 00:00;61;146;149;295
2019;October;44;2019-10-29 00:00;62;139;152;291
2019;October;44;2019-10-29 00:00;63;148;156;304
2019;October;44;2019-10-29 00:00;64;132;116;248
2019;October;44;2019-10-29 00:00;65;130;138;268
2019;October;44;2019-10-29 00:00;66;144;131;275
2019;October;44;2019-10-29 00:00;67;136;149;285
2019;October;44;2019-10-29 00:00;68;139;130;269
2019;October;44;2019-10-29 00:00;69;136;153;289
2019;October;44;2019-10-29 00:00;70;147;155;302
2019;October;44;2019-10-29 00:00;71;173;160;333
2019;October;44;2019-10-29 00:00;72;154;146;300
2019;October;44;2019-10-29 00:00;73;179;145;324
2019;October;44;2019-10-29 00:00;74;176;168;344
2019;October;44;2019-10-29 00:00;75;149;151;300
2019;October;44;2019-10-29 00:00;76;149;155;304
2019;October;44;2019-10-29 00:00;77;133;125;258
2019;October;44;2019-10-29 00:00;78;104;97;201
2019;October;44;2019-10-29 00:00;79;83;118;201
2019;October;44;2019-10-29 00:00;80;86;84;170
2019;October;44;2019-10-29 00:00;81;89;76;165
2019;October;44;2019-10-29 00:00;82;73;66;139
2019;October;44;2019-10-29 00:00;83;85;54;139
2019;October;44;2019-10-29 00:00;84;54;57;111
2019;October;44;2019-10-29 00:00;85;57;41;98
2019;October;44;2019-10-29 00:00;86;50;38;88
2019;October;44;2019-10-29 00:00;87;29;32;61
2019;October;44;2019-10-29 00:00;88;35;22;57
2019;October;44;2019-10-29 00:00;89;35;20;55
2019;October;44;2019-10-29 00:00;90;31;20;51
2019;October;44;2019-10-29 00:00;91;21;12;33
2019;October;44;2019-10-29 00:00;92;25;8;33
2019;October;44;2019-10-29 00:00;93;15;7;22
2019;October;44;2019-10-29 00:00;94;16;5;21
2019;October;44;2019-10-29 00:00;95;8;2;10
2019;October;44;2019-10-29 00:00;96;4;4;8
2019;October;44;2019-10-29 00:00;97;8;1;9
2019;October;44;2019-10-29 00:00;98;1;2;3
2019;October;44;2019-10-29 00:00;99;1;2;3
2019;October;44;2019-10-29 00:00;100;0;1;1
2019;October;44;2019-10-29 00:00;107;1;0;1
2019;November;45;2019-11-05 00:00;0;150;159;309
2019;November;45;2019-11-05 00:00;1;209;221;430
2019;November;45;2019-11-05 00:00;2;214;213;427
2019;November;45;2019-11-05 00:00;3;201;223;424
2019;November;45;2019-11-05 00:00;4;208;224;432
2019;November;45;2019-11-05 00:00;5;190;250;440
2019;November;45;2019-11-05 00:00;6;219;236;455
2019;November;45;2019-11-05 00:00;7;199;209;408
2019;November;45;2019-11-05 00:00;8;218;236;454
2019;November;45;2019-11-05 00:00;9;232;241;473
2019;November;45;2019-11-05 00:00;10;211;228;439
2019;November;45;2019-11-05 00:00;11;206;209;415
2019;November;45;2019-11-05 00:00;12;193;211;404
2019;November;45;2019-11-05 00:00;13;227;208;435
2019;November;45;2019-11-05 00:00;14;196;219;415
2019;November;45;2019-11-05 00:00;15;189;206;395
2019;November;45;2019-11-05 00:00;16;179;191;370
2019;November;45;2019-11-05 00:00;17;184;223;407
2019;November;45;2019-11-05 00:00;18;142;181;323
2019;November;45;2019-11-05 00:00;19;172;197;369
2019;November;45;2019-11-05 00:00;20;164;202;366
2019;November;45;2019-11-05 00:00;21;136;173;309
2019;November;45;2019-11-05 00:00;22;138;177;315
2019;November;45;2019-11-05 00:00;23;142;174;316
2019;November;45;2019-11-05 00:00;24;158;181;339
2019;November;45;2019-11-05 00:00;25;175;177;352
2019;November;45;2019-11-05 00:00;26;164;200;364
2019;November;45;2019-11-05 00:00;27;190;181;371
2019;November;45;2019-11-05 00:00;28;187;239;426
2019;November;45;2019-11-05 00:00;29;225;222;447
2019;November;45;2019-11-05 00:00;30;186;216;402
2019;November;45;2019-11-05 00:00;31;202;197;399
2019;November;45;2019-11-05 00:00;32;223;210;433
2019;November;45;2019-11-05 00:00;33;195;204;399
2019;November;45;2019-11-05 00:00;34;207;217;424
2019;November;45;2019-11-05 00:00;35;206;210;416
2019;November;45;2019-11-05 00:00;36;218;193;411
2019;November;45;2019-11-05 00:00;37;217;213;430
2019;November;45;2019-11-05 00:00;38;184;202;386
2019;November;45;2019-11-05 00:00;39;240;216;456
2019;November;45;2019-11-05 00:00;40;212;182;394
2019;November;45;2019-11-05 00:00;41;202;211;413
2019;November;45;2019-11-05 00:00;42;203;221;424
2019;November;45;2019-11-05 00:00;43;226;222;448
2019;November;45;2019-11-05 00:00;44;228;241;469
2019;November;45;2019-11-05 00:00;45;230;285;515
2019;November;45;2019-11-05 00:00;46;213;223;436
2019;November;45;2019-11-05 00:00;47;223;256;479
2019;November;45;2019-11-05 00:00;48;215;224;439
2019;November;45;2019-11-05 00:00;49;202;219;421
2019;November;45;2019-11-05 00:00;50;195;197;392
2019;November;45;2019-11-05 00:00;51;207;221;428
2019;November;45;2019-11-05 00:00;52;240;231;471
2019;November;45;2019-11-05 00:00;53;185;214;399
2019;November;45;2019-11-05 00:00;54;199;215;414
2019;November;45;2019-11-05 00:00;55;187;217;404
2019;November;45;2019-11-05 00:00;56;175;216;391
2019;November;45;2019-11-05 00:00;57;182;181;363
2019;November;45;2019-11-05 00:00;58;151;169;320
2019;November;45;2019-11-05 00:00;59;155;152;307
2019;November;45;2019-11-05 00:00;60;151;157;308
2019;November;45;2019-11-05 00:00;61;145;150;295
2019;November;45;2019-11-05 00:00;62;138;151;289
2019;November;45;2019-11-05 00:00;63;148;158;306
2019;November;45;2019-11-05 00:00;64;132;116;248
2019;November;45;2019-11-05 00:00;65;129;138;267
2019;November;45;2019-11-05 00:00;66;144;131;275
2019;November;45;2019-11-05 00:00;67;136;148;284
2019;November;45;2019-11-05 00:00;68;140;130;270
2019;November;45;2019-11-05 00:00;69;136;153;289
2019;November;45;2019-11-05 00:00;70;147;155;302
2019;November;45;2019-11-05 00:00;71;172;160;332
2019;November;45;2019-11-05 00:00;72;154;146;300
2019;November;45;2019-11-05 00:00;73;179;145;324
2019;November;45;2019-11-05 00:00;74;176;168;344
2019;November;45;2019-11-05 00:00;75;148;151;299
2019;November;45;2019-11-05 00:00;76;149;155;304
2019;November;45;2019-11-05 00:00;77;133;123;256
2019;November;45;2019-11-05 00:00;78;104;97;201
2019;November;45;2019-11-05 00:00;79;83;117;200
2019;November;45;2019-11-05 00:00;80;86;83;169
2019;November;45;2019-11-05 00:00;81;89;76;165
2019;November;45;2019-11-05 00:00;82;72;66;138
2019;November;45;2019-11-05 00:00;83;85;53;138
2019;November;45;2019-11-05 00:00;84;54;57;111
2019;November;45;2019-11-05 00:00;85;56;41;97
2019;November;45;2019-11-05 00:00;86;50;38;88
2019;November;45;2019-11-05 00:00;87;29;32;61
2019;November;45;2019-11-05 00:00;88;35;22;57
2019;November;45;2019-11-05 00:00;89;35;19;54
2019;November;45;2019-11-05 00:00;90;31;20;51
2019;November;45;2019-11-05 00:00;91;21;12;33
2019;November;45;2019-11-05 00:00;92;25;8;33
2019;November;45;2019-11-05 00:00;93;15;7;22
2019;November;45;2019-11-05 00:00;94;16;5;21
2019;November;45;2019-11-05 00:00;95;7;2;9
2019;November;45;2019-11-05 00:00;96;4;4;8
2019;November;45;2019-11-05 00:00;97;8;1;9
2019;November;45;2019-11-05 00:00;98;1;2;3
2019;November;45;2019-11-05 00:00;99;1;2;3
2019;November;45;2019-11-05 00:00;100;0;1;1
2019;November;45;2019-11-05 00:00;107;1;0;1
2019;November;46;2019-11-12 00:00;0;150;159;309
2019;November;46;2019-11-12 00:00;1;209;221;430
2019;November;46;2019-11-12 00:00;2;214;213;427
2019;November;46;2019-11-12 00:00;3;201;223;424
2019;November;46;2019-11-12 00:00;4;208;224;432
2019;November;46;2019-11-12 00:00;5;190;250;440
2019;November;46;2019-11-12 00:00;6;219;236;455
2019;November;46;2019-11-12 00:00;7;199;209;408
2019;November;46;2019-11-12 00:00;8;218;236;454
2019;November;46;2019-11-12 00:00;9;232;241;473
2019;November;46;2019-11-12 00:00;10;211;228;439
2019;November;46;2019-11-12 00:00;11;206;209;415
2019;November;46;2019-11-12 00:00;12;193;211;404
2019;November;46;2019-11-12 00:00;13;227;208;435
2019;November;46;2019-11-12 00:00;14;196;219;415
2019;November;46;2019-11-12 00:00;15;189;206;395
2019;November;46;2019-11-12 00:00;16;179;191;370
2019;November;46;2019-11-12 00:00;17;184;223;407
2019;November;46;2019-11-12 00:00;18;142;181;323
2019;November;46;2019-11-12 00:00;19;172;197;369
2019;November;46;2019-11-12 00:00;20;164;202;366
2019;November;46;2019-11-12 00:00;21;136;173;309
2019;November;46;2019-11-12 00:00;22;138;177;315
2019;November;46;2019-11-12 00:00;23;142;174;316
2019;November;46;2019-11-12 00:00;24;158;181;339
2019;November;46;2019-11-12 00:00;25;175;177;352
2019;November;46;2019-11-12 00:00;26;164;200;364
2019;November;46;2019-11-12 00:00;27;190;181;371
2019;November;46;2019-11-12 00:00;28;187;239;426
2019;November;46;2019-11-12 00:00;29;225;222;447
2019;November;46;2019-11-12 00:00;30;186;216;402
2019;November;46;2019-11-12 00:00;31;202;197;399
2019;November;46;2019-11-12 00:00;32;223;210;433
2019;November;46;2019-11-12 00:00;33;195;204;399
2019;November;46;2019-11-12 00:00;34;207;217;424
2019;November;46;2019-11-12 00:00;35;206;210;416
2019;November;46;2019-11-12 00:00;36;218;193;411
2019;November;46;2019-11-12 00:00;37;217;213;430
2019;November;46;2019-11-12 00:00;38;184;202;386
2019;November;46;2019-11-12 00:00;39;240;216;456
2019;November;46;2019-11-12 00:00;40;212;182;394
2019;November;46;2019-11-12 00:00;41;202;211;413
2019;November;46;2019-11-12 00:00;42;203;221;424
2019;November;46;2019-11-12 00:00;43;226;222;448
2019;November;46;2019-11-12 00:00;44;228;241;469
2019;November;46;2019-11-12 00:00;45;230;285;515
2019;November;46;2019-11-12 00:00;46;213;223;436
2019;November;46;2019-11-12 00:00;47;223;256;479
2019;November;46;2019-11-12 00:00;48;215;224;439
2019;November;46;2019-11-12 00:00;49;202;219;421
2019;November;46;2019-11-12 00:00;50;195;197;392
2019;November;46;2019-11-12 00:00;51;207;221;428
2019;November;46;2019-11-12 00:00;52;240;231;471
2019;November;46;2019-11-12 00:00;53;185;214;399
2019;November;46;2019-11-12 00:00;54;199;215;414
2019;November;46;2019-11-12 00:00;55;187;217;404
2019;November;46;2019-11-12 00:00;56;175;216;391
2019;November;46;2019-11-12 00:00;57;182;181;363
2019;November;46;2019-11-12 00:00;58;151;169;320
2019;November;46;2019-11-12 00:00;59;155;152;307
2019;November;46;2019-11-12 00:00;60;151;157;308
2019;November;46;2019-11-12 00:00;61;145;150;295
2019;November;46;2019-11-12 00:00;62;138;151;289
2019;November;46;2019-11-12 00:00;63;148;158;306
2019;November;46;2019-11-12 00:00;64;132;116;248
2019;November;46;2019-11-12 00:00;65;129;138;267
2019;November;46;2019-11-12 00:00;66;144;131;275
2019;November;46;2019-11-12 00:00;67;136;148;284
2019;November;46;2019-11-12 00:00;68;140;130;270
2019;November;46;2019-11-12 00:00;69;136;153;289
2019;November;46;2019-11-12 00:00;70;147;155;302
2019;November;46;2019-11-12 00:00;71;172;160;332
2019;November;46;2019-11-12 00:00;72;154;146;300
2019;November;46;2019-11-12 00:00;73;179;145;324
2019;November;46;2019-11-12 00:00;74;176;168;344
2019;November;46;2019-11-12 00:00;75;148;151;299
2019;November;46;2019-11-12 00:00;76;149;155;304
2019;November;46;2019-11-12 00:00;77;133;123;256
2019;November;46;2019-11-12 00:00;78;104;97;201
2019;November;46;2019-11-12 00:00;79;83;117;200
2019;November;46;2019-11-12 00:00;80;86;83;169
2019;November;46;2019-11-12 00:00;81;89;76;165
2019;November;46;2019-11-12 00:00;82;72;66;138
2019;November;46;2019-11-12 00:00;83;85;53;138
2019;November;46;2019-11-12 00:00;84;54;57;111
2019;November;46;2019-11-12 00:00;85;56;41;97
2019;November;46;2019-11-12 00:00;86;50;38;88
2019;November;46;2019-11-12 00:00;87;29;32;61
2019;November;46;2019-11-12 00:00;88;35;22;57
2019;November;46;2019-11-12 00:00;89;35;19;54
2019;November;46;2019-11-12 00:00;90;31;20;51
2019;November;46;2019-11-12 00:00;91;21;12;33
2019;November;46;2019-11-12 00:00;92;25;8;33
2019;November;46;2019-11-12 00:00;93;15;7;22
2019;November;46;2019-11-12 00:00;94;16;5;21
2019;November;46;2019-11-12 00:00;95;7;2;9
2019;November;46;2019-11-12 00:00;96;4;4;8
2019;November;46;2019-11-12 00:00;97;8;1;9
2019;November;46;2019-11-12 00:00;98;1;2;3
2019;November;46;2019-11-12 00:00;99;1;2;3
2019;November;46;2019-11-12 00:00;100;0;1;1
2019;November;46;2019-11-12 00:00;107;1;0;1
2019;November;47;2019-11-19 00:00;0;156;166;322
2019;November;47;2019-11-19 00:00;1;210;223;433
2019;November;47;2019-11-19 00:00;2;213;215;428
2019;November;47;2019-11-19 00:00;3;201;225;426
2019;November;47;2019-11-19 00:00;4;208;224;432
2019;November;47;2019-11-19 00:00;5;192;251;443
2019;November;47;2019-11-19 00:00;6;220;237;457
2019;November;47;2019-11-19 00:00;7;199;208;407
2019;November;47;2019-11-19 00:00;8;219;236;455
2019;November;47;2019-11-19 00:00;9;232;241;473
2019;November;47;2019-11-19 00:00;10;212;229;441
2019;November;47;2019-11-19 00:00;11;206;209;415
2019;November;47;2019-11-19 00:00;12;193;211;404
2019;November;47;2019-11-19 00:00;13;227;208;435
2019;November;47;2019-11-19 00:00;14;196;219;415
2019;November;47;2019-11-19 00:00;15;189;205;394
2019;November;47;2019-11-19 00:00;16;179;191;370
2019;November;47;2019-11-19 00:00;17;185;225;410
2019;November;47;2019-11-19 00:00;18;142;182;324
2019;November;47;2019-11-19 00:00;19;172;197;369
2019;November;47;2019-11-19 00:00;20;164;203;367
2019;November;47;2019-11-19 00:00;21;134;173;307
2019;November;47;2019-11-19 00:00;22;138;178;316
2019;November;47;2019-11-19 00:00;23;142;173;315
2019;November;47;2019-11-19 00:00;24;158;181;339
2019;November;47;2019-11-19 00:00;25;176;174;350
2019;November;47;2019-11-19 00:00;26;165;200;365
2019;November;47;2019-11-19 00:00;27;193;181;374
2019;November;47;2019-11-19 00:00;28;188;240;428
2019;November;47;2019-11-19 00:00;29;224;221;445
2019;November;47;2019-11-19 00:00;30;190;214;404
2019;November;47;2019-11-19 00:00;31;202;198;400
2019;November;47;2019-11-19 00:00;32;222;211;433
2019;November;47;2019-11-19 00:00;33;196;205;401
2019;November;47;2019-11-19 00:00;34;212;220;432
2019;November;47;2019-11-19 00:00;35;206;211;417
2019;November;47;2019-11-19 00:00;36;221;194;415
2019;November;47;2019-11-19 00:00;37;219;215;434
2019;November;47;2019-11-19 00:00;38;184;203;387
2019;November;47;2019-11-19 00:00;39;240;215;455
2019;November;47;2019-11-19 00:00;40;212;182;394
2019;November;47;2019-11-19 00:00;41;202;212;414
2019;November;47;2019-11-19 00:00;42;203;220;423
2019;November;47;2019-11-19 00:00;43;226;222;448
2019;November;47;2019-11-19 00:00;44;228;241;469
2019;November;47;2019-11-19 00:00;45;231;286;517
2019;November;47;2019-11-19 00:00;46;213;223;436
2019;November;47;2019-11-19 00:00;47;223;256;479
2019;November;47;2019-11-19 00:00;48;215;224;439
2019;November;47;2019-11-19 00:00;49;202;219;421
2019;November;47;2019-11-19 00:00;50;195;197;392
2019;November;47;2019-11-19 00:00;51;207;221;428
2019;November;47;2019-11-19 00:00;52;240;231;471
2019;November;47;2019-11-19 00:00;53;186;213;399
2019;November;47;2019-11-19 00:00;54;199;215;414
2019;November;47;2019-11-19 00:00;55;187;217;404
2019;November;47;2019-11-19 00:00;56;175;217;392
2019;November;47;2019-11-19 00:00;57;182;181;363
2019;November;47;2019-11-19 00:00;58;151;169;320
2019;November;47;2019-11-19 00:00;59;155;152;307
2019;November;47;2019-11-19 00:00;60;152;157;309
2019;November;47;2019-11-19 00:00;61;145;152;297
2019;November;47;2019-11-19 00:00;62;138;152;290
2019;November;47;2019-11-19 00:00;63;148;158;306
2019;November;47;2019-11-19 00:00;64;132;115;247
2019;November;47;2019-11-19 00:00;65;130;138;268
2019;November;47;2019-11-19 00:00;66;145;132;277
2019;November;47;2019-11-19 00:00;67;136;148;284
2019;November;47;2019-11-19 00:00;68;140;130;270
2019;November;47;2019-11-19 00:00;69;136;153;289
2019;November;47;2019-11-19 00:00;70;147;155;302
2019;November;47;2019-11-19 00:00;71;171;161;332
2019;November;47;2019-11-19 00:00;72;154;146;300
2019;November;47;2019-11-19 00:00;73;180;146;326
2019;November;47;2019-11-19 00:00;74;176;168;344
2019;November;47;2019-11-19 00:00;75;148;151;299
2019;November;47;2019-11-19 00:00;76;149;155;304
2019;November;47;2019-11-19 00:00;77;133;123;256
2019;November;47;2019-11-19 00:00;78;104;97;201
2019;November;47;2019-11-19 00:00;79;83;117;200
2019;November;47;2019-11-19 00:00;80;84;83;167
2019;November;47;2019-11-19 00:00;81;89;76;165
2019;November;47;2019-11-19 00:00;82;72;66;138
2019;November;47;2019-11-19 00:00;83;85;53;138
2019;November;47;2019-11-19 00:00;84;54;57;111
2019;November;47;2019-11-19 00:00;85;56;41;97
2019;November;47;2019-11-19 00:00;86;50;38;88
2019;November;47;2019-11-19 00:00;87;29;32;61
2019;November;47;2019-11-19 00:00;88;35;22;57
2019;November;47;2019-11-19 00:00;89;34;19;53
2019;November;47;2019-11-19 00:00;90;31;20;51
2019;November;47;2019-11-19 00:00;91;21;12;33
2019;November;47;2019-11-19 00:00;92;25;8;33
2019;November;47;2019-11-19 00:00;93;15;7;22
2019;November;47;2019-11-19 00:00;94;16;5;21
2019;November;47;2019-11-19 00:00;95;7;2;9
2019;November;47;2019-11-19 00:00;96;4;4;8
2019;November;47;2019-11-19 00:00;97;8;1;9
2019;November;47;2019-11-19 00:00;98;1;2;3
2019;November;47;2019-11-19 00:00;99;1;2;3
2019;November;47;2019-11-19 00:00;100;0;1;1
2019;November;47;2019-11-19 00:00;107;1;0;1
2019;November;48;2019-11-26 00:00;0;156;166;322
2019;November;48;2019-11-26 00:00;1;210;223;433
2019;November;48;2019-11-26 00:00;2;213;215;428
2019;November;48;2019-11-26 00:00;3;201;225;426
2019;November;48;2019-11-26 00:00;4;208;224;432
2019;November;48;2019-11-26 00:00;5;192;251;443
2019;November;48;2019-11-26 00:00;6;220;237;457
2019;November;48;2019-11-26 00:00;7;199;208;407
2019;November;48;2019-11-26 00:00;8;219;236;455
2019;November;48;2019-11-26 00:00;9;232;241;473
2019;November;48;2019-11-26 00:00;10;212;229;441
2019;November;48;2019-11-26 00:00;11;206;209;415
2019;November;48;2019-11-26 00:00;12;193;211;404
2019;November;48;2019-11-26 00:00;13;227;208;435
2019;November;48;2019-11-26 00:00;14;196;219;415
2019;November;48;2019-11-26 00:00;15;189;205;394
2019;November;48;2019-11-26 00:00;16;179;191;370
2019;November;48;2019-11-26 00:00;17;185;225;410
2019;November;48;2019-11-26 00:00;18;142;182;324
2019;November;48;2019-11-26 00:00;19;172;197;369
2019;November;48;2019-11-26 00:00;20;164;203;367
2019;November;48;2019-11-26 00:00;21;134;173;307
2019;November;48;2019-11-26 00:00;22;138;178;316
2019;November;48;2019-11-26 00:00;23;142;173;315
2019;November;48;2019-11-26 00:00;24;158;181;339
2019;November;48;2019-11-26 00:00;25;176;174;350
2019;November;48;2019-11-26 00:00;26;165;200;365
2019;November;48;2019-11-26 00:00;27;193;181;374
2019;November;48;2019-11-26 00:00;28;188;240;428
2019;November;48;2019-11-26 00:00;29;224;221;445
2019;November;48;2019-11-26 00:00;30;190;214;404
2019;November;48;2019-11-26 00:00;31;202;198;400
2019;November;48;2019-11-26 00:00;32;222;211;433
2019;November;48;2019-11-26 00:00;33;196;205;401
2019;November;48;2019-11-26 00:00;34;212;220;432
2019;November;48;2019-11-26 00:00;35;206;211;417
2019;November;48;2019-11-26 00:00;36;221;194;415
2019;November;48;2019-11-26 00:00;37;219;215;434
2019;November;48;2019-11-26 00:00;38;184;203;387
2019;November;48;2019-11-26 00:00;39;240;215;455
2019;November;48;2019-11-26 00:00;40;212;182;394
2019;November;48;2019-11-26 00:00;41;202;212;414
2019;November;48;2019-11-26 00:00;42;203;220;423
2019;November;48;2019-11-26 00:00;43;226;222;448
2019;November;48;2019-11-26 00:00;44;228;241;469
2019;November;48;2019-11-26 00:00;45;231;286;517
2019;November;48;2019-11-26 00:00;46;213;223;436
2019;November;48;2019-11-26 00:00;47;223;256;479
2019;November;48;2019-11-26 00:00;48;215;224;439
2019;November;48;2019-11-26 00:00;49;202;219;421
2019;November;48;2019-11-26 00:00;50;195;197;392
2019;November;48;2019-11-26 00:00;51;207;221;428
2019;November;48;2019-11-26 00:00;52;240;231;471
2019;November;48;2019-11-26 00:00;53;186;213;399
2019;November;48;2019-11-26 00:00;54;199;215;414
2019;November;48;2019-11-26 00:00;55;187;217;404
2019;November;48;2019-11-26 00:00;56;175;217;392
2019;November;48;2019-11-26 00:00;57;182;181;363
2019;November;48;2019-11-26 00:00;58;151;169;320
2019;November;48;2019-11-26 00:00;59;155;152;307
2019;November;48;2019-11-26 00:00;60;152;157;309
2019;November;48;2019-11-26 00:00;61;145;152;297
2019;November;48;2019-11-26 00:00;62;138;152;290
2019;November;48;2019-11-26 00:00;63;148;158;306
2019;November;48;2019-11-26 00:00;64;132;115;247
2019;November;48;2019-11-26 00:00;65;130;138;268
2019;November;48;2019-11-26 00:00;66;145;132;277
2019;November;48;2019-11-26 00:00;67;136;148;284
2019;November;48;2019-11-26 00:00;68;140;130;270
2019;November;48;2019-11-26 00:00;69;136;153;289
2019;November;48;2019-11-26 00:00;70;147;155;302
2019;November;48;2019-11-26 00:00;71;171;161;332
2019;November;48;2019-11-26 00:00;72;154;146;300
2019;November;48;2019-11-26 00:00;73;180;146;326
2019;November;48;2019-11-26 00:00;74;176;168;344
2019;November;48;2019-11-26 00:00;75;148;151;299
2019;November;48;2019-11-26 00:00;76;149;155;304
2019;November;48;2019-11-26 00:00;77;133;123;256
2019;November;48;2019-11-26 00:00;78;104;97;201
2019;November;48;2019-11-26 00:00;79;83;117;200
2019;November;48;2019-11-26 00:00;80;84;83;167
2019;November;48;2019-11-26 00:00;81;89;76;165
2019;November;48;2019-11-26 00:00;82;72;66;138
2019;November;48;2019-11-26 00:00;83;85;53;138
2019;November;48;2019-11-26 00:00;84;54;57;111
2019;November;48;2019-11-26 00:00;85;56;41;97
2019;November;48;2019-11-26 00:00;86;50;38;88
2019;November;48;2019-11-26 00:00;87;29;32;61
2019;November;48;2019-11-26 00:00;88;35;22;57
2019;November;48;2019-11-26 00:00;89;34;19;53
2019;November;48;2019-11-26 00:00;90;31;20;51
2019;November;48;2019-11-26 00:00;91;21;12;33
2019;November;48;2019-11-26 00:00;92;25;8;33
2019;November;48;2019-11-26 00:00;93;15;7;22
2019;November;48;2019-11-26 00:00;94;16;5;21
2019;November;48;2019-11-26 00:00;95;7;2;9
2019;November;48;2019-11-26 00:00;96;4;4;8
2019;November;48;2019-11-26 00:00;97;8;1;9
2019;November;48;2019-11-26 00:00;98;1;2;3
2019;November;48;2019-11-26 00:00;99;1;2;3
2019;November;48;2019-11-26 00:00;100;0;1;1
2019;November;48;2019-11-26 00:00;107;1;0;1
2019;December;49;2019-12-03 00:00;0;161;179;340
2019;December;49;2019-12-03 00:00;1;211;226;437
2019;December;49;2019-12-03 00:00;2;214;217;431
2019;December;49;2019-12-03 00:00;3;201;226;427
2019;December;49;2019-12-03 00:00;4;209;224;433
2019;December;49;2019-12-03 00:00;5;193;251;444
2019;December;49;2019-12-03 00:00;6;220;237;457
2019;December;49;2019-12-03 00:00;7;200;208;408
2019;December;49;2019-12-03 00:00;8;219;237;456
2019;December;49;2019-12-03 00:00;9;232;241;473
2019;December;49;2019-12-03 00:00;10;213;229;442
2019;December;49;2019-12-03 00:00;11;206;208;414
2019;December;49;2019-12-03 00:00;12;193;210;403
2019;December;49;2019-12-03 00:00;13;227;208;435
2019;December;49;2019-12-03 00:00;14;196;219;415
2019;December;49;2019-12-03 00:00;15;189;205;394
2019;December;49;2019-12-03 00:00;16;179;192;371
2019;December;49;2019-12-03 00:00;17;184;225;409
2019;December;49;2019-12-03 00:00;18;142;182;324
2019;December;49;2019-12-03 00:00;19;172;198;370
2019;December;49;2019-12-03 00:00;20;164;205;369
2019;December;49;2019-12-03 00:00;21;134;173;307
2019;December;49;2019-12-03 00:00;22;139;176;315
2019;December;49;2019-12-03 00:00;23;144;171;315
2019;December;49;2019-12-03 00:00;24;159;180;339
2019;December;49;2019-12-03 00:00;25;177;175;352
2019;December;49;2019-12-03 00:00;26;167;202;369
2019;December;49;2019-12-03 00:00;27;196;181;377
2019;December;49;2019-12-03 00:00;28;183;241;424
2019;December;49;2019-12-03 00:00;29;223;222;445
2019;December;49;2019-12-03 00:00;30;190;213;403
2019;December;49;2019-12-03 00:00;31;206;196;402
2019;December;49;2019-12-03 00:00;32;224;211;435
2019;December;49;2019-12-03 00:00;33;197;204;401
2019;December;49;2019-12-03 00:00;34;213;223;436
2019;December;49;2019-12-03 00:00;35;206;211;417
2019;December;49;2019-12-03 00:00;36;222;193;415
2019;December;49;2019-12-03 00:00;37;218;215;433
2019;December;49;2019-12-03 00:00;38;184;204;388
2019;December;49;2019-12-03 00:00;39;239;214;453
2019;December;49;2019-12-03 00:00;40;212;182;394
2019;December;49;2019-12-03 00:00;41;203;212;415
2019;December;49;2019-12-03 00:00;42;203;221;424
2019;December;49;2019-12-03 00:00;43;226;222;448
2019;December;49;2019-12-03 00:00;44;229;241;470
2019;December;49;2019-12-03 00:00;45;229;285;514
2019;December;49;2019-12-03 00:00;46;213;223;436
2019;December;49;2019-12-03 00:00;47;223;256;479
2019;December;49;2019-12-03 00:00;48;215;225;440
2019;December;49;2019-12-03 00:00;49;202;219;421
2019;December;49;2019-12-03 00:00;50;195;199;394
2019;December;49;2019-12-03 00:00;51;207;220;427
2019;December;49;2019-12-03 00:00;52;240;232;472
2019;December;49;2019-12-03 00:00;53;186;213;399
2019;December;49;2019-12-03 00:00;54;198;214;412
2019;December;49;2019-12-03 00:00;55;188;218;406
2019;December;49;2019-12-03 00:00;56;176;216;392
2019;December;49;2019-12-03 00:00;57;182;181;363
2019;December;49;2019-12-03 00:00;58;151;168;319
2019;December;49;2019-12-03 00:00;59;155;150;305
2019;December;49;2019-12-03 00:00;60;151;157;308
2019;December;49;2019-12-03 00:00;61;146;152;298
2019;December;49;2019-12-03 00:00;62;137;151;288
2019;December;49;2019-12-03 00:00;63;148;158;306
2019;December;49;2019-12-03 00:00;64;133;115;248
2019;December;49;2019-12-03 00:00;65;128;140;268
2019;December;49;2019-12-03 00:00;66;145;132;277
2019;December;49;2019-12-03 00:00;67;136;148;284
2019;December;49;2019-12-03 00:00;68;140;130;270
2019;December;49;2019-12-03 00:00;69;136;152;288
2019;December;49;2019-12-03 00:00;70;147;155;302
2019;December;49;2019-12-03 00:00;71;171;160;331
2019;December;49;2019-12-03 00:00;72;154;146;300
2019;December;49;2019-12-03 00:00;73;180;146;326
2019;December;49;2019-12-03 00:00;74;176;168;344
2019;December;49;2019-12-03 00:00;75;148;151;299
2019;December;49;2019-12-03 00:00;76;148;155;303
2019;December;49;2019-12-03 00:00;77;133;123;256
2019;December;49;2019-12-03 00:00;78;104;97;201
2019;December;49;2019-12-03 00:00;79;83;117;200
2019;December;49;2019-12-03 00:00;80;84;83;167
2019;December;49;2019-12-03 00:00;81;87;76;163
2019;December;49;2019-12-03 00:00;82;71;66;137
2019;December;49;2019-12-03 00:00;83;85;53;138
2019;December;49;2019-12-03 00:00;84;54;57;111
2019;December;49;2019-12-03 00:00;85;56;41;97
2019;December;49;2019-12-03 00:00;86;50;38;88
2019;December;49;2019-12-03 00:00;87;28;32;60
2019;December;49;2019-12-03 00:00;88;34;22;56
2019;December;49;2019-12-03 00:00;89;34;19;53
2019;December;49;2019-12-03 00:00;90;31;20;51
2019;December;49;2019-12-03 00:00;91;21;12;33
2019;December;49;2019-12-03 00:00;92;24;8;32
2019;December;49;2019-12-03 00:00;93;15;7;22
2019;December;49;2019-12-03 00:00;94;16;5;21
2019;December;49;2019-12-03 00:00;95;7;2;9
2019;December;49;2019-12-03 00:00;96;4;4;8
2019;December;49;2019-12-03 00:00;97;7;1;8
2019;December;49;2019-12-03 00:00;98;1;2;3
2019;December;49;2019-12-03 00:00;99;1;2;3
2019;December;49;2019-12-03 00:00;100;0;1;1
2019;December;49;2019-12-03 00:00;107;1;0;1
2019;December;50;2019-12-10 00:00;0;163;183;346
2019;December;50;2019-12-10 00:00;1;210;226;436
2019;December;50;2019-12-10 00:00;2;216;217;433
2019;December;50;2019-12-10 00:00;3;202;226;428
2019;December;50;2019-12-10 00:00;4;210;224;434
2019;December;50;2019-12-10 00:00;5;194;250;444
2019;December;50;2019-12-10 00:00;6;219;237;456
2019;December;50;2019-12-10 00:00;7;201;208;409
2019;December;50;2019-12-10 00:00;8;219;237;456
2019;December;50;2019-12-10 00:00;9;232;241;473
2019;December;50;2019-12-10 00:00;10;213;229;442
2019;December;50;2019-12-10 00:00;11;205;208;413
2019;December;50;2019-12-10 00:00;12;193;210;403
2019;December;50;2019-12-10 00:00;13;227;208;435
2019;December;50;2019-12-10 00:00;14;196;220;416
2019;December;50;2019-12-10 00:00;15;189;205;394
2019;December;50;2019-12-10 00:00;16;179;193;372
2019;December;50;2019-12-10 00:00;17;183;225;408
2019;December;50;2019-12-10 00:00;18;142;182;324
2019;December;50;2019-12-10 00:00;19;172;198;370
2019;December;50;2019-12-10 00:00;20;166;204;370
2019;December;50;2019-12-10 00:00;21;134;173;307
2019;December;50;2019-12-10 00:00;22;139;175;314
2019;December;50;2019-12-10 00:00;23;144;170;314
2019;December;50;2019-12-10 00:00;24;159;180;339
2019;December;50;2019-12-10 00:00;25;176;175;351
2019;December;50;2019-12-10 00:00;26;168;201;369
2019;December;50;2019-12-10 00:00;27;194;179;373
2019;December;50;2019-12-10 00:00;28;183;243;426
2019;December;50;2019-12-10 00:00;29;224;222;446
2019;December;50;2019-12-10 00:00;30;190;212;402
2019;December;50;2019-12-10 00:00;31;206;197;403
2019;December;50;2019-12-10 00:00;32;224;212;436
2019;December;50;2019-12-10 00:00;33;197;203;400
2019;December;50;2019-12-10 00:00;34;212;223;435
2019;December;50;2019-12-10 00:00;35;206;212;418
2019;December;50;2019-12-10 00:00;36;220;193;413
2019;December;50;2019-12-10 00:00;37;218;215;433
2019;December;50;2019-12-10 00:00;38;185;204;389
2019;December;50;2019-12-10 00:00;39;239;214;453
2019;December;50;2019-12-10 00:00;40;212;181;393
2019;December;50;2019-12-10 00:00;41;203;212;415
2019;December;50;2019-12-10 00:00;42;204;221;425
2019;December;50;2019-12-10 00:00;43;226;223;449
2019;December;50;2019-12-10 00:00;44;230;242;472
2019;December;50;2019-12-10 00:00;45;229;287;516
2019;December;50;2019-12-10 00:00;46;214;223;437
2019;December;50;2019-12-10 00:00;47;222;256;478
2019;December;50;2019-12-10 00:00;48;215;224;439
2019;December;50;2019-12-10 00:00;49;202;218;420
2019;December;50;2019-12-10 00:00;50;195;199;394
2019;December;50;2019-12-10 00:00;51;207;220;427
2019;December;50;2019-12-10 00:00;52;240;232;472
2019;December;50;2019-12-10 00:00;53;186;213;399
2019;December;50;2019-12-10 00:00;54;197;214;411
2019;December;50;2019-12-10 00:00;55;188;218;406
2019;December;50;2019-12-10 00:00;56;176;216;392
2019;December;50;2019-12-10 00:00;57;183;181;364
2019;December;50;2019-12-10 00:00;58;151;168;319
2019;December;50;2019-12-10 00:00;59;155;150;305
2019;December;50;2019-12-10 00:00;60;151;157;308
2019;December;50;2019-12-10 00:00;61;146;151;297
2019;December;50;2019-12-10 00:00;62;137;151;288
2019;December;50;2019-12-10 00:00;63;148;158;306
2019;December;50;2019-12-10 00:00;64;133;115;248
2019;December;50;2019-12-10 00:00;65;128;140;268
2019;December;50;2019-12-10 00:00;66;145;132;277
2019;December;50;2019-12-10 00:00;67;136;148;284
2019;December;50;2019-12-10 00:00;68;139;130;269
2019;December;50;2019-12-10 00:00;69;136;152;288
2019;December;50;2019-12-10 00:00;70;147;155;302
2019;December;50;2019-12-10 00:00;71;171;160;331
2019;December;50;2019-12-10 00:00;72;154;146;300
2019;December;50;2019-12-10 00:00;73;179;145;324
2019;December;50;2019-12-10 00:00;74;176;168;344
2019;December;50;2019-12-10 00:00;75;148;151;299
2019;December;50;2019-12-10 00:00;76;148;155;303
2019;December;50;2019-12-10 00:00;77;133;123;256
2019;December;50;2019-12-10 00:00;78;104;97;201
2019;December;50;2019-12-10 00:00;79;83;117;200
2019;December;50;2019-12-10 00:00;80;85;83;168
2019;December;50;2019-12-10 00:00;81;87;75;162
2019;December;50;2019-12-10 00:00;82;71;66;137
2019;December;50;2019-12-10 00:00;83;85;53;138
2019;December;50;2019-12-10 00:00;84;54;57;111
2019;December;50;2019-12-10 00:00;85;56;41;97
2019;December;50;2019-12-10 00:00;86;50;38;88
2019;December;50;2019-12-10 00:00;87;28;32;60
2019;December;50;2019-12-10 00:00;88;33;22;55
2019;December;50;2019-12-10 00:00;89;34;19;53
2019;December;50;2019-12-10 00:00;90;31;20;51
2019;December;50;2019-12-10 00:00;91;21;12;33
2019;December;50;2019-12-10 00:00;92;24;8;32
2019;December;50;2019-12-10 00:00;93;15;7;22
2019;December;50;2019-12-10 00:00;94;16;5;21
2019;December;50;2019-12-10 00:00;95;7;2;9
2019;December;50;2019-12-10 00:00;96;4;4;8
2019;December;50;2019-12-10 00:00;97;7;1;8
2019;December;50;2019-12-10 00:00;98;1;2;3
2019;December;50;2019-12-10 00:00;99;1;2;3
2019;December;50;2019-12-10 00:00;100;0;1;1
2019;December;50;2019-12-10 00:00;107;1;0;1
2019;December;51;2019-12-17 00:00;0;170;185;355
2019;December;51;2019-12-17 00:00;1;211;226;437
2019;December;51;2019-12-17 00:00;2;216;217;433
2019;December;51;2019-12-17 00:00;3;203;228;431
2019;December;51;2019-12-17 00:00;4;211;226;437
2019;December;51;2019-12-17 00:00;5;194;250;444
2019;December;51;2019-12-17 00:00;6;219;237;456
2019;December;51;2019-12-17 00:00;7;201;208;409
2019;December;51;2019-12-17 00:00;8;219;237;456
2019;December;51;2019-12-17 00:00;9;232;241;473
2019;December;51;2019-12-17 00:00;10;213;229;442
2019;December;51;2019-12-17 00:00;11;205;207;412
2019;December;51;2019-12-17 00:00;12;193;210;403
2019;December;51;2019-12-17 00:00;13;226;208;434
2019;December;51;2019-12-17 00:00;14;195;220;415
2019;December;51;2019-12-17 00:00;15;190;205;395
2019;December;51;2019-12-17 00:00;16;179;193;372
2019;December;51;2019-12-17 00:00;17;183;225;408
2019;December;51;2019-12-17 00:00;18;141;182;323
2019;December;51;2019-12-17 00:00;19;172;198;370
2019;December;51;2019-12-17 00:00;20;166;203;369
2019;December;51;2019-12-17 00:00;21;133;174;307
2019;December;51;2019-12-17 00:00;22;138;173;311
2019;December;51;2019-12-17 00:00;23;145;170;315
2019;December;51;2019-12-17 00:00;24;158;179;337
2019;December;51;2019-12-17 00:00;25;176;177;353
2019;December;51;2019-12-17 00:00;26;167;201;368
2019;December;51;2019-12-17 00:00;27;196;179;375
2019;December;51;2019-12-17 00:00;28;184;245;429
2019;December;51;2019-12-17 00:00;29;224;223;447
2019;December;51;2019-12-17 00:00;30;190;213;403
2019;December;51;2019-12-17 00:00;31;206;198;404
2019;December;51;2019-12-17 00:00;32;224;212;436
2019;December;51;2019-12-17 00:00;33;197;203;400
2019;December;51;2019-12-17 00:00;34;212;224;436
2019;December;51;2019-12-17 00:00;35;206;212;418
2019;December;51;2019-12-17 00:00;36;221;193;414
2019;December;51;2019-12-17 00:00;37;218;215;433
2019;December;51;2019-12-17 00:00;38;185;204;389
2019;December;51;2019-12-17 00:00;39;239;214;453
2019;December;51;2019-12-17 00:00;40;213;181;394
2019;December;51;2019-12-17 00:00;41;203;212;415
2019;December;51;2019-12-17 00:00;42;204;221;425
2019;December;51;2019-12-17 00:00;43;225;221;446
2019;December;51;2019-12-17 00:00;44;230;243;473
2019;December;51;2019-12-17 00:00;45;229;287;516
2019;December;51;2019-12-17 00:00;46;214;223;437
2019;December;51;2019-12-17 00:00;47;222;256;478
2019;December;51;2019-12-17 00:00;48;215;224;439
2019;December;51;2019-12-17 00:00;49;202;218;420
2019;December;51;2019-12-17 00:00;50;195;199;394
2019;December;51;2019-12-17 00:00;51;208;221;429
2019;December;51;2019-12-17 00:00;52;240;232;472
2019;December;51;2019-12-17 00:00;53;186;213;399
2019;December;51;2019-12-17 00:00;54;197;214;411
2019;December;51;2019-12-17 00:00;55;188;218;406
2019;December;51;2019-12-17 00:00;56;176;216;392
2019;December;51;2019-12-17 00:00;57;183;181;364
2019;December;51;2019-12-17 00:00;58;151;168;319
2019;December;51;2019-12-17 00:00;59;155;149;304
2019;December;51;2019-12-17 00:00;60;151;157;308
2019;December;51;2019-12-17 00:00;61;146;151;297
2019;December;51;2019-12-17 00:00;62;137;151;288
2019;December;51;2019-12-17 00:00;63;148;158;306
2019;December;51;2019-12-17 00:00;64;133;115;248
2019;December;51;2019-12-17 00:00;65;128;140;268
2019;December;51;2019-12-17 00:00;66;145;133;278
2019;December;51;2019-12-17 00:00;67;136;148;284
2019;December;51;2019-12-17 00:00;68;139;130;269
2019;December;51;2019-12-17 00:00;69;136;152;288
2019;December;51;2019-12-17 00:00;70;147;155;302
2019;December;51;2019-12-17 00:00;71;171;160;331
2019;December;51;2019-12-17 00:00;72;154;146;300
2019;December;51;2019-12-17 00:00;73;179;145;324
2019;December;51;2019-12-17 00:00;74;176;168;344
2019;December;51;2019-12-17 00:00;75;148;151;299
2019;December;51;2019-12-17 00:00;76;148;155;303
2019;December;51;2019-12-17 00:00;77;133;123;256
2019;December;51;2019-12-17 00:00;78;104;97;201
2019;December;51;2019-12-17 00:00;79;83;117;200
2019;December;51;2019-12-17 00:00;80;85;83;168
2019;December;51;2019-12-17 00:00;81;87;75;162
2019;December;51;2019-12-17 00:00;82;71;66;137
2019;December;51;2019-12-17 00:00;83;85;53;138
2019;December;51;2019-12-17 00:00;84;54;57;111
2019;December;51;2019-12-17 00:00;85;55;41;96
2019;December;51;2019-12-17 00:00;86;50;38;88
2019;December;51;2019-12-17 00:00;87;28;32;60
2019;December;51;2019-12-17 00:00;88;33;22;55
2019;December;51;2019-12-17 00:00;89;34;19;53
2019;December;51;2019-12-17 00:00;90;31;20;51
2019;December;51;2019-12-17 00:00;91;21;12;33
2019;December;51;2019-12-17 00:00;92;24;8;32
2019;December;51;2019-12-17 00:00;93;15;7;22
2019;December;51;2019-12-17 00:00;94;16;5;21
2019;December;51;2019-12-17 00:00;95;7;2;9
2019;December;51;2019-12-17 00:00;96;4;4;8
2019;December;51;2019-12-17 00:00;97;7;1;8
2019;December;51;2019-12-17 00:00;98;1;2;3
2019;December;51;2019-12-17 00:00;99;1;2;3
2019;December;51;2019-12-17 00:00;100;0;1;1
2019;December;51;2019-12-17 00:00;107;1;0;1
2020;January;2;2020-01-08 00:00;0;4;2;6
2020;January;2;2020-01-08 00:00;1;177;191;368
2020;January;2;2020-01-08 00:00;2;212;226;438
2020;January;2;2020-01-08 00:00;3;216;215;431
2020;January;2;2020-01-08 00:00;4;203;228;431
2020;January;2;2020-01-08 00:00;5;211;225;436
2020;January;2;2020-01-08 00:00;6;194;249;443
2020;January;2;2020-01-08 00:00;7;218;237;455
2020;January;2;2020-01-08 00:00;8;202;208;410
2020;January;2;2020-01-08 00:00;9;219;237;456
2020;January;2;2020-01-08 00:00;10;233;242;475
2020;January;2;2020-01-08 00:00;11;213;231;444
2020;January;2;2020-01-08 00:00;12;205;207;412
2020;January;2;2020-01-08 00:00;13;194;211;405
2020;January;2;2020-01-08 00:00;14;227;208;435
2020;January;2;2020-01-08 00:00;15;195;221;416
2020;January;2;2020-01-08 00:00;16;190;206;396
2020;January;2;2020-01-08 00:00;17;179;193;372
2020;January;2;2020-01-08 00:00;18;184;225;409
2020;January;2;2020-01-08 00:00;19;141;181;322
2020;January;2;2020-01-08 00:00;20;172;198;370
2020;January;2;2020-01-08 00:00;21;165;202;367
2020;January;2;2020-01-08 00:00;22;133;173;306
2020;January;2;2020-01-08 00:00;23;137;171;308
2020;January;2;2020-01-08 00:00;24;141;170;311
2020;January;2;2020-01-08 00:00;25;156;180;336
2020;January;2;2020-01-08 00:00;26;179;179;358
2020;January;2;2020-01-08 00:00;27;168;201;369
2020;January;2;2020-01-08 00:00;28;196;181;377
2020;January;2;2020-01-08 00:00;29;185;241;426
2020;January;2;2020-01-08 00:00;30;226;223;449
2020;January;2;2020-01-08 00:00;31;191;216;407
2020;January;2;2020-01-08 00:00;32;206;199;405
2020;January;2;2020-01-08 00:00;33;223;216;439
2020;January;2;2020-01-08 00:00;34;198;204;402
2020;January;2;2020-01-08 00:00;35;212;224;436
2020;January;2;2020-01-08 00:00;36;206;213;419
2020;January;2;2020-01-08 00:00;37;224;194;418
2020;January;2;2020-01-08 00:00;38;217;217;434
2020;January;2;2020-01-08 00:00;39;185;204;389
2020;January;2;2020-01-08 00:00;40;240;214;454
2020;January;2;2020-01-08 00:00;41;213;182;395
2020;January;2;2020-01-08 00:00;42;203;211;414
2020;January;2;2020-01-08 00:00;43;204;220;424
2020;January;2;2020-01-08 00:00;44;225;222;447
2020;January;2;2020-01-08 00:00;45;229;242;471
2020;January;2;2020-01-08 00:00;46;229;288;517
2020;January;2;2020-01-08 00:00;47;214;224;438
2020;January;2;2020-01-08 00:00;48;224;256;480
2020;January;2;2020-01-08 00:00;49;216;224;440
2020;January;2;2020-01-08 00:00;50;201;217;418
2020;January;2;2020-01-08 00:00;51;195;199;394
2020;January;2;2020-01-08 00:00;52;208;221;429
2020;January;2;2020-01-08 00:00;53;240;233;473
2020;January;2;2020-01-08 00:00;54;185;214;399
2020;January;2;2020-01-08 00:00;55;196;214;410
2020;January;2;2020-01-08 00:00;56;186;218;404
2020;January;2;2020-01-08 00:00;57;175;217;392
2020;January;2;2020-01-08 00:00;58;183;180;363
2020;January;2;2020-01-08 00:00;59;151;168;319
2020;January;2;2020-01-08 00:00;60;155;149;304
2020;January;2;2020-01-08 00:00;61;151;156;307
2020;January;2;2020-01-08 00:00;62;146;151;297
2020;January;2;2020-01-08 00:00;63;137;150;287
2020;January;2;2020-01-08 00:00;64;148;158;306
2020;January;2;2020-01-08 00:00;65;132;115;247
2020;January;2;2020-01-08 00:00;66;128;140;268
2020;January;2;2020-01-08 00:00;67;145;133;278
2020;January;2;2020-01-08 00:00;68;136;148;284
2020;January;2;2020-01-08 00:00;69;139;130;269
2020;January;2;2020-01-08 00:00;70;136;152;288
2020;January;2;2020-01-08 00:00;71;147;154;301
2020;January;2;2020-01-08 00:00;72;171;160;331
2020;January;2;2020-01-08 00:00;73;154;146;300
2020;January;2;2020-01-08 00:00;74;178;144;322
2020;January;2;2020-01-08 00:00;75;175;168;343
2020;January;2;2020-01-08 00:00;76;149;151;300
2020;January;2;2020-01-08 00:00;77;148;153;301
2020;January;2;2020-01-08 00:00;78;133;123;256
2020;January;2;2020-01-08 00:00;79;104;96;200
2020;January;2;2020-01-08 00:00;80;83;117;200
2020;January;2;2020-01-08 00:00;81;85;83;168
2020;January;2;2020-01-08 00:00;82;86;76;162
2020;January;2;2020-01-08 00:00;83;70;66;136
2020;January;2;2020-01-08 00:00;84;85;53;138
2020;January;2;2020-01-08 00:00;85;54;56;110
2020;January;2;2020-01-08 00:00;86;55;41;96
2020;January;2;2020-01-08 00:00;87;49;38;87
2020;January;2;2020-01-08 00:00;88;28;32;60
2020;January;2;2020-01-08 00:00;89;33;22;55
2020;January;2;2020-01-08 00:00;90;34;19;53
2020;January;2;2020-01-08 00:00;91;30;20;50
2020;January;2;2020-01-08 00:00;92;21;12;33
2020;January;2;2020-01-08 00:00;93;24;8;32
2020;January;2;2020-01-08 00:00;94;15;7;22
2020;January;2;2020-01-08 00:00;95;16;5;21
2020;January;2;2020-01-08 00:00;96;7;2;9
2020;January;2;2020-01-08 00:00;97;4;4;8
2020;January;2;2020-01-08 00:00;98;7;1;8
2020;January;2;2020-01-08 00:00;99;1;2;3
2020;January;2;2020-01-08 00:00;100;1;2;3
2020;January;2;2020-01-08 00:00;101;0;1;1
2020;January;2;2020-01-08 00:00;108;1;0;1
2020;January;3;2020-01-14 00:00;0;5;5;10
2020;January;3;2020-01-14 00:00;1;175;191;366
2020;January;3;2020-01-14 00:00;2;212;226;438
2020;January;3;2020-01-14 00:00;3;216;214;430
2020;January;3;2020-01-14 00:00;4;203;228;431
2020;January;3;2020-01-14 00:00;5;211;225;436
2020;January;3;2020-01-14 00:00;6;194;249;443
2020;January;3;2020-01-14 00:00;7;219;237;456
2020;January;3;2020-01-14 00:00;8;202;208;410
2020;January;3;2020-01-14 00:00;9;219;238;457
2020;January;3;2020-01-14 00:00;10;233;242;475
2020;January;3;2020-01-14 00:00;11;214;231;445
2020;January;3;2020-01-14 00:00;12;205;207;412
2020;January;3;2020-01-14 00:00;13;195;211;406
2020;January;3;2020-01-14 00:00;14;227;208;435
2020;January;3;2020-01-14 00:00;15;195;221;416
2020;January;3;2020-01-14 00:00;16;190;206;396
2020;January;3;2020-01-14 00:00;17;179;192;371
2020;January;3;2020-01-14 00:00;18;184;225;409
2020;January;3;2020-01-14 00:00;19;141;181;322
2020;January;3;2020-01-14 00:00;20;172;198;370
2020;January;3;2020-01-14 00:00;21;165;202;367
2020;January;3;2020-01-14 00:00;22;133;171;304
2020;January;3;2020-01-14 00:00;23;136;171;307
2020;January;3;2020-01-14 00:00;24;140;169;309
2020;January;3;2020-01-14 00:00;25;156;180;336
2020;January;3;2020-01-14 00:00;26;179;179;358
2020;January;3;2020-01-14 00:00;27;169;201;370
2020;January;3;2020-01-14 00:00;28;196;180;376
2020;January;3;2020-01-14 00:00;29;187;241;428
2020;January;3;2020-01-14 00:00;30;227;222;449
2020;January;3;2020-01-14 00:00;31;191;216;407
2020;January;3;2020-01-14 00:00;32;208;200;408
2020;January;3;2020-01-14 00:00;33;223;217;440
2020;January;3;2020-01-14 00:00;34;198;205;403
2020;January;3;2020-01-14 00:00;35;211;223;434
2020;January;3;2020-01-14 00:00;36;206;213;419
2020;January;3;2020-01-14 00:00;37;224;194;418
2020;January;3;2020-01-14 00:00;38;217;218;435
2020;January;3;2020-01-14 00:00;39;186;204;390
2020;January;3;2020-01-14 00:00;40;240;215;455
2020;January;3;2020-01-14 00:00;41;213;182;395
2020;January;3;2020-01-14 00:00;42;203;211;414
2020;January;3;2020-01-14 00:00;43;205;220;425
2020;January;3;2020-01-14 00:00;44;225;222;447
2020;January;3;2020-01-14 00:00;45;229;242;471
2020;January;3;2020-01-14 00:00;46;229;288;517
2020;January;3;2020-01-14 00:00;47;214;224;438
2020;January;3;2020-01-14 00:00;48;224;255;479
2020;January;3;2020-01-14 00:00;49;216;224;440
2020;January;3;2020-01-14 00:00;50;201;217;418
2020;January;3;2020-01-14 00:00;51;195;199;394
2020;January;3;2020-01-14 00:00;52;208;222;430
2020;January;3;2020-01-14 00:00;53;240;232;472
2020;January;3;2020-01-14 00:00;54;185;214;399
2020;January;3;2020-01-14 00:00;55;195;213;408
2020;January;3;2020-01-14 00:00;56;185;218;403
2020;January;3;2020-01-14 00:00;57;175;217;392
2020;January;3;2020-01-14 00:00;58;183;180;363
2020;January;3;2020-01-14 00:00;59;151;168;319
2020;January;3;2020-01-14 00:00;60;155;150;305
2020;January;3;2020-01-14 00:00;61;151;156;307
2020;January;3;2020-01-14 00:00;62;147;151;298
2020;January;3;2020-01-14 00:00;63;137;150;287
2020;January;3;2020-01-14 00:00;64;148;158;306
2020;January;3;2020-01-14 00:00;65;132;115;247
2020;January;3;2020-01-14 00:00;66;128;140;268
2020;January;3;2020-01-14 00:00;67;145;133;278
2020;January;3;2020-01-14 00:00;68;136;148;284
2020;January;3;2020-01-14 00:00;69;139;129;268
2020;January;3;2020-01-14 00:00;70;136;152;288
2020;January;3;2020-01-14 00:00;71;147;154;301
2020;January;3;2020-01-14 00:00;72;171;160;331
2020;January;3;2020-01-14 00:00;73;154;146;300
2020;January;3;2020-01-14 00:00;74;178;144;322
2020;January;3;2020-01-14 00:00;75;174;168;342
2020;January;3;2020-01-14 00:00;76;149;151;300
2020;January;3;2020-01-14 00:00;77;148;153;301
2020;January;3;2020-01-14 00:00;78;133;123;256
2020;January;3;2020-01-14 00:00;79;104;96;200
2020;January;3;2020-01-14 00:00;80;83;117;200
2020;January;3;2020-01-14 00:00;81;85;83;168
2020;January;3;2020-01-14 00:00;82;86;76;162
2020;January;3;2020-01-14 00:00;83;70;66;136
2020;January;3;2020-01-14 00:00;84;85;53;138
2020;January;3;2020-01-14 00:00;85;54;56;110
2020;January;3;2020-01-14 00:00;86;55;41;96
2020;January;3;2020-01-14 00:00;87;49;38;87
2020;January;3;2020-01-14 00:00;88;28;32;60
2020;January;3;2020-01-14 00:00;89;33;22;55
2020;January;3;2020-01-14 00:00;90;34;18;52
2020;January;3;2020-01-14 00:00;91;29;20;49
2020;January;3;2020-01-14 00:00;92;21;11;32
2020;January;3;2020-01-14 00:00;93;24;8;32
2020;January;3;2020-01-14 00:00;94;15;7;22
2020;January;3;2020-01-14 00:00;95;16;5;21
2020;January;3;2020-01-14 00:00;96;7;2;9
2020;January;3;2020-01-14 00:00;97;4;4;8
2020;January;3;2020-01-14 00:00;98;7;1;8
2020;January;3;2020-01-14 00:00;99;1;2;3
2020;January;3;2020-01-14 00:00;100;1;2;3
2020;January;3;2020-01-14 00:00;101;0;1;1
2020;January;3;2020-01-14 00:00;108;1;0;1
2020;January;4;2020-01-22 00:00;0;11;9;20
2020;January;4;2020-01-22 00:00;1;177;192;369
2020;January;4;2020-01-22 00:00;2;212;226;438
2020;January;4;2020-01-22 00:00;3;218;214;432
2020;January;4;2020-01-22 00:00;4;204;229;433
2020;January;4;2020-01-22 00:00;5;211;226;437
2020;January;4;2020-01-22 00:00;6;195;249;444
2020;January;4;2020-01-22 00:00;7;219;237;456
2020;January;4;2020-01-22 00:00;8;202;208;410
2020;January;4;2020-01-22 00:00;9;220;238;458
2020;January;4;2020-01-22 00:00;10;233;242;475
2020;January;4;2020-01-22 00:00;11;214;231;445
2020;January;4;2020-01-22 00:00;12;205;208;413
2020;January;4;2020-01-22 00:00;13;195;211;406
2020;January;4;2020-01-22 00:00;14;227;208;435
2020;January;4;2020-01-22 00:00;15;195;221;416
2020;January;4;2020-01-22 00:00;16;190;206;396
2020;January;4;2020-01-22 00:00;17;179;191;370
2020;January;4;2020-01-22 00:00;18;184;226;410
2020;January;4;2020-01-22 00:00;19;142;182;324
2020;January;4;2020-01-22 00:00;20;172;196;368
2020;January;4;2020-01-22 00:00;21;165;201;366
2020;January;4;2020-01-22 00:00;22;132;170;302
2020;January;4;2020-01-22 00:00;23;136;172;308
2020;January;4;2020-01-22 00:00;24;141;170;311
2020;January;4;2020-01-22 00:00;25;156;180;336
2020;January;4;2020-01-22 00:00;26;178;178;356
2020;January;4;2020-01-22 00:00;27;170;201;371
2020;January;4;2020-01-22 00:00;28;197;179;376
2020;January;4;2020-01-22 00:00;29;186;240;426
2020;January;4;2020-01-22 00:00;30;229;224;453
2020;January;4;2020-01-22 00:00;31;192;217;409
2020;January;4;2020-01-22 00:00;32;209;199;408
2020;January;4;2020-01-22 00:00;33;225;217;442
2020;January;4;2020-01-22 00:00;34;199;205;404
2020;January;4;2020-01-22 00:00;35;212;225;437
2020;January;4;2020-01-22 00:00;36;207;213;420
2020;January;4;2020-01-22 00:00;37;224;196;420
2020;January;4;2020-01-22 00:00;38;218;218;436
2020;January;4;2020-01-22 00:00;39;186;205;391
2020;January;4;2020-01-22 00:00;40;240;214;454
2020;January;4;2020-01-22 00:00;41;213;183;396
2020;January;4;2020-01-22 00:00;42;204;212;416
2020;January;4;2020-01-22 00:00;43;205;221;426
2020;January;4;2020-01-22 00:00;44;225;222;447
2020;January;4;2020-01-22 00:00;45;229;241;470
2020;January;4;2020-01-22 00:00;46;229;287;516
2020;January;4;2020-01-22 00:00;47;214;224;438
2020;January;4;2020-01-22 00:00;48;224;255;479
2020;January;4;2020-01-22 00:00;49;216;224;440
2020;January;4;2020-01-22 00:00;50;201;218;419
2020;January;4;2020-01-22 00:00;51;195;199;394
2020;January;4;2020-01-22 00:00;52;208;222;430
2020;January;4;2020-01-22 00:00;53;240;232;472
2020;January;4;2020-01-22 00:00;54;185;214;399
2020;January;4;2020-01-22 00:00;55;195;213;408
2020;January;4;2020-01-22 00:00;56;185;218;403
2020;January;4;2020-01-22 00:00;57;175;217;392
2020;January;4;2020-01-22 00:00;58;183;180;363
2020;January;4;2020-01-22 00:00;59;151;168;319
2020;January;4;2020-01-22 00:00;60;155;150;305
2020;January;4;2020-01-22 00:00;61;151;156;307
2020;January;4;2020-01-22 00:00;62;147;150;297
2020;January;4;2020-01-22 00:00;63;137;150;287
2020;January;4;2020-01-22 00:00;64;148;158;306
2020;January;4;2020-01-22 00:00;65;132;115;247
2020;January;4;2020-01-22 00:00;66;128;140;268
2020;January;4;2020-01-22 00:00;67;145;133;278
2020;January;4;2020-01-22 00:00;68;136;148;284
2020;January;4;2020-01-22 00:00;69;139;129;268
2020;January;4;2020-01-22 00:00;70;136;152;288
2020;January;4;2020-01-22 00:00;71;147;154;301
2020;January;4;2020-01-22 00:00;72;171;160;331
2020;January;4;2020-01-22 00:00;73;154;146;300
2020;January;4;2020-01-22 00:00;74;178;144;322
2020;January;4;2020-01-22 00:00;75;174;167;341
2020;January;4;2020-01-22 00:00;76;149;151;300
2020;January;4;2020-01-22 00:00;77;147;153;300
2020;January;4;2020-01-22 00:00;78;133;123;256
2020;January;4;2020-01-22 00:00;79;104;96;200
2020;January;4;2020-01-22 00:00;80;83;117;200
2020;January;4;2020-01-22 00:00;81;85;83;168
2020;January;4;2020-01-22 00:00;82;86;76;162
2020;January;4;2020-01-22 00:00;83;70;65;135
2020;January;4;2020-01-22 00:00;84;85;53;138
2020;January;4;2020-01-22 00:00;85;54;55;109
2020;January;4;2020-01-22 00:00;86;55;41;96
2020;January;4;2020-01-22 00:00;87;49;38;87
2020;January;4;2020-01-22 00:00;88;28;32;60
2020;January;4;2020-01-22 00:00;89;33;22;55
2020;January;4;2020-01-22 00:00;90;34;18;52
2020;January;4;2020-01-22 00:00;91;29;20;49
2020;January;4;2020-01-22 00:00;92;21;11;32
2020;January;4;2020-01-22 00:00;93;24;8;32
2020;January;4;2020-01-22 00:00;94;15;7;22
2020;January;4;2020-01-22 00:00;95;16;5;21
2020;January;4;2020-01-22 00:00;96;7;2;9
2020;January;4;2020-01-22 00:00;97;4;4;8
2020;January;4;2020-01-22 00:00;98;7;1;8
2020;January;4;2020-01-22 00:00;99;1;2;3
2020;January;4;2020-01-22 00:00;100;1;2;3
2020;January;4;2020-01-22 00:00;101;0;1;1
2020;January;4;2020-01-22 00:00;108;1;0;1
2020;January;5;2020-01-28 00:00;0;17;12;29
2020;January;5;2020-01-28 00:00;1;176;193;369
2020;January;5;2020-01-28 00:00;2;212;226;438
2020;January;5;2020-01-28 00:00;3;217;214;431
2020;January;5;2020-01-28 00:00;4;204;230;434
2020;January;5;2020-01-28 00:00;5;211;228;439
2020;January;5;2020-01-28 00:00;6;197;250;447
2020;January;5;2020-01-28 00:00;7;219;237;456
2020;January;5;2020-01-28 00:00;8;202;209;411
2020;January;5;2020-01-28 00:00;9;220;238;458
2020;January;5;2020-01-28 00:00;10;234;242;476
2020;January;5;2020-01-28 00:00;11;214;231;445
2020;January;5;2020-01-28 00:00;12;206;207;413
2020;January;5;2020-01-28 00:00;13;194;211;405
2020;January;5;2020-01-28 00:00;14;227;208;435
2020;January;5;2020-01-28 00:00;15;194;221;415
2020;January;5;2020-01-28 00:00;16;190;206;396
2020;January;5;2020-01-28 00:00;17;178;191;369
2020;January;5;2020-01-28 00:00;18;184;225;409
2020;January;5;2020-01-28 00:00;19;142;182;324
2020;January;5;2020-01-28 00:00;20;172;196;368
2020;January;5;2020-01-28 00:00;21;164;201;365
2020;January;5;2020-01-28 00:00;22;133;171;304
2020;January;5;2020-01-28 00:00;23;137;173;310
2020;January;5;2020-01-28 00:00;24;142;170;312
2020;January;5;2020-01-28 00:00;25;156;179;335
2020;January;5;2020-01-28 00:00;26;178;179;357
2020;January;5;2020-01-28 00:00;27;170;202;372
2020;January;5;2020-01-28 00:00;28;198;179;377
2020;January;5;2020-01-28 00:00;29;186;240;426
2020;January;5;2020-01-28 00:00;30;229;225;454
2020;January;5;2020-01-28 00:00;31;193;218;411
2020;January;5;2020-01-28 00:00;32;208;200;408
2020;January;5;2020-01-28 00:00;33;226;217;443
2020;January;5;2020-01-28 00:00;34;198;205;403
2020;January;5;2020-01-28 00:00;35;212;225;437
2020;January;5;2020-01-28 00:00;36;207;213;420
2020;January;5;2020-01-28 00:00;37;224;195;419
2020;January;5;2020-01-28 00:00;38;219;217;436
2020;January;5;2020-01-28 00:00;39;186;207;393
2020;January;5;2020-01-28 00:00;40;240;214;454
2020;January;5;2020-01-28 00:00;41;214;183;397
2020;January;5;2020-01-28 00:00;42;204;211;415
2020;January;5;2020-01-28 00:00;43;205;221;426
2020;January;5;2020-01-28 00:00;44;225;222;447
2020;January;5;2020-01-28 00:00;45;229;242;471
2020;January;5;2020-01-28 00:00;46;229;287;516
2020;January;5;2020-01-28 00:00;47;215;224;439
2020;January;5;2020-01-28 00:00;48;224;255;479
2020;January;5;2020-01-28 00:00;49;216;224;440
2020;January;5;2020-01-28 00:00;50;201;219;420
2020;January;5;2020-01-28 00:00;51;195;199;394
2020;January;5;2020-01-28 00:00;52;208;222;430
2020;January;5;2020-01-28 00:00;53;241;232;473
2020;January;5;2020-01-28 00:00;54;185;214;399
2020;January;5;2020-01-28 00:00;55;195;213;408
2020;January;5;2020-01-28 00:00;56;185;219;404
2020;January;5;2020-01-28 00:00;57;175;218;393
2020;January;5;2020-01-28 00:00;58;183;180;363
2020;January;5;2020-01-28 00:00;59;151;168;319
2020;January;5;2020-01-28 00:00;60;155;150;305
2020;January;5;2020-01-28 00:00;61;151;156;307
2020;January;5;2020-01-28 00:00;62;147;150;297
2020;January;5;2020-01-28 00:00;63;137;150;287
2020;January;5;2020-01-28 00:00;64;148;158;306
2020;January;5;2020-01-28 00:00;65;130;115;245
2020;January;5;2020-01-28 00:00;66;128;140;268
2020;January;5;2020-01-28 00:00;67;145;132;277
2020;January;5;2020-01-28 00:00;68;136;148;284
2020;January;5;2020-01-28 00:00;69;139;129;268
2020;January;5;2020-01-28 00:00;70;136;152;288
2020;January;5;2020-01-28 00:00;71;147;154;301
2020;January;5;2020-01-28 00:00;72;171;160;331
2020;January;5;2020-01-28 00:00;73;154;146;300
2020;January;5;2020-01-28 00:00;74;178;144;322
2020;January;5;2020-01-28 00:00;75;174;167;341
2020;January;5;2020-01-28 00:00;76;149;150;299
2020;January;5;2020-01-28 00:00;77;147;153;300
2020;January;5;2020-01-28 00:00;78;133;123;256
2020;January;5;2020-01-28 00:00;79;104;96;200
2020;January;5;2020-01-28 00:00;80;83;117;200
2020;January;5;2020-01-28 00:00;81;85;83;168
2020;January;5;2020-01-28 00:00;82;86;76;162
2020;January;5;2020-01-28 00:00;83;70;65;135
2020;January;5;2020-01-28 00:00;84;85;53;138
2020;January;5;2020-01-28 00:00;85;54;55;109
2020;January;5;2020-01-28 00:00;86;55;41;96
2020;January;5;2020-01-28 00:00;87;49;38;87
2020;January;5;2020-01-28 00:00;88;28;32;60
2020;January;5;2020-01-28 00:00;89;33;22;55
2020;January;5;2020-01-28 00:00;90;33;18;51
2020;January;5;2020-01-28 00:00;91;29;19;48
2020;January;5;2020-01-28 00:00;92;21;11;32
2020;January;5;2020-01-28 00:00;93;24;8;32
2020;January;5;2020-01-28 00:00;94;15;6;21
2020;January;5;2020-01-28 00:00;95;16;5;21
2020;January;5;2020-01-28 00:00;96;7;2;9
2020;January;5;2020-01-28 00:00;97;4;4;8
2020;January;5;2020-01-28 00:00;98;7;1;8
2020;January;5;2020-01-28 00:00;99;1;2;3
2020;January;5;2020-01-28 00:00;100;1;2;3
2020;January;5;2020-01-28 00:00;101;0;1;1
2020;January;5;2020-01-28 00:00;108;1;0;1
2020;February;6;2020-02-04 00:00;0;19;17;36
2020;February;6;2020-02-04 00:00;1;176;193;369
2020;February;6;2020-02-04 00:00;2;211;226;437
2020;February;6;2020-02-04 00:00;3;217;214;431
2020;February;6;2020-02-04 00:00;4;205;231;436
2020;February;6;2020-02-04 00:00;5;211;228;439
2020;February;6;2020-02-04 00:00;6;197;251;448
2020;February;6;2020-02-04 00:00;7;219;237;456
2020;February;6;2020-02-04 00:00;8;203;208;411
2020;February;6;2020-02-04 00:00;9;220;239;459
2020;February;6;2020-02-04 00:00;10;235;243;478
2020;February;6;2020-02-04 00:00;11;214;231;445
2020;February;6;2020-02-04 00:00;12;206;207;413
2020;February;6;2020-02-04 00:00;13;194;210;404
2020;February;6;2020-02-04 00:00;14;227;208;435
2020;February;6;2020-02-04 00:00;15;194;221;415
2020;February;6;2020-02-04 00:00;16;191;206;397
2020;February;6;2020-02-04 00:00;17;178;191;369
2020;February;6;2020-02-04 00:00;18;184;225;409
2020;February;6;2020-02-04 00:00;19;142;182;324
2020;February;6;2020-02-04 00:00;20;168;197;365
2020;February;6;2020-02-04 00:00;21;164;201;365
2020;February;6;2020-02-04 00:00;22;131;170;301
2020;February;6;2020-02-04 00:00;23;137;174;311
2020;February;6;2020-02-04 00:00;24;139;170;309
2020;February;6;2020-02-04 00:00;25;153;180;333
2020;February;6;2020-02-04 00:00;26;180;179;359
2020;February;6;2020-02-04 00:00;27;171;202;373
2020;February;6;2020-02-04 00:00;28;198;180;378
2020;February;6;2020-02-04 00:00;29;186;240;426
2020;February;6;2020-02-04 00:00;30;229;221;450
2020;February;6;2020-02-04 00:00;31;193;219;412
2020;February;6;2020-02-04 00:00;32;208;200;408
2020;February;6;2020-02-04 00:00;33;226;219;445
2020;February;6;2020-02-04 00:00;34;198;207;405
2020;February;6;2020-02-04 00:00;35;211;225;436
2020;February;6;2020-02-04 00:00;36;208;213;421
2020;February;6;2020-02-04 00:00;37;224;194;418
2020;February;6;2020-02-04 00:00;38;219;218;437
2020;February;6;2020-02-04 00:00;39;186;209;395
2020;February;6;2020-02-04 00:00;40;240;214;454
2020;February;6;2020-02-04 00:00;41;214;183;397
2020;February;6;2020-02-04 00:00;42;204;211;415
2020;February;6;2020-02-04 00:00;43;205;220;425
2020;February;6;2020-02-04 00:00;44;225;221;446
2020;February;6;2020-02-04 00:00;45;228;242;470
2020;February;6;2020-02-04 00:00;46;229;286;515
2020;February;6;2020-02-04 00:00;47;215;223;438
2020;February;6;2020-02-04 00:00;48;224;255;479
2020;February;6;2020-02-04 00:00;49;216;224;440
2020;February;6;2020-02-04 00:00;50;201;219;420
2020;February;6;2020-02-04 00:00;51;193;199;392
2020;February;6;2020-02-04 00:00;52;208;222;430
2020;February;6;2020-02-04 00:00;53;240;232;472
2020;February;6;2020-02-04 00:00;54;185;213;398
2020;February;6;2020-02-04 00:00;55;194;213;407
2020;February;6;2020-02-04 00:00;56;186;219;405
2020;February;6;2020-02-04 00:00;57;175;218;393
2020;February;6;2020-02-04 00:00;58;183;181;364
2020;February;6;2020-02-04 00:00;59;151;168;319
2020;February;6;2020-02-04 00:00;60;155;150;305
2020;February;6;2020-02-04 00:00;61;151;157;308
2020;February;6;2020-02-04 00:00;62;147;150;297
2020;February;6;2020-02-04 00:00;63;137;150;287
2020;February;6;2020-02-04 00:00;64;148;158;306
2020;February;6;2020-02-04 00:00;65;131;115;246
2020;February;6;2020-02-04 00:00;66;127;140;267
2020;February;6;2020-02-04 00:00;67;145;132;277
2020;February;6;2020-02-04 00:00;68;136;148;284
2020;February;6;2020-02-04 00:00;69;139;129;268
2020;February;6;2020-02-04 00:00;70;136;152;288
2020;February;6;2020-02-04 00:00;71;147;154;301
2020;February;6;2020-02-04 00:00;72;171;160;331
2020;February;6;2020-02-04 00:00;73;154;146;300
2020;February;6;2020-02-04 00:00;74;179;144;323
2020;February;6;2020-02-04 00:00;75;174;167;341
2020;February;6;2020-02-04 00:00;76;148;150;298
2020;February;6;2020-02-04 00:00;77;147;153;300
2020;February;6;2020-02-04 00:00;78;133;123;256
2020;February;6;2020-02-04 00:00;79;104;96;200
2020;February;6;2020-02-04 00:00;80;83;117;200
2020;February;6;2020-02-04 00:00;81;85;83;168
2020;February;6;2020-02-04 00:00;82;86;76;162
2020;February;6;2020-02-04 00:00;83;70;65;135
2020;February;6;2020-02-04 00:00;84;85;53;138
2020;February;6;2020-02-04 00:00;85;54;55;109
2020;February;6;2020-02-04 00:00;86;55;41;96
2020;February;6;2020-02-04 00:00;87;49;38;87
2020;February;6;2020-02-04 00:00;88;28;32;60
2020;February;6;2020-02-04 00:00;89;33;22;55
2020;February;6;2020-02-04 00:00;90;33;18;51
2020;February;6;2020-02-04 00:00;91;29;19;48
2020;February;6;2020-02-04 00:00;92;20;11;31
2020;February;6;2020-02-04 00:00;93;24;8;32
2020;February;6;2020-02-04 00:00;94;14;6;20
2020;February;6;2020-02-04 00:00;95;16;5;21
2020;February;6;2020-02-04 00:00;96;7;2;9
2020;February;6;2020-02-04 00:00;97;4;4;8
2020;February;6;2020-02-04 00:00;98;7;1;8
2020;February;6;2020-02-04 00:00;99;1;2;3
2020;February;6;2020-02-04 00:00;100;1;2;3
2020;February;6;2020-02-04 00:00;101;0;1;1
2020;February;6;2020-02-04 00:00;108;1;0;1
2020;February;7;2020-02-11 00:00;0;21;20;41
2020;February;7;2020-02-11 00:00;1;177;193;370
2020;February;7;2020-02-11 00:00;2;211;226;437
2020;February;7;2020-02-11 00:00;3;215;213;428
2020;February;7;2020-02-11 00:00;4;206;231;437
2020;February;7;2020-02-11 00:00;5;211;229;440
2020;February;7;2020-02-11 00:00;6;197;251;448
2020;February;7;2020-02-11 00:00;7;220;237;457
2020;February;7;2020-02-11 00:00;8;203;208;411
2020;February;7;2020-02-11 00:00;9;220;239;459
2020;February;7;2020-02-11 00:00;10;236;243;479
2020;February;7;2020-02-11 00:00;11;214;233;447
2020;February;7;2020-02-11 00:00;12;206;207;413
2020;February;7;2020-02-11 00:00;13;195;210;405
2020;February;7;2020-02-11 00:00;14;227;208;435
2020;February;7;2020-02-11 00:00;15;195;221;416
2020;February;7;2020-02-11 00:00;16;191;206;397
2020;February;7;2020-02-11 00:00;17;178;191;369
2020;February;7;2020-02-11 00:00;18;185;225;410
2020;February;7;2020-02-11 00:00;19;141;181;322
2020;February;7;2020-02-11 00:00;20;168;197;365
2020;February;7;2020-02-11 00:00;21;163;201;364
2020;February;7;2020-02-11 00:00;22;131;170;301
2020;February;7;2020-02-11 00:00;23;137;174;311
2020;February;7;2020-02-11 00:00;24;139;170;309
2020;February;7;2020-02-11 00:00;25;153;180;333
2020;February;7;2020-02-11 00:00;26;180;178;358
2020;February;7;2020-02-11 00:00;27;170;202;372
2020;February;7;2020-02-11 00:00;28;198;180;378
2020;February;7;2020-02-11 00:00;29;186;239;425
2020;February;7;2020-02-11 00:00;30;229;223;452
2020;February;7;2020-02-11 00:00;31;193;219;412
2020;February;7;2020-02-11 00:00;32;209;201;410
2020;February;7;2020-02-11 00:00;33;226;218;444
2020;February;7;2020-02-11 00:00;34;197;206;403
2020;February;7;2020-02-11 00:00;35;212;225;437
2020;February;7;2020-02-11 00:00;36;208;213;421
2020;February;7;2020-02-11 00:00;37;223;194;417
2020;February;7;2020-02-11 00:00;38;219;218;437
2020;February;7;2020-02-11 00:00;39;187;209;396
2020;February;7;2020-02-11 00:00;40;241;215;456
2020;February;7;2020-02-11 00:00;41;215;183;398
2020;February;7;2020-02-11 00:00;42;203;211;414
2020;February;7;2020-02-11 00:00;43;205;220;425
2020;February;7;2020-02-11 00:00;44;225;221;446
2020;February;7;2020-02-11 00:00;45;228;242;470
2020;February;7;2020-02-11 00:00;46;229;287;516
2020;February;7;2020-02-11 00:00;47;215;223;438
2020;February;7;2020-02-11 00:00;48;225;256;481
2020;February;7;2020-02-11 00:00;49;216;224;440
2020;February;7;2020-02-11 00:00;50;201;218;419
2020;February;7;2020-02-11 00:00;51;193;199;392
2020;February;7;2020-02-11 00:00;52;208;223;431
2020;February;7;2020-02-11 00:00;53;240;232;472
2020;February;7;2020-02-11 00:00;54;186;213;399
2020;February;7;2020-02-11 00:00;55;194;213;407
2020;February;7;2020-02-11 00:00;56;186;218;404
2020;February;7;2020-02-11 00:00;57;176;218;394
2020;February;7;2020-02-11 00:00;58;183;182;365
2020;February;7;2020-02-11 00:00;59;151;168;319
2020;February;7;2020-02-11 00:00;60;155;150;305
2020;February;7;2020-02-11 00:00;61;151;157;308
2020;February;7;2020-02-11 00:00;62;147;150;297
2020;February;7;2020-02-11 00:00;63;137;150;287
2020;February;7;2020-02-11 00:00;64;148;157;305
2020;February;7;2020-02-11 00:00;65;131;115;246
2020;February;7;2020-02-11 00:00;66;127;140;267
2020;February;7;2020-02-11 00:00;67;145;132;277
2020;February;7;2020-02-11 00:00;68;136;148;284
2020;February;7;2020-02-11 00:00;69;139;128;267
2020;February;7;2020-02-11 00:00;70;136;152;288
2020;February;7;2020-02-11 00:00;71;147;154;301
2020;February;7;2020-02-11 00:00;72;171;160;331
2020;February;7;2020-02-11 00:00;73;154;146;300
2020;February;7;2020-02-11 00:00;74;179;144;323
2020;February;7;2020-02-11 00:00;75;174;167;341
2020;February;7;2020-02-11 00:00;76;148;150;298
2020;February;7;2020-02-11 00:00;77;147;153;300
2020;February;7;2020-02-11 00:00;78;133;123;256
2020;February;7;2020-02-11 00:00;79;104;96;200
2020;February;7;2020-02-11 00:00;80;83;117;200
2020;February;7;2020-02-11 00:00;81;85;83;168
2020;February;7;2020-02-11 00:00;82;86;76;162
2020;February;7;2020-02-11 00:00;83;70;65;135
2020;February;7;2020-02-11 00:00;84;85;53;138
2020;February;7;2020-02-11 00:00;85;54;55;109
2020;February;7;2020-02-11 00:00;86;55;41;96
2020;February;7;2020-02-11 00:00;87;49;38;87
2020;February;7;2020-02-11 00:00;88;28;32;60
2020;February;7;2020-02-11 00:00;89;33;22;55
2020;February;7;2020-02-11 00:00;90;33;18;51
2020;February;7;2020-02-11 00:00;91;29;19;48
2020;February;7;2020-02-11 00:00;92;20;11;31
2020;February;7;2020-02-11 00:00;93;23;8;31
2020;February;7;2020-02-11 00:00;94;13;6;19
2020;February;7;2020-02-11 00:00;95;16;5;21
2020;February;7;2020-02-11 00:00;96;7;2;9
2020;February;7;2020-02-11 00:00;97;4;4;8
2020;February;7;2020-02-11 00:00;98;7;1;8
2020;February;7;2020-02-11 00:00;99;1;1;2
2020;February;7;2020-02-11 00:00;100;1;2;3
2020;February;7;2020-02-11 00:00;101;0;1;1
2020;February;7;2020-02-11 00:00;108;1;0;1
2020;February;8;2020-02-18 00:00;0;27;25;52
2020;February;8;2020-02-18 00:00;1;178;193;371
2020;February;8;2020-02-18 00:00;2;210;226;436
2020;February;8;2020-02-18 00:00;3;214;213;427
2020;February;8;2020-02-18 00:00;4;206;231;437
2020;February;8;2020-02-18 00:00;5;211;232;443
2020;February;8;2020-02-18 00:00;6;197;251;448
2020;February;8;2020-02-18 00:00;7;220;237;457
2020;February;8;2020-02-18 00:00;8;203;208;411
2020;February;8;2020-02-18 00:00;9;222;239;461
2020;February;8;2020-02-18 00:00;10;236;243;479
2020;February;8;2020-02-18 00:00;11;216;233;449
2020;February;8;2020-02-18 00:00;12;206;207;413
2020;February;8;2020-02-18 00:00;13;195;211;406
2020;February;8;2020-02-18 00:00;14;227;208;435
2020;February;8;2020-02-18 00:00;15;196;221;417
2020;February;8;2020-02-18 00:00;16;190;207;397
2020;February;8;2020-02-18 00:00;17;178;191;369
2020;February;8;2020-02-18 00:00;18;185;225;410
2020;February;8;2020-02-18 00:00;19;142;181;323
2020;February;8;2020-02-18 00:00;20;167;196;363
2020;February;8;2020-02-18 00:00;21;163;200;363
2020;February;8;2020-02-18 00:00;22;133;169;302
2020;February;8;2020-02-18 00:00;23;137;176;313
2020;February;8;2020-02-18 00:00;24;138;171;309
2020;February;8;2020-02-18 00:00;25;152;181;333
2020;February;8;2020-02-18 00:00;26;182;177;359
2020;February;8;2020-02-18 00:00;27;170;201;371
2020;February;8;2020-02-18 00:00;28;199;180;379
2020;February;8;2020-02-18 00:00;29;185;238;423
2020;February;8;2020-02-18 00:00;30;230;222;452
2020;February;8;2020-02-18 00:00;31;194;220;414
2020;February;8;2020-02-18 00:00;32;209;202;411
2020;February;8;2020-02-18 00:00;33;227;219;446
2020;February;8;2020-02-18 00:00;34;196;207;403
2020;February;8;2020-02-18 00:00;35;213;224;437
2020;February;8;2020-02-18 00:00;36;207;213;420
2020;February;8;2020-02-18 00:00;37;223;194;417
2020;February;8;2020-02-18 00:00;38;219;221;440
2020;February;8;2020-02-18 00:00;39;187;210;397
2020;February;8;2020-02-18 00:00;40;241;215;456
2020;February;8;2020-02-18 00:00;41;215;183;398
2020;February;8;2020-02-18 00:00;42;203;211;414
2020;February;8;2020-02-18 00:00;43;205;219;424
2020;February;8;2020-02-18 00:00;44;225;221;446
2020;February;8;2020-02-18 00:00;45;228;241;469
2020;February;8;2020-02-18 00:00;46;229;287;516
2020;February;8;2020-02-18 00:00;47;215;224;439
2020;February;8;2020-02-18 00:00;48;225;256;481
2020;February;8;2020-02-18 00:00;49;216;223;439
2020;February;8;2020-02-18 00:00;50;201;218;419
2020;February;8;2020-02-18 00:00;51;192;198;390
2020;February;8;2020-02-18 00:00;52;208;222;430
2020;February;8;2020-02-18 00:00;53;240;232;472
2020;February;8;2020-02-18 00:00;54;186;213;399
2020;February;8;2020-02-18 00:00;55;194;212;406
2020;February;8;2020-02-18 00:00;56;186;218;404
2020;February;8;2020-02-18 00:00;57;176;218;394
2020;February;8;2020-02-18 00:00;58;183;182;365
2020;February;8;2020-02-18 00:00;59;151;168;319
2020;February;8;2020-02-18 00:00;60;155;150;305
2020;February;8;2020-02-18 00:00;61;151;157;308
2020;February;8;2020-02-18 00:00;62;148;150;298
2020;February;8;2020-02-18 00:00;63;137;150;287
2020;February;8;2020-02-18 00:00;64;149;157;306
2020;February;8;2020-02-18 00:00;65;131;115;246
2020;February;8;2020-02-18 00:00;66;127;140;267
2020;February;8;2020-02-18 00:00;67;145;132;277
2020;February;8;2020-02-18 00:00;68;135;148;283
2020;February;8;2020-02-18 00:00;69;139;128;267
2020;February;8;2020-02-18 00:00;70;136;152;288
2020;February;8;2020-02-18 00:00;71;147;154;301
2020;February;8;2020-02-18 00:00;72;171;159;330
2020;February;8;2020-02-18 00:00;73;154;146;300
2020;February;8;2020-02-18 00:00;74;181;144;325
2020;February;8;2020-02-18 00:00;75;174;167;341
2020;February;8;2020-02-18 00:00;76;148;150;298
2020;February;8;2020-02-18 00:00;77;147;153;300
2020;February;8;2020-02-18 00:00;78;133;123;256
2020;February;8;2020-02-18 00:00;79;104;96;200
2020;February;8;2020-02-18 00:00;80;83;115;198
2020;February;8;2020-02-18 00:00;81;85;83;168
2020;February;8;2020-02-18 00:00;82;86;76;162
2020;February;8;2020-02-18 00:00;83;70;65;135
2020;February;8;2020-02-18 00:00;84;85;53;138
2020;February;8;2020-02-18 00:00;85;54;55;109
2020;February;8;2020-02-18 00:00;86;55;41;96
2020;February;8;2020-02-18 00:00;87;49;38;87
2020;February;8;2020-02-18 00:00;88;27;32;59
2020;February;8;2020-02-18 00:00;89;32;22;54
2020;February;8;2020-02-18 00:00;90;33;18;51
2020;February;8;2020-02-18 00:00;91;29;19;48
2020;February;8;2020-02-18 00:00;92;18;11;29
2020;February;8;2020-02-18 00:00;93;23;8;31
2020;February;8;2020-02-18 00:00;94;12;6;18
2020;February;8;2020-02-18 00:00;95;16;5;21
2020;February;8;2020-02-18 00:00;96;6;2;8
2020;February;8;2020-02-18 00:00;97;4;4;8
2020;February;8;2020-02-18 00:00;98;7;0;7
2020;February;8;2020-02-18 00:00;99;1;1;2
2020;February;8;2020-02-18 00:00;100;1;2;3
2020;February;8;2020-02-18 00:00;101;0;1;1
2020;February;8;2020-02-18 00:00;108;1;0;1
2020;February;9;2020-02-27 00:00;0;29;33;62
2020;February;9;2020-02-27 00:00;1;178;193;371
2020;February;9;2020-02-27 00:00;2;211;227;438
2020;February;9;2020-02-27 00:00;3;215;213;428
2020;February;9;2020-02-27 00:00;4;206;230;436
2020;February;9;2020-02-27 00:00;5;210;233;443
2020;February;9;2020-02-27 00:00;6;197;251;448
2020;February;9;2020-02-27 00:00;7;220;237;457
2020;February;9;2020-02-27 00:00;8;203;208;411
2020;February;9;2020-02-27 00:00;9;222;239;461
2020;February;9;2020-02-27 00:00;10;236;245;481
2020;February;9;2020-02-27 00:00;11;215;233;448
2020;February;9;2020-02-27 00:00;12;206;208;414
2020;February;9;2020-02-27 00:00;13;195;211;406
2020;February;9;2020-02-27 00:00;14;227;208;435
2020;February;9;2020-02-27 00:00;15;196;221;417
2020;February;9;2020-02-27 00:00;16;190;207;397
2020;February;9;2020-02-27 00:00;17;178;192;370
2020;February;9;2020-02-27 00:00;18;185;225;410
2020;February;9;2020-02-27 00:00;19;142;181;323
2020;February;9;2020-02-27 00:00;20;167;196;363
2020;February;9;2020-02-27 00:00;21;163;200;363
2020;February;9;2020-02-27 00:00;22;133;169;302
2020;February;9;2020-02-27 00:00;23;137;176;313
2020;February;9;2020-02-27 00:00;24;138;170;308
2020;February;9;2020-02-27 00:00;25;151;181;332
2020;February;9;2020-02-27 00:00;26;183;177;360
2020;February;9;2020-02-27 00:00;27;171;200;371
2020;February;9;2020-02-27 00:00;28;198;177;375
2020;February;9;2020-02-27 00:00;29;184;238;422
2020;February;9;2020-02-27 00:00;30;230;222;452
2020;February;9;2020-02-27 00:00;31;196;220;416
2020;February;9;2020-02-27 00:00;32;210;202;412
2020;February;9;2020-02-27 00:00;33;229;220;449
2020;February;9;2020-02-27 00:00;34;196;209;405
2020;February;9;2020-02-27 00:00;35;214;224;438
2020;February;9;2020-02-27 00:00;36;207;213;420
2020;February;9;2020-02-27 00:00;37;223;194;417
2020;February;9;2020-02-27 00:00;38;219;221;440
2020;February;9;2020-02-27 00:00;39;187;210;397
2020;February;9;2020-02-27 00:00;40;241;215;456
2020;February;9;2020-02-27 00:00;41;216;183;399
2020;February;9;2020-02-27 00:00;42;203;211;414
2020;February;9;2020-02-27 00:00;43;205;219;424
2020;February;9;2020-02-27 00:00;44;225;221;446
2020;February;9;2020-02-27 00:00;45;227;241;468
2020;February;9;2020-02-27 00:00;46;229;286;515
2020;February;9;2020-02-27 00:00;47;215;223;438
2020;February;9;2020-02-27 00:00;48;225;256;481
2020;February;9;2020-02-27 00:00;49;216;223;439
2020;February;9;2020-02-27 00:00;50;201;217;418
2020;February;9;2020-02-27 00:00;51;192;198;390
2020;February;9;2020-02-27 00:00;52;206;223;429
2020;February;9;2020-02-27 00:00;53;239;232;471
2020;February;9;2020-02-27 00:00;54;186;213;399
2020;February;9;2020-02-27 00:00;55;194;212;406
2020;February;9;2020-02-27 00:00;56;186;218;404
2020;February;9;2020-02-27 00:00;57;175;218;393
2020;February;9;2020-02-27 00:00;58;183;181;364
2020;February;9;2020-02-27 00:00;59;151;168;319
2020;February;9;2020-02-27 00:00;60;155;150;305
2020;February;9;2020-02-27 00:00;61;151;157;308
2020;February;9;2020-02-27 00:00;62;148;150;298
2020;February;9;2020-02-27 00:00;63;137;150;287
2020;February;9;2020-02-27 00:00;64;149;155;304
2020;February;9;2020-02-27 00:00;65;131;115;246
2020;February;9;2020-02-27 00:00;66;127;138;265
2020;February;9;2020-02-27 00:00;67;145;132;277
2020;February;9;2020-02-27 00:00;68;135;148;283
2020;February;9;2020-02-27 00:00;69;139;128;267
2020;February;9;2020-02-27 00:00;70;136;152;288
2020;February;9;2020-02-27 00:00;71;146;154;300
2020;February;9;2020-02-27 00:00;72;171;159;330
2020;February;9;2020-02-27 00:00;73;154;146;300
2020;February;9;2020-02-27 00:00;74;181;143;324
2020;February;9;2020-02-27 00:00;75;174;167;341
2020;February;9;2020-02-27 00:00;76;148;150;298
2020;February;9;2020-02-27 00:00;77;147;153;300
2020;February;9;2020-02-27 00:00;78;133;123;256
2020;February;9;2020-02-27 00:00;79;104;96;200
2020;February;9;2020-02-27 00:00;80;83;115;198
2020;February;9;2020-02-27 00:00;81;85;83;168
2020;February;9;2020-02-27 00:00;82;86;76;162
2020;February;9;2020-02-27 00:00;83;70;65;135
2020;February;9;2020-02-27 00:00;84;84;53;137
2020;February;9;2020-02-27 00:00;85;54;55;109
2020;February;9;2020-02-27 00:00;86;55;41;96
2020;February;9;2020-02-27 00:00;87;49;38;87
2020;February;9;2020-02-27 00:00;88;27;32;59
2020;February;9;2020-02-27 00:00;89;32;22;54
2020;February;9;2020-02-27 00:00;90;33;18;51
2020;February;9;2020-02-27 00:00;91;29;19;48
2020;February;9;2020-02-27 00:00;92;18;11;29
2020;February;9;2020-02-27 00:00;93;23;8;31
2020;February;9;2020-02-27 00:00;94;12;6;18
2020;February;9;2020-02-27 00:00;95;16;5;21
2020;February;9;2020-02-27 00:00;96;6;2;8
2020;February;9;2020-02-27 00:00;97;3;4;7
2020;February;9;2020-02-27 00:00;98;7;0;7
2020;February;9;2020-02-27 00:00;99;1;1;2
2020;February;9;2020-02-27 00:00;100;1;2;3
2020;February;9;2020-02-27 00:00;101;0;1;1
2020;February;9;2020-02-27 00:00;108;1;0;1
2020;March;10;2020-03-03 00:00;0;32;37;69
2020;March;10;2020-03-03 00:00;1;181;193;374
2020;March;10;2020-03-03 00:00;2;212;229;441
2020;March;10;2020-03-03 00:00;3;214;214;428
2020;March;10;2020-03-03 00:00;4;206;231;437
2020;March;10;2020-03-03 00:00;5;210;235;445
2020;March;10;2020-03-03 00:00;6;198;251;449
2020;March;10;2020-03-03 00:00;7;221;237;458
2020;March;10;2020-03-03 00:00;8;204;208;412
2020;March;10;2020-03-03 00:00;9;222;239;461
2020;March;10;2020-03-03 00:00;10;236;246;482
2020;March;10;2020-03-03 00:00;11;215;233;448
2020;March;10;2020-03-03 00:00;12;206;208;414
2020;March;10;2020-03-03 00:00;13;194;211;405
2020;March;10;2020-03-03 00:00;14;228;209;437
2020;March;10;2020-03-03 00:00;15;196;221;417
2020;March;10;2020-03-03 00:00;16;191;207;398
2020;March;10;2020-03-03 00:00;17;178;191;369
2020;March;10;2020-03-03 00:00;18;185;225;410
2020;March;10;2020-03-03 00:00;19;143;181;324
2020;March;10;2020-03-03 00:00;20;169;196;365
2020;March;10;2020-03-03 00:00;21;163;199;362
2020;March;10;2020-03-03 00:00;22;132;168;300
2020;March;10;2020-03-03 00:00;23;136;177;313
2020;March;10;2020-03-03 00:00;24;141;171;312
2020;March;10;2020-03-03 00:00;25;154;182;336
2020;March;10;2020-03-03 00:00;26;184;178;362
2020;March;10;2020-03-03 00:00;27;169;203;372
2020;March;10;2020-03-03 00:00;28;199;177;376
2020;March;10;2020-03-03 00:00;29;186;236;422
2020;March;10;2020-03-03 00:00;30;228;221;449
2020;March;10;2020-03-03 00:00;31;198;219;417
2020;March;10;2020-03-03 00:00;32;210;204;414
2020;March;10;2020-03-03 00:00;33;230;221;451
2020;March;10;2020-03-03 00:00;34;196;210;406
2020;March;10;2020-03-03 00:00;35;214;226;440
2020;March;10;2020-03-03 00:00;36;210;214;424
2020;March;10;2020-03-03 00:00;37;222;193;415
2020;March;10;2020-03-03 00:00;38;222;223;445
2020;March;10;2020-03-03 00:00;39;189;211;400
2020;March;10;2020-03-03 00:00;40;242;215;457
2020;March;10;2020-03-03 00:00;41;216;183;399
2020;March;10;2020-03-03 00:00;42;204;211;415
2020;March;10;2020-03-03 00:00;43;205;221;426
2020;March;10;2020-03-03 00:00;44;226;223;449
2020;March;10;2020-03-03 00:00;45;224;244;468
2020;March;10;2020-03-03 00:00;46;229;284;513
2020;March;10;2020-03-03 00:00;47;215;225;440
2020;March;10;2020-03-03 00:00;48;225;256;481
2020;March;10;2020-03-03 00:00;49;216;223;439
2020;March;10;2020-03-03 00:00;50;202;217;419
2020;March;10;2020-03-03 00:00;51;190;197;387
2020;March;10;2020-03-03 00:00;52;206;223;429
2020;March;10;2020-03-03 00:00;53;239;233;472
2020;March;10;2020-03-03 00:00;54;186;213;399
2020;March;10;2020-03-03 00:00;55;194;212;406
2020;March;10;2020-03-03 00:00;56;186;219;405
2020;March;10;2020-03-03 00:00;57;175;218;393
2020;March;10;2020-03-03 00:00;58;183;181;364
2020;March;10;2020-03-03 00:00;59;151;168;319
2020;March;10;2020-03-03 00:00;60;155;150;305
2020;March;10;2020-03-03 00:00;61;151;157;308
2020;March;10;2020-03-03 00:00;62;147;150;297
2020;March;10;2020-03-03 00:00;63;138;149;287
2020;March;10;2020-03-03 00:00;64;149;155;304
2020;March;10;2020-03-03 00:00;65;132;115;247
2020;March;10;2020-03-03 00:00;66;127;138;265
2020;March;10;2020-03-03 00:00;67;145;132;277
2020;March;10;2020-03-03 00:00;68;135;148;283
2020;March;10;2020-03-03 00:00;69;139;127;266
2020;March;10;2020-03-03 00:00;70;136;152;288
2020;March;10;2020-03-03 00:00;71;146;154;300
2020;March;10;2020-03-03 00:00;72;171;159;330
2020;March;10;2020-03-03 00:00;73;154;146;300
2020;March;10;2020-03-03 00:00;74;181;143;324
2020;March;10;2020-03-03 00:00;75;174;167;341
2020;March;10;2020-03-03 00:00;76;146;150;296
2020;March;10;2020-03-03 00:00;77;146;153;299
2020;March;10;2020-03-03 00:00;78;133;122;255
2020;March;10;2020-03-03 00:00;79;104;96;200
2020;March;10;2020-03-03 00:00;80;83;115;198
2020;March;10;2020-03-03 00:00;81;85;83;168
2020;March;10;2020-03-03 00:00;82;86;75;161
2020;March;10;2020-03-03 00:00;83;70;65;135
2020;March;10;2020-03-03 00:00;84;84;53;137
2020;March;10;2020-03-03 00:00;85;54;55;109
2020;March;10;2020-03-03 00:00;86;55;41;96
2020;March;10;2020-03-03 00:00;87;49;38;87
2020;March;10;2020-03-03 00:00;88;26;32;58
2020;March;10;2020-03-03 00:00;89;32;22;54
2020;March;10;2020-03-03 00:00;90;33;18;51
2020;March;10;2020-03-03 00:00;91;29;19;48
2020;March;10;2020-03-03 00:00;92;18;11;29
2020;March;10;2020-03-03 00:00;93;23;7;30
2020;March;10;2020-03-03 00:00;94;12;6;18
2020;March;10;2020-03-03 00:00;95;16;5;21
2020;March;10;2020-03-03 00:00;96;6;2;8
2020;March;10;2020-03-03 00:00;97;3;4;7
2020;March;10;2020-03-03 00:00;98;7;0;7
2020;March;10;2020-03-03 00:00;99;1;1;2
2020;March;10;2020-03-03 00:00;100;1;2;3
2020;March;10;2020-03-03 00:00;101;0;1;1
2020;March;10;2020-03-03 00:00;108;1;0;1
2020;March;11;2020-03-10 00:00;0;36;41;77
2020;March;11;2020-03-10 00:00;1;180;193;373
2020;March;11;2020-03-10 00:00;2;213;230;443
2020;March;11;2020-03-10 00:00;3;214;214;428
2020;March;11;2020-03-10 00:00;4;206;232;438
2020;March;11;2020-03-10 00:00;5;210;235;445
2020;March;11;2020-03-10 00:00;6;199;251;450
2020;March;11;2020-03-10 00:00;7;221;238;459
2020;March;11;2020-03-10 00:00;8;204;208;412
2020;March;11;2020-03-10 00:00;9;223;239;462
2020;March;11;2020-03-10 00:00;10;236;246;482
2020;March;11;2020-03-10 00:00;11;215;233;448
2020;March;11;2020-03-10 00:00;12;207;208;415
2020;March;11;2020-03-10 00:00;13;194;211;405
2020;March;11;2020-03-10 00:00;14;228;208;436
2020;March;11;2020-03-10 00:00;15;196;221;417
2020;March;11;2020-03-10 00:00;16;192;207;399
2020;March;11;2020-03-10 00:00;17;178;192;370
2020;March;11;2020-03-10 00:00;18;185;225;410
2020;March;11;2020-03-10 00:00;19;143;181;324
2020;March;11;2020-03-10 00:00;20;170;195;365
2020;March;11;2020-03-10 00:00;21;163;200;363
2020;March;11;2020-03-10 00:00;22;131;167;298
2020;March;11;2020-03-10 00:00;23;135;176;311
2020;March;11;2020-03-10 00:00;24;141;171;312
2020;March;11;2020-03-10 00:00;25;154;183;337
2020;March;11;2020-03-10 00:00;26;184;177;361
2020;March;11;2020-03-10 00:00;27;169;203;372
2020;March;11;2020-03-10 00:00;28;197;177;374
2020;March;11;2020-03-10 00:00;29;188;238;426
2020;March;11;2020-03-10 00:00;30;229;223;452
2020;March;11;2020-03-10 00:00;31;198;219;417
2020;March;11;2020-03-10 00:00;32;210;205;415
2020;March;11;2020-03-10 00:00;33;228;221;449
2020;March;11;2020-03-10 00:00;34;196;210;406
2020;March;11;2020-03-10 00:00;35;213;226;439
2020;March;11;2020-03-10 00:00;36;211;213;424
2020;March;11;2020-03-10 00:00;37;221;193;414
2020;March;11;2020-03-10 00:00;38;223;225;448
2020;March;11;2020-03-10 00:00;39;190;211;401
2020;March;11;2020-03-10 00:00;40;242;215;457
2020;March;11;2020-03-10 00:00;41;215;184;399
2020;March;11;2020-03-10 00:00;42;203;210;413
2020;March;11;2020-03-10 00:00;43;206;219;425
2020;March;11;2020-03-10 00:00;44;225;223;448
2020;March;11;2020-03-10 00:00;45;223;244;467
2020;March;11;2020-03-10 00:00;46;229;285;514
2020;March;11;2020-03-10 00:00;47;215;225;440
2020;March;11;2020-03-10 00:00;48;226;256;482
2020;March;11;2020-03-10 00:00;49;216;223;439
2020;March;11;2020-03-10 00:00;50;202;218;420
2020;March;11;2020-03-10 00:00;51;191;197;388
2020;March;11;2020-03-10 00:00;52;206;223;429
2020;March;11;2020-03-10 00:00;53;239;235;474
2020;March;11;2020-03-10 00:00;54;186;214;400
2020;March;11;2020-03-10 00:00;55;194;212;406
2020;March;11;2020-03-10 00:00;56;186;219;405
2020;March;11;2020-03-10 00:00;57;176;218;394
2020;March;11;2020-03-10 00:00;58;183;181;364
2020;March;11;2020-03-10 00:00;59;151;168;319
2020;March;11;2020-03-10 00:00;60;155;150;305
2020;March;11;2020-03-10 00:00;61;151;157;308
2020;March;11;2020-03-10 00:00;62;147;150;297
2020;March;11;2020-03-10 00:00;63;138;149;287
2020;March;11;2020-03-10 00:00;64;147;155;302
2020;March;11;2020-03-10 00:00;65;132;115;247
2020;March;11;2020-03-10 00:00;66;127;137;264
2020;March;11;2020-03-10 00:00;67;146;132;278
2020;March;11;2020-03-10 00:00;68;135;147;282
2020;March;11;2020-03-10 00:00;69;139;127;266
2020;March;11;2020-03-10 00:00;70;136;152;288
2020;March;11;2020-03-10 00:00;71;146;154;300
2020;March;11;2020-03-10 00:00;72;171;159;330
2020;March;11;2020-03-10 00:00;73;154;146;300
2020;March;11;2020-03-10 00:00;74;181;143;324
2020;March;11;2020-03-10 00:00;75;174;167;341
2020;March;11;2020-03-10 00:00;76;146;150;296
2020;March;11;2020-03-10 00:00;77;146;153;299
2020;March;11;2020-03-10 00:00;78;133;122;255
2020;March;11;2020-03-10 00:00;79;104;96;200
2020;March;11;2020-03-10 00:00;80;83;115;198
2020;March;11;2020-03-10 00:00;81;85;83;168
2020;March;11;2020-03-10 00:00;82;86;75;161
2020;March;11;2020-03-10 00:00;83;70;65;135
2020;March;11;2020-03-10 00:00;84;84;53;137
2020;March;11;2020-03-10 00:00;85;54;55;109
2020;March;11;2020-03-10 00:00;86;55;41;96
2020;March;11;2020-03-10 00:00;87;49;37;86
2020;March;11;2020-03-10 00:00;88;26;32;58
2020;March;11;2020-03-10 00:00;89;31;22;53
2020;March;11;2020-03-10 00:00;90;33;18;51
2020;March;11;2020-03-10 00:00;91;29;19;48
2020;March;11;2020-03-10 00:00;92;18;11;29
2020;March;11;2020-03-10 00:00;93;23;7;30
2020;March;11;2020-03-10 00:00;94;12;6;18
2020;March;11;2020-03-10 00:00;95;16;5;21
2020;March;11;2020-03-10 00:00;96;6;2;8
2020;March;11;2020-03-10 00:00;97;3;4;7
2020;March;11;2020-03-10 00:00;98;7;0;7
2020;March;11;2020-03-10 00:00;99;1;1;2
2020;March;11;2020-03-10 00:00;100;1;1;2
2020;March;11;2020-03-10 00:00;101;0;1;1
2020;March;11;2020-03-10 00:00;108;1;0;1
2020;March;13;2020-03-24 00:00;0;47;49;96
2020;March;13;2020-03-24 00:00;1;181;193;374
2020;March;13;2020-03-24 00:00;2;212;230;442
2020;March;13;2020-03-24 00:00;3;212;212;424
2020;March;13;2020-03-24 00:00;4;207;233;440
2020;March;13;2020-03-24 00:00;5;210;233;443
2020;March;13;2020-03-24 00:00;6;200;251;451
2020;March;13;2020-03-24 00:00;7;220;238;458
2020;March;13;2020-03-24 00:00;8;205;207;412
2020;March;13;2020-03-24 00:00;9;224;240;464
2020;March;13;2020-03-24 00:00;10;236;246;482
2020;March;13;2020-03-24 00:00;11;216;232;448
2020;March;13;2020-03-24 00:00;12;207;208;415
2020;March;13;2020-03-24 00:00;13;194;211;405
2020;March;13;2020-03-24 00:00;14;228;208;436
2020;March;13;2020-03-24 00:00;15;196;221;417
2020;March;13;2020-03-24 00:00;16;193;207;400
2020;March;13;2020-03-24 00:00;17;178;192;370
2020;March;13;2020-03-24 00:00;18;185;226;411
2020;March;13;2020-03-24 00:00;19;143;181;324
2020;March;13;2020-03-24 00:00;20;172;193;365
2020;March;13;2020-03-24 00:00;21;161;200;361
2020;March;13;2020-03-24 00:00;22;130;167;297
2020;March;13;2020-03-24 00:00;23;135;176;311
2020;March;13;2020-03-24 00:00;24;142;171;313
2020;March;13;2020-03-24 00:00;25;154;181;335
2020;March;13;2020-03-24 00:00;26;183;177;360
2020;March;13;2020-03-24 00:00;27;167;202;369
2020;March;13;2020-03-24 00:00;28;194;176;370
2020;March;13;2020-03-24 00:00;29;188;236;424
2020;March;13;2020-03-24 00:00;30;229;222;451
2020;March;13;2020-03-24 00:00;31;196;219;415
2020;March;13;2020-03-24 00:00;32;211;207;418
2020;March;13;2020-03-24 00:00;33;230;221;451
2020;March;13;2020-03-24 00:00;34;196;209;405
2020;March;13;2020-03-24 00:00;35;214;229;443
2020;March;13;2020-03-24 00:00;36;212;214;426
2020;March;13;2020-03-24 00:00;37;221;194;415
2020;March;13;2020-03-24 00:00;38;223;225;448
2020;March;13;2020-03-24 00:00;39;190;212;402
2020;March;13;2020-03-24 00:00;40;243;217;460
2020;March;13;2020-03-24 00:00;41;216;183;399
2020;March;13;2020-03-24 00:00;42;203;212;415
2020;March;13;2020-03-24 00:00;43;206;221;427
2020;March;13;2020-03-24 00:00;44;224;222;446
2020;March;13;2020-03-24 00:00;45;223;245;468
2020;March;13;2020-03-24 00:00;46;230;285;515
2020;March;13;2020-03-24 00:00;47;215;224;439
2020;March;13;2020-03-24 00:00;48;226;256;482
2020;March;13;2020-03-24 00:00;49;216;223;439
2020;March;13;2020-03-24 00:00;50;201;218;419
2020;March;13;2020-03-24 00:00;51;190;197;387
2020;March;13;2020-03-24 00:00;52;207;223;430
2020;March;13;2020-03-24 00:00;53;239;234;473
2020;March;13;2020-03-24 00:00;54;186;213;399
2020;March;13;2020-03-24 00:00;55;192;213;405
2020;March;13;2020-03-24 00:00;56;186;219;405
2020;March;13;2020-03-24 00:00;57;176;216;392
2020;March;13;2020-03-24 00:00;58;183;181;364
2020;March;13;2020-03-24 00:00;59;151;168;319
2020;March;13;2020-03-24 00:00;60;155;152;307
2020;March;13;2020-03-24 00:00;61;151;157;308
2020;March;13;2020-03-24 00:00;62;147;150;297
2020;March;13;2020-03-24 00:00;63;138;148;286
2020;March;13;2020-03-24 00:00;64;147;154;301
2020;March;13;2020-03-24 00:00;65;131;115;246
2020;March;13;2020-03-24 00:00;66;127;136;263
2020;March;13;2020-03-24 00:00;67;146;132;278
2020;March;13;2020-03-24 00:00;68;134;147;281
2020;March;13;2020-03-24 00:00;69;139;127;266
2020;March;13;2020-03-24 00:00;70;136;152;288
2020;March;13;2020-03-24 00:00;71;146;154;300
2020;March;13;2020-03-24 00:00;72;170;157;327
2020;March;13;2020-03-24 00:00;73;153;146;299
2020;March;13;2020-03-24 00:00;74;180;141;321
2020;March;13;2020-03-24 00:00;75;174;167;341
2020;March;13;2020-03-24 00:00;76;145;150;295
2020;March;13;2020-03-24 00:00;77;146;152;298
2020;March;13;2020-03-24 00:00;78;131;122;253
2020;March;13;2020-03-24 00:00;79;104;96;200
2020;March;13;2020-03-24 00:00;80;83;115;198
2020;March;13;2020-03-24 00:00;81;86;82;168
2020;March;13;2020-03-24 00:00;82;86;75;161
2020;March;13;2020-03-24 00:00;83;70;65;135
2020;March;13;2020-03-24 00:00;84;83;52;135
2020;March;13;2020-03-24 00:00;85;54;55;109
2020;March;13;2020-03-24 00:00;86;55;41;96
2020;March;13;2020-03-24 00:00;87;49;37;86
2020;March;13;2020-03-24 00:00;88;26;32;58
2020;March;13;2020-03-24 00:00;89;31;22;53
2020;March;13;2020-03-24 00:00;90;33;18;51
2020;March;13;2020-03-24 00:00;91;29;19;48
2020;March;13;2020-03-24 00:00;92;18;11;29
2020;March;13;2020-03-24 00:00;93;23;7;30
2020;March;13;2020-03-24 00:00;94;12;5;17
2020;March;13;2020-03-24 00:00;95;16;5;21
2020;March;13;2020-03-24 00:00;96;6;2;8
2020;March;13;2020-03-24 00:00;97;3;4;7
2020;March;13;2020-03-24 00:00;98;7;0;7
2020;March;13;2020-03-24 00:00;99;1;1;2
2020;March;13;2020-03-24 00:00;100;1;1;2
2020;March;13;2020-03-24 00:00;101;0;1;1
2020;March;13;2020-03-24 00:00;108;1;0;1
2020;March;14;2020-03-31 00:00;0;48;51;99
2020;March;14;2020-03-31 00:00;1;181;192;373
2020;March;14;2020-03-31 00:00;2;212;232;444
2020;March;14;2020-03-31 00:00;3;212;213;425
2020;March;14;2020-03-31 00:00;4;207;232;439
2020;March;14;2020-03-31 00:00;5;210;233;443
2020;March;14;2020-03-31 00:00;6;200;250;450
2020;March;14;2020-03-31 00:00;7;221;238;459
2020;March;14;2020-03-31 00:00;8;205;206;411
2020;March;14;2020-03-31 00:00;9;224;240;464
2020;March;14;2020-03-31 00:00;10;236;246;482
2020;March;14;2020-03-31 00:00;11;216;232;448
2020;March;14;2020-03-31 00:00;12;207;208;415
2020;March;14;2020-03-31 00:00;13;194;210;404
2020;March;14;2020-03-31 00:00;14;228;208;436
2020;March;14;2020-03-31 00:00;15;196;220;416
2020;March;14;2020-03-31 00:00;16;193;207;400
2020;March;14;2020-03-31 00:00;17;179;192;371
2020;March;14;2020-03-31 00:00;18;185;226;411
2020;March;14;2020-03-31 00:00;19;143;181;324
2020;March;14;2020-03-31 00:00;20;172;192;364
2020;March;14;2020-03-31 00:00;21;161;199;360
2020;March;14;2020-03-31 00:00;22;130;168;298
2020;March;14;2020-03-31 00:00;23;135;175;310
2020;March;14;2020-03-31 00:00;24;142;170;312
2020;March;14;2020-03-31 00:00;25;152;181;333
2020;March;14;2020-03-31 00:00;26;183;175;358
2020;March;14;2020-03-31 00:00;27;167;204;371
2020;March;14;2020-03-31 00:00;28;194;176;370
2020;March;14;2020-03-31 00:00;29;188;236;424
2020;March;14;2020-03-31 00:00;30;227;220;447
2020;March;14;2020-03-31 00:00;31;196;221;417
2020;March;14;2020-03-31 00:00;32;211;209;420
2020;March;14;2020-03-31 00:00;33;230;221;451
2020;March;14;2020-03-31 00:00;34;198;210;408
2020;March;14;2020-03-31 00:00;35;212;229;441
2020;March;14;2020-03-31 00:00;36;212;214;426
2020;March;14;2020-03-31 00:00;37;222;194;416
2020;March;14;2020-03-31 00:00;38;223;226;449
2020;March;14;2020-03-31 00:00;39;190;212;402
2020;March;14;2020-03-31 00:00;40;243;217;460
2020;March;14;2020-03-31 00:00;41;216;183;399
2020;March;14;2020-03-31 00:00;42;202;212;414
2020;March;14;2020-03-31 00:00;43;206;222;428
2020;March;14;2020-03-31 00:00;44;223;221;444
2020;March;14;2020-03-31 00:00;45;223;245;468
2020;March;14;2020-03-31 00:00;46;230;285;515
2020;March;14;2020-03-31 00:00;47;216;224;440
2020;March;14;2020-03-31 00:00;48;226;257;483
2020;March;14;2020-03-31 00:00;49;216;223;439
2020;March;14;2020-03-31 00:00;50;201;218;419
2020;March;14;2020-03-31 00:00;51;192;197;389
2020;March;14;2020-03-31 00:00;52;207;223;430
2020;March;14;2020-03-31 00:00;53;240;234;474
2020;March;14;2020-03-31 00:00;54;186;213;399
2020;March;14;2020-03-31 00:00;55;192;214;406
2020;March;14;2020-03-31 00:00;56;187;219;406
2020;March;14;2020-03-31 00:00;57;176;216;392
2020;March;14;2020-03-31 00:00;58;183;181;364
2020;March;14;2020-03-31 00:00;59;151;169;320
2020;March;14;2020-03-31 00:00;60;155;152;307
2020;March;14;2020-03-31 00:00;61;151;157;308
2020;March;14;2020-03-31 00:00;62;148;150;298
2020;March;14;2020-03-31 00:00;63;138;148;286
2020;March;14;2020-03-31 00:00;64;147;154;301
2020;March;14;2020-03-31 00:00;65;131;115;246
2020;March;14;2020-03-31 00:00;66;127;136;263
2020;March;14;2020-03-31 00:00;67;146;132;278
2020;March;14;2020-03-31 00:00;68;134;147;281
2020;March;14;2020-03-31 00:00;69;139;127;266
2020;March;14;2020-03-31 00:00;70;136;152;288
2020;March;14;2020-03-31 00:00;71;146;154;300
2020;March;14;2020-03-31 00:00;72;170;157;327
2020;March;14;2020-03-31 00:00;73;153;146;299
2020;March;14;2020-03-31 00:00;74;180;141;321
2020;March;14;2020-03-31 00:00;75;175;167;342
2020;March;14;2020-03-31 00:00;76;145;150;295
2020;March;14;2020-03-31 00:00;77;145;152;297
2020;March;14;2020-03-31 00:00;78;130;122;252
2020;March;14;2020-03-31 00:00;79;104;96;200
2020;March;14;2020-03-31 00:00;80;83;115;198
2020;March;14;2020-03-31 00:00;81;86;82;168
2020;March;14;2020-03-31 00:00;82;86;75;161
2020;March;14;2020-03-31 00:00;83;70;65;135
2020;March;14;2020-03-31 00:00;84;83;52;135
2020;March;14;2020-03-31 00:00;85;54;55;109
2020;March;14;2020-03-31 00:00;86;55;41;96
2020;March;14;2020-03-31 00:00;87;49;37;86
2020;March;14;2020-03-31 00:00;88;26;32;58
2020;March;14;2020-03-31 00:00;89;31;22;53
2020;March;14;2020-03-31 00:00;90;33;18;51
2020;March;14;2020-03-31 00:00;91;29;19;48
2020;March;14;2020-03-31 00:00;92;18;11;29
2020;March;14;2020-03-31 00:00;93;23;7;30
2020;March;14;2020-03-31 00:00;94;12;5;17
2020;March;14;2020-03-31 00:00;95;16;5;21
2020;March;14;2020-03-31 00:00;96;6;2;8
2020;March;14;2020-03-31 00:00;97;3;4;7
2020;March;14;2020-03-31 00:00;98;7;0;7
2020;March;14;2020-03-31 00:00;99;1;1;2
2020;March;14;2020-03-31 00:00;100;1;1;2
2020;March;14;2020-03-31 00:00;101;0;1;1
2020;March;14;2020-03-31 00:00;108;1;0;1
2020;April;15;2020-04-07 00:00;0;51;51;102
2020;April;15;2020-04-07 00:00;1;182;191;373
2020;April;15;2020-04-07 00:00;2;213;230;443
2020;April;15;2020-04-07 00:00;3;212;213;425
2020;April;15;2020-04-07 00:00;4;206;232;438
2020;April;15;2020-04-07 00:00;5;211;233;444
2020;April;15;2020-04-07 00:00;6;199;250;449
2020;April;15;2020-04-07 00:00;7;222;238;460
2020;April;15;2020-04-07 00:00;8;206;206;412
2020;April;15;2020-04-07 00:00;9;224;240;464
2020;April;15;2020-04-07 00:00;10;236;245;481
2020;April;15;2020-04-07 00:00;11;216;232;448
2020;April;15;2020-04-07 00:00;12;207;208;415
2020;April;15;2020-04-07 00:00;13;194;210;404
2020;April;15;2020-04-07 00:00;14;228;206;434
2020;April;15;2020-04-07 00:00;15;196;220;416
2020;April;15;2020-04-07 00:00;16;192;207;399
2020;April;15;2020-04-07 00:00;17;179;192;371
2020;April;15;2020-04-07 00:00;18;185;225;410
2020;April;15;2020-04-07 00:00;19;143;182;325
2020;April;15;2020-04-07 00:00;20;171;192;363
2020;April;15;2020-04-07 00:00;21;161;200;361
2020;April;15;2020-04-07 00:00;22;130;169;299
2020;April;15;2020-04-07 00:00;23;136;176;312
2020;April;15;2020-04-07 00:00;24;142;172;314
2020;April;15;2020-04-07 00:00;25;154;181;335
2020;April;15;2020-04-07 00:00;26;181;173;354
2020;April;15;2020-04-07 00:00;27;168;202;370
2020;April;15;2020-04-07 00:00;28;194;175;369
2020;April;15;2020-04-07 00:00;29;190;235;425
2020;April;15;2020-04-07 00:00;30;229;221;450
2020;April;15;2020-04-07 00:00;31;195;221;416
2020;April;15;2020-04-07 00:00;32;211;207;418
2020;April;15;2020-04-07 00:00;33;229;221;450
2020;April;15;2020-04-07 00:00;34;197;210;407
2020;April;15;2020-04-07 00:00;35;211;229;440
2020;April;15;2020-04-07 00:00;36;213;214;427
2020;April;15;2020-04-07 00:00;37;223;193;416
2020;April;15;2020-04-07 00:00;38;224;228;452
2020;April;15;2020-04-07 00:00;39;189;213;402
2020;April;15;2020-04-07 00:00;40;243;217;460
2020;April;15;2020-04-07 00:00;41;216;184;400
2020;April;15;2020-04-07 00:00;42;202;213;415
2020;April;15;2020-04-07 00:00;43;206;222;428
2020;April;15;2020-04-07 00:00;44;222;221;443
2020;April;15;2020-04-07 00:00;45;221;245;466
2020;April;15;2020-04-07 00:00;46;231;285;516
2020;April;15;2020-04-07 00:00;47;217;225;442
2020;April;15;2020-04-07 00:00;48;226;257;483
2020;April;15;2020-04-07 00:00;49;216;223;439
2020;April;15;2020-04-07 00:00;50;201;218;419
2020;April;15;2020-04-07 00:00;51;192;197;389
2020;April;15;2020-04-07 00:00;52;208;223;431
2020;April;15;2020-04-07 00:00;53;239;233;472
2020;April;15;2020-04-07 00:00;54;186;212;398
2020;April;15;2020-04-07 00:00;55;192;212;404
2020;April;15;2020-04-07 00:00;56;188;219;407
2020;April;15;2020-04-07 00:00;57;176;216;392
2020;April;15;2020-04-07 00:00;58;183;181;364
2020;April;15;2020-04-07 00:00;59;152;169;321
2020;April;15;2020-04-07 00:00;60;155;152;307
2020;April;15;2020-04-07 00:00;61;150;157;307
2020;April;15;2020-04-07 00:00;62;148;150;298
2020;April;15;2020-04-07 00:00;63;137;148;285
2020;April;15;2020-04-07 00:00;64;147;155;302
2020;April;15;2020-04-07 00:00;65;130;114;244
2020;April;15;2020-04-07 00:00;66;127;135;262
2020;April;15;2020-04-07 00:00;67;146;131;277
2020;April;15;2020-04-07 00:00;68;134;147;281
2020;April;15;2020-04-07 00:00;69;138;126;264
2020;April;15;2020-04-07 00:00;70;137;152;289
2020;April;15;2020-04-07 00:00;71;146;153;299
2020;April;15;2020-04-07 00:00;72;170;155;325
2020;April;15;2020-04-07 00:00;73;153;145;298
2020;April;15;2020-04-07 00:00;74;180;141;321
2020;April;15;2020-04-07 00:00;75;175;167;342
2020;April;15;2020-04-07 00:00;76;145;150;295
2020;April;15;2020-04-07 00:00;77;145;152;297
2020;April;15;2020-04-07 00:00;78;130;122;252
2020;April;15;2020-04-07 00:00;79;104;96;200
2020;April;15;2020-04-07 00:00;80;83;115;198
2020;April;15;2020-04-07 00:00;81;86;82;168
2020;April;15;2020-04-07 00:00;82;84;75;159
2020;April;15;2020-04-07 00:00;83;70;65;135
2020;April;15;2020-04-07 00:00;84;83;52;135
2020;April;15;2020-04-07 00:00;85;54;54;108
2020;April;15;2020-04-07 00:00;86;54;41;95
2020;April;15;2020-04-07 00:00;87;49;37;86
2020;April;15;2020-04-07 00:00;88;26;32;58
2020;April;15;2020-04-07 00:00;89;31;22;53
2020;April;15;2020-04-07 00:00;90;33;17;50
2020;April;15;2020-04-07 00:00;91;27;19;46
2020;April;15;2020-04-07 00:00;92;18;11;29
2020;April;15;2020-04-07 00:00;93;22;7;29
2020;April;15;2020-04-07 00:00;94;12;5;17
2020;April;15;2020-04-07 00:00;95;16;5;21
2020;April;15;2020-04-07 00:00;96;6;2;8
2020;April;15;2020-04-07 00:00;97;3;4;7
2020;April;15;2020-04-07 00:00;98;7;0;7
2020;April;15;2020-04-07 00:00;99;1;1;2
2020;April;15;2020-04-07 00:00;100;1;1;2
2020;April;15;2020-04-07 00:00;101;0;1;1
2020;April;15;2020-04-07 00:00;108;1;0;1
2020;April;16;2020-04-14 00:00;0;56;55;111
2020;April;16;2020-04-14 00:00;1;182;191;373
2020;April;16;2020-04-14 00:00;2;213;230;443
2020;April;16;2020-04-14 00:00;3;212;213;425
2020;April;16;2020-04-14 00:00;4;206;231;437
2020;April;16;2020-04-14 00:00;5;211;233;444
2020;April;16;2020-04-14 00:00;6;199;250;449
2020;April;16;2020-04-14 00:00;7;222;238;460
2020;April;16;2020-04-14 00:00;8;207;206;413
2020;April;16;2020-04-14 00:00;9;224;240;464
2020;April;16;2020-04-14 00:00;10;237;245;482
2020;April;16;2020-04-14 00:00;11;216;232;448
2020;April;16;2020-04-14 00:00;12;207;208;415
2020;April;16;2020-04-14 00:00;13;194;209;403
2020;April;16;2020-04-14 00:00;14;228;206;434
2020;April;16;2020-04-14 00:00;15;194;220;414
2020;April;16;2020-04-14 00:00;16;192;207;399
2020;April;16;2020-04-14 00:00;17;179;192;371
2020;April;16;2020-04-14 00:00;18;185;224;409
2020;April;16;2020-04-14 00:00;19;143;181;324
2020;April;16;2020-04-14 00:00;20;170;192;362
2020;April;16;2020-04-14 00:00;21;161;200;361
2020;April;16;2020-04-14 00:00;22;131;169;300
2020;April;16;2020-04-14 00:00;23;137;176;313
2020;April;16;2020-04-14 00:00;24;142;173;315
2020;April;16;2020-04-14 00:00;25;154;181;335
2020;April;16;2020-04-14 00:00;26;180;173;353
2020;April;16;2020-04-14 00:00;27;169;201;370
2020;April;16;2020-04-14 00:00;28;195;175;370
2020;April;16;2020-04-14 00:00;29;190;234;424
2020;April;16;2020-04-14 00:00;30;231;220;451
2020;April;16;2020-04-14 00:00;31;195;221;416
2020;April;16;2020-04-14 00:00;32;211;207;418
2020;April;16;2020-04-14 00:00;33;230;221;451
2020;April;16;2020-04-14 00:00;34;197;210;407
2020;April;16;2020-04-14 00:00;35;210;228;438
2020;April;16;2020-04-14 00:00;36;213;214;427
2020;April;16;2020-04-14 00:00;37;223;191;414
2020;April;16;2020-04-14 00:00;38;224;228;452
2020;April;16;2020-04-14 00:00;39;189;213;402
2020;April;16;2020-04-14 00:00;40;243;218;461
2020;April;16;2020-04-14 00:00;41;216;184;400
2020;April;16;2020-04-14 00:00;42;202;213;415
2020;April;16;2020-04-14 00:00;43;206;222;428
2020;April;16;2020-04-14 00:00;44;222;221;443
2020;April;16;2020-04-14 00:00;45;219;245;464
2020;April;16;2020-04-14 00:00;46;231;286;517
2020;April;16;2020-04-14 00:00;47;217;225;442
2020;April;16;2020-04-14 00:00;48;226;259;485
2020;April;16;2020-04-14 00:00;49;216;222;438
2020;April;16;2020-04-14 00:00;50;201;218;419
2020;April;16;2020-04-14 00:00;51;192;197;389
2020;April;16;2020-04-14 00:00;52;208;223;431
2020;April;16;2020-04-14 00:00;53;239;233;472
2020;April;16;2020-04-14 00:00;54;186;212;398
2020;April;16;2020-04-14 00:00;55;192;212;404
2020;April;16;2020-04-14 00:00;56;188;219;407
2020;April;16;2020-04-14 00:00;57;176;216;392
2020;April;16;2020-04-14 00:00;58;183;181;364
2020;April;16;2020-04-14 00:00;59;152;169;321
2020;April;16;2020-04-14 00:00;60;155;152;307
2020;April;16;2020-04-14 00:00;61;150;156;306
2020;April;16;2020-04-14 00:00;62;148;150;298
2020;April;16;2020-04-14 00:00;63;137;148;285
2020;April;16;2020-04-14 00:00;64;147;155;302
2020;April;16;2020-04-14 00:00;65;130;114;244
2020;April;16;2020-04-14 00:00;66;127;135;262
2020;April;16;2020-04-14 00:00;67;145;131;276
2020;April;16;2020-04-14 00:00;68;134;147;281
2020;April;16;2020-04-14 00:00;69;139;126;265
2020;April;16;2020-04-14 00:00;70;137;152;289
2020;April;16;2020-04-14 00:00;71;146;153;299
2020;April;16;2020-04-14 00:00;72;170;155;325
2020;April;16;2020-04-14 00:00;73;153;144;297
2020;April;16;2020-04-14 00:00;74;180;141;321
2020;April;16;2020-04-14 00:00;75;175;167;342
2020;April;16;2020-04-14 00:00;76;145;150;295
2020;April;16;2020-04-14 00:00;77;145;152;297
2020;April;16;2020-04-14 00:00;78;130;122;252
2020;April;16;2020-04-14 00:00;79;104;95;199
2020;April;16;2020-04-14 00:00;80;83;115;198
2020;April;16;2020-04-14 00:00;81;86;82;168
2020;April;16;2020-04-14 00:00;82;84;75;159
2020;April;16;2020-04-14 00:00;83;70;65;135
2020;April;16;2020-04-14 00:00;84;83;52;135
2020;April;16;2020-04-14 00:00;85;54;54;108
2020;April;16;2020-04-14 00:00;86;54;41;95
2020;April;16;2020-04-14 00:00;87;49;37;86
2020;April;16;2020-04-14 00:00;88;26;32;58
2020;April;16;2020-04-14 00:00;89;31;22;53
2020;April;16;2020-04-14 00:00;90;33;17;50
2020;April;16;2020-04-14 00:00;91;27;19;46
2020;April;16;2020-04-14 00:00;92;18;11;29
2020;April;16;2020-04-14 00:00;93;22;7;29
2020;April;16;2020-04-14 00:00;94;12;5;17
2020;April;16;2020-04-14 00:00;95;16;5;21
2020;April;16;2020-04-14 00:00;96;6;2;8
2020;April;16;2020-04-14 00:00;97;3;4;7
2020;April;16;2020-04-14 00:00;98;7;0;7
2020;April;16;2020-04-14 00:00;99;1;1;2
2020;April;16;2020-04-14 00:00;100;1;1;2
2020;April;16;2020-04-14 00:00;101;0;1;1
2020;April;16;2020-04-14 00:00;108;1;0;1
2020;April;17;2020-04-21 00:00;0;59;56;115
2020;April;17;2020-04-21 00:00;1;182;193;375
2020;April;17;2020-04-21 00:00;2;213;229;442
2020;April;17;2020-04-21 00:00;3;211;213;424
2020;April;17;2020-04-21 00:00;4;206;231;437
2020;April;17;2020-04-21 00:00;5;211;232;443
2020;April;17;2020-04-21 00:00;6;199;249;448
2020;April;17;2020-04-21 00:00;7;222;239;461
2020;April;17;2020-04-21 00:00;8;207;206;413
2020;April;17;2020-04-21 00:00;9;224;240;464
2020;April;17;2020-04-21 00:00;10;237;246;483
2020;April;17;2020-04-21 00:00;11;216;233;449
2020;April;17;2020-04-21 00:00;12;207;208;415
2020;April;17;2020-04-21 00:00;13;195;210;405
2020;April;17;2020-04-21 00:00;14;228;206;434
2020;April;17;2020-04-21 00:00;15;194;220;414
2020;April;17;2020-04-21 00:00;16;192;208;400
2020;April;17;2020-04-21 00:00;17;179;192;371
2020;April;17;2020-04-21 00:00;18;185;224;409
2020;April;17;2020-04-21 00:00;19;143;181;324
2020;April;17;2020-04-21 00:00;20;170;192;362
2020;April;17;2020-04-21 00:00;21;160;202;362
2020;April;17;2020-04-21 00:00;22;131;168;299
2020;April;17;2020-04-21 00:00;23;135;176;311
2020;April;17;2020-04-21 00:00;24;143;172;315
2020;April;17;2020-04-21 00:00;25;153;180;333
2020;April;17;2020-04-21 00:00;26;178;172;350
2020;April;17;2020-04-21 00:00;27;169;200;369
2020;April;17;2020-04-21 00:00;28;194;174;368
2020;April;17;2020-04-21 00:00;29;191;233;424
2020;April;17;2020-04-21 00:00;30;232;219;451
2020;April;17;2020-04-21 00:00;31;194;222;416
2020;April;17;2020-04-21 00:00;32;211;206;417
2020;April;17;2020-04-21 00:00;33;230;222;452
2020;April;17;2020-04-21 00:00;34;197;210;407
2020;April;17;2020-04-21 00:00;35;210;228;438
2020;April;17;2020-04-21 00:00;36;213;214;427
2020;April;17;2020-04-21 00:00;37;223;191;414
2020;April;17;2020-04-21 00:00;38;224;228;452
2020;April;17;2020-04-21 00:00;39;188;214;402
2020;April;17;2020-04-21 00:00;40;243;218;461
2020;April;17;2020-04-21 00:00;41;216;185;401
2020;April;17;2020-04-21 00:00;42;202;212;414
2020;April;17;2020-04-21 00:00;43;206;223;429
2020;April;17;2020-04-21 00:00;44;223;221;444
2020;April;17;2020-04-21 00:00;45;219;245;464
2020;April;17;2020-04-21 00:00;46;231;286;517
2020;April;17;2020-04-21 00:00;47;217;225;442
2020;April;17;2020-04-21 00:00;48;226;259;485
2020;April;17;2020-04-21 00:00;49;216;221;437
2020;April;17;2020-04-21 00:00;50;200;218;418
2020;April;17;2020-04-21 00:00;51;192;196;388
2020;April;17;2020-04-21 00:00;52;208;223;431
2020;April;17;2020-04-21 00:00;53;239;233;472
2020;April;17;2020-04-21 00:00;54;187;213;400
2020;April;17;2020-04-21 00:00;55;191;213;404
2020;April;17;2020-04-21 00:00;56;188;219;407
2020;April;17;2020-04-21 00:00;57;176;216;392
2020;April;17;2020-04-21 00:00;58;183;181;364
2020;April;17;2020-04-21 00:00;59;152;169;321
2020;April;17;2020-04-21 00:00;60;155;151;306
2020;April;17;2020-04-21 00:00;61;150;156;306
2020;April;17;2020-04-21 00:00;62;148;150;298
2020;April;17;2020-04-21 00:00;63;137;148;285
2020;April;17;2020-04-21 00:00;64;147;155;302
2020;April;17;2020-04-21 00:00;65;130;114;244
2020;April;17;2020-04-21 00:00;66;127;135;262
2020;April;17;2020-04-21 00:00;67;145;131;276
2020;April;17;2020-04-21 00:00;68;134;147;281
2020;April;17;2020-04-21 00:00;69;139;126;265
2020;April;17;2020-04-21 00:00;70;137;152;289
2020;April;17;2020-04-21 00:00;71;146;152;298
2020;April;17;2020-04-21 00:00;72;170;155;325
2020;April;17;2020-04-21 00:00;73;153;144;297
2020;April;17;2020-04-21 00:00;74;180;141;321
2020;April;17;2020-04-21 00:00;75;175;167;342
2020;April;17;2020-04-21 00:00;76;145;150;295
2020;April;17;2020-04-21 00:00;77;145;152;297
2020;April;17;2020-04-21 00:00;78;130;120;250
2020;April;17;2020-04-21 00:00;79;104;94;198
2020;April;17;2020-04-21 00:00;80;82;115;197
2020;April;17;2020-04-21 00:00;81;85;82;167
2020;April;17;2020-04-21 00:00;82;84;75;159
2020;April;17;2020-04-21 00:00;83;70;65;135
2020;April;17;2020-04-21 00:00;84;82;52;134
2020;April;17;2020-04-21 00:00;85;54;54;108
2020;April;17;2020-04-21 00:00;86;54;41;95
2020;April;17;2020-04-21 00:00;87;49;36;85
2020;April;17;2020-04-21 00:00;88;26;32;58
2020;April;17;2020-04-21 00:00;89;31;22;53
2020;April;17;2020-04-21 00:00;90;33;17;50
2020;April;17;2020-04-21 00:00;91;27;18;45
2020;April;17;2020-04-21 00:00;92;18;11;29
2020;April;17;2020-04-21 00:00;93;22;7;29
2020;April;17;2020-04-21 00:00;94;12;5;17
2020;April;17;2020-04-21 00:00;95;16;5;21
2020;April;17;2020-04-21 00:00;96;6;2;8
2020;April;17;2020-04-21 00:00;97;3;4;7
2020;April;17;2020-04-21 00:00;98;7;0;7
2020;April;17;2020-04-21 00:00;99;1;1;2
2020;April;17;2020-04-21 00:00;100;1;1;2
2020;April;17;2020-04-21 00:00;101;0;1;1
2020;April;17;2020-04-21 00:00;108;1;0;1
2020;April;18;2020-04-28 00:00;0;60;58;118
2020;April;18;2020-04-28 00:00;1;182;193;375
2020;April;18;2020-04-28 00:00;2;213;228;441
2020;April;18;2020-04-28 00:00;3;211;212;423
2020;April;18;2020-04-28 00:00;4;207;231;438
2020;April;18;2020-04-28 00:00;5;211;231;442
2020;April;18;2020-04-28 00:00;6;199;249;448
2020;April;18;2020-04-28 00:00;7;223;239;462
2020;April;18;2020-04-28 00:00;8;206;206;412
2020;April;18;2020-04-28 00:00;9;224;240;464
2020;April;18;2020-04-28 00:00;10;237;246;483
2020;April;18;2020-04-28 00:00;11;216;233;449
2020;April;18;2020-04-28 00:00;12;207;209;416
2020;April;18;2020-04-28 00:00;13;196;210;406
2020;April;18;2020-04-28 00:00;14;228;206;434
2020;April;18;2020-04-28 00:00;15;194;220;414
2020;April;18;2020-04-28 00:00;16;192;208;400
2020;April;18;2020-04-28 00:00;17;179;192;371
2020;April;18;2020-04-28 00:00;18;186;224;410
2020;April;18;2020-04-28 00:00;19;142;181;323
2020;April;18;2020-04-28 00:00;20;170;192;362
2020;April;18;2020-04-28 00:00;21;162;202;364
2020;April;18;2020-04-28 00:00;22;132;167;299
2020;April;18;2020-04-28 00:00;23;137;176;313
2020;April;18;2020-04-28 00:00;24;144;172;316
2020;April;18;2020-04-28 00:00;25;153;180;333
2020;April;18;2020-04-28 00:00;26;177;172;349
2020;April;18;2020-04-28 00:00;27;169;201;370
2020;April;18;2020-04-28 00:00;28;192;173;365
2020;April;18;2020-04-28 00:00;29;191;232;423
2020;April;18;2020-04-28 00:00;30;232;219;451
2020;April;18;2020-04-28 00:00;31;194;222;416
2020;April;18;2020-04-28 00:00;32;212;205;417
2020;April;18;2020-04-28 00:00;33;230;222;452
2020;April;18;2020-04-28 00:00;34;196;211;407
2020;April;18;2020-04-28 00:00;35;211;227;438
2020;April;18;2020-04-28 00:00;36;213;214;427
2020;April;18;2020-04-28 00:00;37;223;191;414
2020;April;18;2020-04-28 00:00;38;223;228;451
2020;April;18;2020-04-28 00:00;39;188;214;402
2020;April;18;2020-04-28 00:00;40;243;219;462
2020;April;18;2020-04-28 00:00;41;216;185;401
2020;April;18;2020-04-28 00:00;42;201;212;413
2020;April;18;2020-04-28 00:00;43;206;223;429
2020;April;18;2020-04-28 00:00;44;223;221;444
2020;April;18;2020-04-28 00:00;45;219;246;465
2020;April;18;2020-04-28 00:00;46;231;287;518
2020;April;18;2020-04-28 00:00;47;217;225;442
2020;April;18;2020-04-28 00:00;48;226;259;485
2020;April;18;2020-04-28 00:00;49;216;221;437
2020;April;18;2020-04-28 00:00;50;200;218;418
2020;April;18;2020-04-28 00:00;51;192;196;388
2020;April;18;2020-04-28 00:00;52;208;223;431
2020;April;18;2020-04-28 00:00;53;239;233;472
2020;April;18;2020-04-28 00:00;54;186;213;399
2020;April;18;2020-04-28 00:00;55;191;213;404
2020;April;18;2020-04-28 00:00;56;189;219;408
2020;April;18;2020-04-28 00:00;57;177;216;393
2020;April;18;2020-04-28 00:00;58;183;181;364
2020;April;18;2020-04-28 00:00;59;152;169;321
2020;April;18;2020-04-28 00:00;60;155;151;306
2020;April;18;2020-04-28 00:00;61;150;156;306
2020;April;18;2020-04-28 00:00;62;148;150;298
2020;April;18;2020-04-28 00:00;63;137;148;285
2020;April;18;2020-04-28 00:00;64;147;155;302
2020;April;18;2020-04-28 00:00;65;130;113;243
2020;April;18;2020-04-28 00:00;66;127;135;262
2020;April;18;2020-04-28 00:00;67;145;131;276
2020;April;18;2020-04-28 00:00;68;134;147;281
2020;April;18;2020-04-28 00:00;69;139;126;265
2020;April;18;2020-04-28 00:00;70;137;152;289
2020;April;18;2020-04-28 00:00;71;146;152;298
2020;April;18;2020-04-28 00:00;72;170;155;325
2020;April;18;2020-04-28 00:00;73;153;144;297
2020;April;18;2020-04-28 00:00;74;180;140;320
2020;April;18;2020-04-28 00:00;75;175;167;342
2020;April;18;2020-04-28 00:00;76;145;150;295
2020;April;18;2020-04-28 00:00;77;145;152;297
2020;April;18;2020-04-28 00:00;78;130;120;250
2020;April;18;2020-04-28 00:00;79;103;93;196
2020;April;18;2020-04-28 00:00;80;82;115;197
2020;April;18;2020-04-28 00:00;81;84;82;166
2020;April;18;2020-04-28 00:00;82;84;74;158
2020;April;18;2020-04-28 00:00;83;70;65;135
2020;April;18;2020-04-28 00:00;84;82;52;134
2020;April;18;2020-04-28 00:00;85;54;54;108
2020;April;18;2020-04-28 00:00;86;54;41;95
2020;April;18;2020-04-28 00:00;87;49;36;85
2020;April;18;2020-04-28 00:00;88;26;31;57
2020;April;18;2020-04-28 00:00;89;31;22;53
2020;April;18;2020-04-28 00:00;90;33;17;50
2020;April;18;2020-04-28 00:00;91;27;18;45
2020;April;18;2020-04-28 00:00;92;17;11;28
2020;April;18;2020-04-28 00:00;93;22;7;29
2020;April;18;2020-04-28 00:00;94;12;5;17
2020;April;18;2020-04-28 00:00;95;16;5;21
2020;April;18;2020-04-28 00:00;96;6;2;8
2020;April;18;2020-04-28 00:00;97;3;4;7
2020;April;18;2020-04-28 00:00;98;7;0;7
2020;April;18;2020-04-28 00:00;99;1;1;2
2020;April;18;2020-04-28 00:00;100;1;1;2
2020;April;18;2020-04-28 00:00;101;0;1;1
2020;April;18;2020-04-28 00:00;108;1;0;1
2020;May;19;2020-05-05 00:00;0;65;63;128
2020;May;19;2020-05-05 00:00;1;182;193;375
2020;May;19;2020-05-05 00:00;2;212;229;441
2020;May;19;2020-05-05 00:00;3;210;213;423
2020;May;19;2020-05-05 00:00;4;206;232;438
2020;May;19;2020-05-05 00:00;5;210;231;441
2020;May;19;2020-05-05 00:00;6;198;249;447
2020;May;19;2020-05-05 00:00;7;224;238;462
2020;May;19;2020-05-05 00:00;8;206;206;412
2020;May;19;2020-05-05 00:00;9;224;240;464
2020;May;19;2020-05-05 00:00;10;237;245;482
2020;May;19;2020-05-05 00:00;11;216;233;449
2020;May;19;2020-05-05 00:00;12;207;209;416
2020;May;19;2020-05-05 00:00;13;195;210;405
2020;May;19;2020-05-05 00:00;14;228;206;434
2020;May;19;2020-05-05 00:00;15;194;220;414
2020;May;19;2020-05-05 00:00;16;192;208;400
2020;May;19;2020-05-05 00:00;17;178;192;370
2020;May;19;2020-05-05 00:00;18;185;224;409
2020;May;19;2020-05-05 00:00;19;143;181;324
2020;May;19;2020-05-05 00:00;20;168;193;361
2020;May;19;2020-05-05 00:00;21;163;203;366
2020;May;19;2020-05-05 00:00;22;133;168;301
2020;May;19;2020-05-05 00:00;23;137;175;312
2020;May;19;2020-05-05 00:00;24;145;172;317
2020;May;19;2020-05-05 00:00;25;154;180;334
2020;May;19;2020-05-05 00:00;26;177;173;350
2020;May;19;2020-05-05 00:00;27;167;202;369
2020;May;19;2020-05-05 00:00;28;192;173;365
2020;May;19;2020-05-05 00:00;29;191;232;423
2020;May;19;2020-05-05 00:00;30;233;219;452
2020;May;19;2020-05-05 00:00;31;194;226;420
2020;May;19;2020-05-05 00:00;32;213;207;420
2020;May;19;2020-05-05 00:00;33;230;221;451
2020;May;19;2020-05-05 00:00;34;195;209;404
2020;May;19;2020-05-05 00:00;35;213;227;440
2020;May;19;2020-05-05 00:00;36;213;215;428
2020;May;19;2020-05-05 00:00;37;224;190;414
2020;May;19;2020-05-05 00:00;38;223;227;450
2020;May;19;2020-05-05 00:00;39;188;215;403
2020;May;19;2020-05-05 00:00;40;243;220;463
2020;May;19;2020-05-05 00:00;41;216;184;400
2020;May;19;2020-05-05 00:00;42;201;212;413
2020;May;19;2020-05-05 00:00;43;206;223;429
2020;May;19;2020-05-05 00:00;44;222;221;443
2020;May;19;2020-05-05 00:00;45;219;247;466
2020;May;19;2020-05-05 00:00;46;231;287;518
2020;May;19;2020-05-05 00:00;47;218;225;443
2020;May;19;2020-05-05 00:00;48;226;261;487
2020;May;19;2020-05-05 00:00;49;215;222;437
2020;May;19;2020-05-05 00:00;50;201;218;419
2020;May;19;2020-05-05 00:00;51;192;195;387
2020;May;19;2020-05-05 00:00;52;208;223;431
2020;May;19;2020-05-05 00:00;53;239;232;471
2020;May;19;2020-05-05 00:00;54;185;213;398
2020;May;19;2020-05-05 00:00;55;189;213;402
2020;May;19;2020-05-05 00:00;56;189;219;408
2020;May;19;2020-05-05 00:00;57;178;216;394
2020;May;19;2020-05-05 00:00;58;183;181;364
2020;May;19;2020-05-05 00:00;59;152;169;321
2020;May;19;2020-05-05 00:00;60;155;150;305
2020;May;19;2020-05-05 00:00;61;150;157;307
2020;May;19;2020-05-05 00:00;62;148;150;298
2020;May;19;2020-05-05 00:00;63;137;148;285
2020;May;19;2020-05-05 00:00;64;147;155;302
2020;May;19;2020-05-05 00:00;65;129;113;242
2020;May;19;2020-05-05 00:00;66;127;135;262
2020;May;19;2020-05-05 00:00;67;146;131;277
2020;May;19;2020-05-05 00:00;68;134;147;281
2020;May;19;2020-05-05 00:00;69;139;126;265
2020;May;19;2020-05-05 00:00;70;137;152;289
2020;May;19;2020-05-05 00:00;71;146;152;298
2020;May;19;2020-05-05 00:00;72;170;155;325
2020;May;19;2020-05-05 00:00;73;153;144;297
2020;May;19;2020-05-05 00:00;74;180;140;320
2020;May;19;2020-05-05 00:00;75;175;167;342
2020;May;19;2020-05-05 00:00;76;145;150;295
2020;May;19;2020-05-05 00:00;77;145;152;297
2020;May;19;2020-05-05 00:00;78;130;120;250
2020;May;19;2020-05-05 00:00;79;104;94;198
2020;May;19;2020-05-05 00:00;80;82;115;197
2020;May;19;2020-05-05 00:00;81;83;82;165
2020;May;19;2020-05-05 00:00;82;84;74;158
2020;May;19;2020-05-05 00:00;83;70;65;135
2020;May;19;2020-05-05 00:00;84;82;52;134
2020;May;19;2020-05-05 00:00;85;54;54;108
2020;May;19;2020-05-05 00:00;86;54;41;95
2020;May;19;2020-05-05 00:00;87;49;37;86
2020;May;19;2020-05-05 00:00;88;26;31;57
2020;May;19;2020-05-05 00:00;89;31;22;53
2020;May;19;2020-05-05 00:00;90;32;17;49
2020;May;19;2020-05-05 00:00;91;27;18;45
2020;May;19;2020-05-05 00:00;92;17;11;28
2020;May;19;2020-05-05 00:00;93;22;7;29
2020;May;19;2020-05-05 00:00;94;12;5;17
2020;May;19;2020-05-05 00:00;95;16;5;21
2020;May;19;2020-05-05 00:00;96;6;2;8
2020;May;19;2020-05-05 00:00;97;3;4;7
2020;May;19;2020-05-05 00:00;98;7;0;7
2020;May;19;2020-05-05 00:00;99;1;1;2
2020;May;19;2020-05-05 00:00;100;1;1;2
2020;May;19;2020-05-05 00:00;101;0;1;1
2020;May;19;2020-05-05 00:00;108;1;0;1
2020;May;20;2020-05-12 00:00;0;70;65;135
2020;May;20;2020-05-12 00:00;1;183;194;377
2020;May;20;2020-05-12 00:00;2;212;230;442
2020;May;20;2020-05-12 00:00;3;210;213;423
2020;May;20;2020-05-12 00:00;4;206;232;438
2020;May;20;2020-05-12 00:00;5;210;231;441
2020;May;20;2020-05-12 00:00;6;199;250;449
2020;May;20;2020-05-12 00:00;7;224;238;462
2020;May;20;2020-05-12 00:00;8;206;207;413
2020;May;20;2020-05-12 00:00;9;224;240;464
2020;May;20;2020-05-12 00:00;10;237;245;482
2020;May;20;2020-05-12 00:00;11;217;233;450
2020;May;20;2020-05-12 00:00;12;207;209;416
2020;May;20;2020-05-12 00:00;13;195;210;405
2020;May;20;2020-05-12 00:00;14;228;207;435
2020;May;20;2020-05-12 00:00;15;194;220;414
2020;May;20;2020-05-12 00:00;16;192;209;401
2020;May;20;2020-05-12 00:00;17;177;192;369
2020;May;20;2020-05-12 00:00;18;185;224;409
2020;May;20;2020-05-12 00:00;19;143;179;322
2020;May;20;2020-05-12 00:00;20;169;194;363
2020;May;20;2020-05-12 00:00;21;164;204;368
2020;May;20;2020-05-12 00:00;22;133;168;301
2020;May;20;2020-05-12 00:00;23;138;176;314
2020;May;20;2020-05-12 00:00;24;146;172;318
2020;May;20;2020-05-12 00:00;25;156;181;337
2020;May;20;2020-05-12 00:00;26;178;173;351
2020;May;20;2020-05-12 00:00;27;167;200;367
2020;May;20;2020-05-12 00:00;28;192;173;365
2020;May;20;2020-05-12 00:00;29;192;234;426
2020;May;20;2020-05-12 00:00;30;234;218;452
2020;May;20;2020-05-12 00:00;31;194;228;422
2020;May;20;2020-05-12 00:00;32;214;208;422
2020;May;20;2020-05-12 00:00;33;230;221;451
2020;May;20;2020-05-12 00:00;34;195;209;404
2020;May;20;2020-05-12 00:00;35;213;227;440
2020;May;20;2020-05-12 00:00;36;213;214;427
2020;May;20;2020-05-12 00:00;37;224;191;415
2020;May;20;2020-05-12 00:00;38;224;227;451
2020;May;20;2020-05-12 00:00;39;188;216;404
2020;May;20;2020-05-12 00:00;40;243;220;463
2020;May;20;2020-05-12 00:00;41;216;185;401
2020;May;20;2020-05-12 00:00;42;201;212;413
2020;May;20;2020-05-12 00:00;43;206;223;429
2020;May;20;2020-05-12 00:00;44;221;221;442
2020;May;20;2020-05-12 00:00;45;219;246;465
2020;May;20;2020-05-12 00:00;46;230;286;516
2020;May;20;2020-05-12 00:00;47;218;225;443
2020;May;20;2020-05-12 00:00;48;226;261;487
2020;May;20;2020-05-12 00:00;49;215;222;437
2020;May;20;2020-05-12 00:00;50;201;218;419
2020;May;20;2020-05-12 00:00;51;193;195;388
2020;May;20;2020-05-12 00:00;52;208;223;431
2020;May;20;2020-05-12 00:00;53;239;231;470
2020;May;20;2020-05-12 00:00;54;185;213;398
2020;May;20;2020-05-12 00:00;55;189;213;402
2020;May;20;2020-05-12 00:00;56;188;219;407
2020;May;20;2020-05-12 00:00;57;178;215;393
2020;May;20;2020-05-12 00:00;58;183;180;363
2020;May;20;2020-05-12 00:00;59;153;168;321
2020;May;20;2020-05-12 00:00;60;155;150;305
2020;May;20;2020-05-12 00:00;61;150;157;307
2020;May;20;2020-05-12 00:00;62;148;150;298
2020;May;20;2020-05-12 00:00;63;137;148;285
2020;May;20;2020-05-12 00:00;64;147;155;302
2020;May;20;2020-05-12 00:00;65;129;113;242
2020;May;20;2020-05-12 00:00;66;127;135;262
2020;May;20;2020-05-12 00:00;67;146;131;277
2020;May;20;2020-05-12 00:00;68;134;147;281
2020;May;20;2020-05-12 00:00;69;139;126;265
2020;May;20;2020-05-12 00:00;70;137;152;289
2020;May;20;2020-05-12 00:00;71;146;152;298
2020;May;20;2020-05-12 00:00;72;170;155;325
2020;May;20;2020-05-12 00:00;73;153;144;297
2020;May;20;2020-05-12 00:00;74;180;140;320
2020;May;20;2020-05-12 00:00;75;175;167;342
2020;May;20;2020-05-12 00:00;76;145;150;295
2020;May;20;2020-05-12 00:00;77;145;151;296
2020;May;20;2020-05-12 00:00;78;131;121;252
2020;May;20;2020-05-12 00:00;79;104;94;198
2020;May;20;2020-05-12 00:00;80;82;115;197
2020;May;20;2020-05-12 00:00;81;83;82;165
2020;May;20;2020-05-12 00:00;82;84;74;158
2020;May;20;2020-05-12 00:00;83;70;65;135
2020;May;20;2020-05-12 00:00;84;82;52;134
2020;May;20;2020-05-12 00:00;85;54;54;108
2020;May;20;2020-05-12 00:00;86;54;41;95
2020;May;20;2020-05-12 00:00;87;49;37;86
2020;May;20;2020-05-12 00:00;88;26;30;56
2020;May;20;2020-05-12 00:00;89;31;22;53
2020;May;20;2020-05-12 00:00;90;32;17;49
2020;May;20;2020-05-12 00:00;91;27;18;45
2020;May;20;2020-05-12 00:00;92;16;11;27
2020;May;20;2020-05-12 00:00;93;22;7;29
2020;May;20;2020-05-12 00:00;94;12;5;17
2020;May;20;2020-05-12 00:00;95;16;5;21
2020;May;20;2020-05-12 00:00;96;6;2;8
2020;May;20;2020-05-12 00:00;97;3;4;7
2020;May;20;2020-05-12 00:00;98;7;0;7
2020;May;20;2020-05-12 00:00;99;1;1;2
2020;May;20;2020-05-12 00:00;100;1;1;2
2020;May;20;2020-05-12 00:00;101;0;1;1
2020;May;20;2020-05-12 00:00;108;1;0;1
2020;May;21;2020-05-19 00:00;0;76;67;143
2020;May;21;2020-05-19 00:00;1;183;194;377
2020;May;21;2020-05-19 00:00;2;211;230;441
2020;May;21;2020-05-19 00:00;3;211;213;424
2020;May;21;2020-05-19 00:00;4;206;232;438
2020;May;21;2020-05-19 00:00;5;210;232;442
2020;May;21;2020-05-19 00:00;6;199;250;449
2020;May;21;2020-05-19 00:00;7;224;238;462
2020;May;21;2020-05-19 00:00;8;206;207;413
2020;May;21;2020-05-19 00:00;9;224;240;464
2020;May;21;2020-05-19 00:00;10;237;245;482
2020;May;21;2020-05-19 00:00;11;217;233;450
2020;May;21;2020-05-19 00:00;12;207;209;416
2020;May;21;2020-05-19 00:00;13;195;210;405
2020;May;21;2020-05-19 00:00;14;228;207;435
2020;May;21;2020-05-19 00:00;15;194;220;414
2020;May;21;2020-05-19 00:00;16;192;209;401
2020;May;21;2020-05-19 00:00;17;177;193;370
2020;May;21;2020-05-19 00:00;18;185;224;409
2020;May;21;2020-05-19 00:00;19;143;180;323
2020;May;21;2020-05-19 00:00;20;169;194;363
2020;May;21;2020-05-19 00:00;21;164;205;369
2020;May;21;2020-05-19 00:00;22;133;168;301
2020;May;21;2020-05-19 00:00;23;138;174;312
2020;May;21;2020-05-19 00:00;24;148;171;319
2020;May;21;2020-05-19 00:00;25;157;183;340
2020;May;21;2020-05-19 00:00;26;179;174;353
2020;May;21;2020-05-19 00:00;27;165;199;364
2020;May;21;2020-05-19 00:00;28;191;174;365
2020;May;21;2020-05-19 00:00;29;194;232;426
2020;May;21;2020-05-19 00:00;30;234;220;454
2020;May;21;2020-05-19 00:00;31;197;227;424
2020;May;21;2020-05-19 00:00;32;214;209;423
2020;May;21;2020-05-19 00:00;33;228;222;450
2020;May;21;2020-05-19 00:00;34;195;208;403
2020;May;21;2020-05-19 00:00;35;213;227;440
2020;May;21;2020-05-19 00:00;36;212;214;426
2020;May;21;2020-05-19 00:00;37;224;191;415
2020;May;21;2020-05-19 00:00;38;224;228;452
2020;May;21;2020-05-19 00:00;39;188;216;404
2020;May;21;2020-05-19 00:00;40;243;220;463
2020;May;21;2020-05-19 00:00;41;216;185;401
2020;May;21;2020-05-19 00:00;42;201;212;413
2020;May;21;2020-05-19 00:00;43;206;223;429
2020;May;21;2020-05-19 00:00;44;222;221;443
2020;May;21;2020-05-19 00:00;45;219;246;465
2020;May;21;2020-05-19 00:00;46;230;285;515
2020;May;21;2020-05-19 00:00;47;218;226;444
2020;May;21;2020-05-19 00:00;48;226;261;487
2020;May;21;2020-05-19 00:00;49;215;222;437
2020;May;21;2020-05-19 00:00;50;201;218;419
2020;May;21;2020-05-19 00:00;51;193;194;387
2020;May;21;2020-05-19 00:00;52;208;223;431
2020;May;21;2020-05-19 00:00;53;239;231;470
2020;May;21;2020-05-19 00:00;54;185;213;398
2020;May;21;2020-05-19 00:00;55;191;213;404
2020;May;21;2020-05-19 00:00;56;188;219;407
2020;May;21;2020-05-19 00:00;57;179;215;394
2020;May;21;2020-05-19 00:00;58;183;180;363
2020;May;21;2020-05-19 00:00;59;153;168;321
2020;May;21;2020-05-19 00:00;60;155;150;305
2020;May;21;2020-05-19 00:00;61;150;157;307
2020;May;21;2020-05-19 00:00;62;147;150;297
2020;May;21;2020-05-19 00:00;63;137;148;285
2020;May;21;2020-05-19 00:00;64;146;155;301
2020;May;21;2020-05-19 00:00;65;129;113;242
2020;May;21;2020-05-19 00:00;66;127;135;262
2020;May;21;2020-05-19 00:00;67;146;130;276
2020;May;21;2020-05-19 00:00;68;134;147;281
2020;May;21;2020-05-19 00:00;69;140;126;266
2020;May;21;2020-05-19 00:00;70;137;152;289
2020;May;21;2020-05-19 00:00;71;146;152;298
2020;May;21;2020-05-19 00:00;72;170;155;325
2020;May;21;2020-05-19 00:00;73;153;144;297
2020;May;21;2020-05-19 00:00;74;179;140;319
2020;May;21;2020-05-19 00:00;75;175;167;342
2020;May;21;2020-05-19 00:00;76;145;150;295
2020;May;21;2020-05-19 00:00;77;145;151;296
2020;May;21;2020-05-19 00:00;78;131;121;252
2020;May;21;2020-05-19 00:00;79;104;94;198
2020;May;21;2020-05-19 00:00;80;82;115;197
2020;May;21;2020-05-19 00:00;81;83;82;165
2020;May;21;2020-05-19 00:00;82;84;74;158
2020;May;21;2020-05-19 00:00;83;70;65;135
2020;May;21;2020-05-19 00:00;84;82;52;134
2020;May;21;2020-05-19 00:00;85;53;54;107
2020;May;21;2020-05-19 00:00;86;54;41;95
2020;May;21;2020-05-19 00:00;87;49;37;86
2020;May;21;2020-05-19 00:00;88;26;30;56
2020;May;21;2020-05-19 00:00;89;31;22;53
2020;May;21;2020-05-19 00:00;90;32;17;49
2020;May;21;2020-05-19 00:00;91;27;18;45
2020;May;21;2020-05-19 00:00;92;16;11;27
2020;May;21;2020-05-19 00:00;93;22;7;29
2020;May;21;2020-05-19 00:00;94;12;5;17
2020;May;21;2020-05-19 00:00;95;16;4;20
2020;May;21;2020-05-19 00:00;96;6;2;8
2020;May;21;2020-05-19 00:00;97;3;4;7
2020;May;21;2020-05-19 00:00;98;7;0;7
2020;May;21;2020-05-19 00:00;99;1;1;2
2020;May;21;2020-05-19 00:00;100;1;1;2
2020;May;21;2020-05-19 00:00;101;0;1;1
2020;May;21;2020-05-19 00:00;108;1;0;1
2020;May;22;2020-05-26 00:00;0;80;70;150
2020;May;22;2020-05-26 00:00;1;185;194;379
2020;May;22;2020-05-26 00:00;2;211;229;440
2020;May;22;2020-05-26 00:00;3;211;213;424
2020;May;22;2020-05-26 00:00;4;206;232;438
2020;May;22;2020-05-26 00:00;5;209;232;441
2020;May;22;2020-05-26 00:00;6;199;250;449
2020;May;22;2020-05-26 00:00;7;224;238;462
2020;May;22;2020-05-26 00:00;8;206;207;413
2020;May;22;2020-05-26 00:00;9;224;240;464
2020;May;22;2020-05-26 00:00;10;237;244;481
2020;May;22;2020-05-26 00:00;11;217;233;450
2020;May;22;2020-05-26 00:00;12;207;208;415
2020;May;22;2020-05-26 00:00;13;195;210;405
2020;May;22;2020-05-26 00:00;14;228;207;435
2020;May;22;2020-05-26 00:00;15;194;220;414
2020;May;22;2020-05-26 00:00;16;192;209;401
2020;May;22;2020-05-26 00:00;17;177;193;370
2020;May;22;2020-05-26 00:00;18;185;224;409
2020;May;22;2020-05-26 00:00;19;143;180;323
2020;May;22;2020-05-26 00:00;20;169;195;364
2020;May;22;2020-05-26 00:00;21;163;205;368
2020;May;22;2020-05-26 00:00;22;132;167;299
2020;May;22;2020-05-26 00:00;23;138;174;312
2020;May;22;2020-05-26 00:00;24;148;171;319
2020;May;22;2020-05-26 00:00;25;157;184;341
2020;May;22;2020-05-26 00:00;26;179;175;354
2020;May;22;2020-05-26 00:00;27;165;199;364
2020;May;22;2020-05-26 00:00;28;191;176;367
2020;May;22;2020-05-26 00:00;29;194;232;426
2020;May;22;2020-05-26 00:00;30;233;220;453
2020;May;22;2020-05-26 00:00;31;199;228;427
2020;May;22;2020-05-26 00:00;32;215;210;425
2020;May;22;2020-05-26 00:00;33;228;221;449
2020;May;22;2020-05-26 00:00;34;195;208;403
2020;May;22;2020-05-26 00:00;35;213;227;440
2020;May;22;2020-05-26 00:00;36;211;214;425
2020;May;22;2020-05-26 00:00;37;224;191;415
2020;May;22;2020-05-26 00:00;38;224;227;451
2020;May;22;2020-05-26 00:00;39;189;216;405
2020;May;22;2020-05-26 00:00;40;243;220;463
2020;May;22;2020-05-26 00:00;41;215;185;400
2020;May;22;2020-05-26 00:00;42;201;212;413
2020;May;22;2020-05-26 00:00;43;206;223;429
2020;May;22;2020-05-26 00:00;44;222;221;443
2020;May;22;2020-05-26 00:00;45;219;247;466
2020;May;22;2020-05-26 00:00;46;230;285;515
2020;May;22;2020-05-26 00:00;47;218;226;444
2020;May;22;2020-05-26 00:00;48;226;261;487
2020;May;22;2020-05-26 00:00;49;215;222;437
2020;May;22;2020-05-26 00:00;50;201;218;419
2020;May;22;2020-05-26 00:00;51;193;194;387
2020;May;22;2020-05-26 00:00;52;209;223;432
2020;May;22;2020-05-26 00:00;53;239;231;470
2020;May;22;2020-05-26 00:00;54;185;213;398
2020;May;22;2020-05-26 00:00;55;191;213;404
2020;May;22;2020-05-26 00:00;56;188;220;408
2020;May;22;2020-05-26 00:00;57;178;215;393
2020;May;22;2020-05-26 00:00;58;182;180;362
2020;May;22;2020-05-26 00:00;59;153;167;320
2020;May;22;2020-05-26 00:00;60;155;150;305
2020;May;22;2020-05-26 00:00;61;150;157;307
2020;May;22;2020-05-26 00:00;62;147;150;297
2020;May;22;2020-05-26 00:00;63;137;148;285
2020;May;22;2020-05-26 00:00;64;146;155;301
2020;May;22;2020-05-26 00:00;65;129;113;242
2020;May;22;2020-05-26 00:00;66;127;135;262
2020;May;22;2020-05-26 00:00;67;146;130;276
2020;May;22;2020-05-26 00:00;68;133;147;280
2020;May;22;2020-05-26 00:00;69;140;126;266
2020;May;22;2020-05-26 00:00;70;137;152;289
2020;May;22;2020-05-26 00:00;71;146;152;298
2020;May;22;2020-05-26 00:00;72;170;155;325
2020;May;22;2020-05-26 00:00;73;153;143;296
2020;May;22;2020-05-26 00:00;74;179;140;319
2020;May;22;2020-05-26 00:00;75;175;167;342
2020;May;22;2020-05-26 00:00;76;145;148;293
2020;May;22;2020-05-26 00:00;77;145;151;296
2020;May;22;2020-05-26 00:00;78;131;121;252
2020;May;22;2020-05-26 00:00;79;104;94;198
2020;May;22;2020-05-26 00:00;80;82;115;197
2020;May;22;2020-05-26 00:00;81;83;82;165
2020;May;22;2020-05-26 00:00;82;84;74;158
2020;May;22;2020-05-26 00:00;83;69;65;134
2020;May;22;2020-05-26 00:00;84;82;52;134
2020;May;22;2020-05-26 00:00;85;53;54;107
2020;May;22;2020-05-26 00:00;86;54;41;95
2020;May;22;2020-05-26 00:00;87;49;37;86
2020;May;22;2020-05-26 00:00;88;26;30;56
2020;May;22;2020-05-26 00:00;89;31;22;53
2020;May;22;2020-05-26 00:00;90;32;17;49
2020;May;22;2020-05-26 00:00;91;27;18;45
2020;May;22;2020-05-26 00:00;92;16;11;27
2020;May;22;2020-05-26 00:00;93;22;7;29
2020;May;22;2020-05-26 00:00;94;12;5;17
2020;May;22;2020-05-26 00:00;95;16;4;20
2020;May;22;2020-05-26 00:00;96;6;2;8
2020;May;22;2020-05-26 00:00;97;3;4;7
2020;May;22;2020-05-26 00:00;98;7;0;7
2020;May;22;2020-05-26 00:00;99;1;1;2
2020;May;22;2020-05-26 00:00;100;1;1;2
2020;May;22;2020-05-26 00:00;101;0;1;1
2020;May;22;2020-05-26 00:00;108;1;0;1
2020;June;23;2020-06-02 00:00;0;87;73;160
2020;June;23;2020-06-02 00:00;1;187;197;384
2020;June;23;2020-06-02 00:00;2;213;231;444
2020;June;23;2020-06-02 00:00;3;211;212;423
2020;June;23;2020-06-02 00:00;4;208;233;441
2020;June;23;2020-06-02 00:00;5;211;233;444
2020;June;23;2020-06-02 00:00;6;201;251;452
2020;June;23;2020-06-02 00:00;7;224;239;463
2020;June;23;2020-06-02 00:00;8;206;206;412
2020;June;23;2020-06-02 00:00;9;226;240;466
2020;June;23;2020-06-02 00:00;10;237;242;479
2020;June;23;2020-06-02 00:00;11;216;233;449
2020;June;23;2020-06-02 00:00;12;207;207;414
2020;June;23;2020-06-02 00:00;13;195;210;405
2020;June;23;2020-06-02 00:00;14;228;208;436
2020;June;23;2020-06-02 00:00;15;194;221;415
2020;June;23;2020-06-02 00:00;16;192;209;401
2020;June;23;2020-06-02 00:00;17;177;193;370
2020;June;23;2020-06-02 00:00;18;185;224;409
2020;June;23;2020-06-02 00:00;19;144;180;324
2020;June;23;2020-06-02 00:00;20;168;195;363
2020;June;23;2020-06-02 00:00;21;162;206;368
2020;June;23;2020-06-02 00:00;22;132;168;300
2020;June;23;2020-06-02 00:00;23;139;176;315
2020;June;23;2020-06-02 00:00;24;145;169;314
2020;June;23;2020-06-02 00:00;25;158;184;342
2020;June;23;2020-06-02 00:00;26;180;177;357
2020;June;23;2020-06-02 00:00;27;169;199;368
2020;June;23;2020-06-02 00:00;28;199;177;376
2020;June;23;2020-06-02 00:00;29;198;234;432
2020;June;23;2020-06-02 00:00;30;234;226;460
2020;June;23;2020-06-02 00:00;31;199;227;426
2020;June;23;2020-06-02 00:00;32;217;214;431
2020;June;23;2020-06-02 00:00;33;228;224;452
2020;June;23;2020-06-02 00:00;34;196;208;404
2020;June;23;2020-06-02 00:00;35;213;226;439
2020;June;23;2020-06-02 00:00;36;211;217;428
2020;June;23;2020-06-02 00:00;37;224;191;415
2020;June;23;2020-06-02 00:00;38;225;225;450
2020;June;23;2020-06-02 00:00;39;189;218;407
2020;June;23;2020-06-02 00:00;40;242;221;463
2020;June;23;2020-06-02 00:00;41;215;185;400
2020;June;23;2020-06-02 00:00;42;202;212;414
2020;June;23;2020-06-02 00:00;43;206;222;428
2020;June;23;2020-06-02 00:00;44;222;222;444
2020;June;23;2020-06-02 00:00;45;219;247;466
2020;June;23;2020-06-02 00:00;46;230;284;514
2020;June;23;2020-06-02 00:00;47;216;227;443
2020;June;23;2020-06-02 00:00;48;225;261;486
2020;June;23;2020-06-02 00:00;49;215;221;436
2020;June;23;2020-06-02 00:00;50;201;218;419
2020;June;23;2020-06-02 00:00;51;194;194;388
2020;June;23;2020-06-02 00:00;52;208;222;430
2020;June;23;2020-06-02 00:00;53;239;231;470
2020;June;23;2020-06-02 00:00;54;186;213;399
2020;June;23;2020-06-02 00:00;55;190;212;402
2020;June;23;2020-06-02 00:00;56;187;220;407
2020;June;23;2020-06-02 00:00;57;179;215;394
2020;June;23;2020-06-02 00:00;58;182;180;362
2020;June;23;2020-06-02 00:00;59;153;167;320
2020;June;23;2020-06-02 00:00;60;154;150;304
2020;June;23;2020-06-02 00:00;61;150;157;307
2020;June;23;2020-06-02 00:00;62;147;149;296
2020;June;23;2020-06-02 00:00;63;137;148;285
2020;June;23;2020-06-02 00:00;64;147;155;302
2020;June;23;2020-06-02 00:00;65;129;114;243
2020;June;23;2020-06-02 00:00;66;127;136;263
2020;June;23;2020-06-02 00:00;67;146;130;276
2020;June;23;2020-06-02 00:00;68;133;147;280
2020;June;23;2020-06-02 00:00;69;140;126;266
2020;June;23;2020-06-02 00:00;70;137;151;288
2020;June;23;2020-06-02 00:00;71;146;152;298
2020;June;23;2020-06-02 00:00;72;170;155;325
2020;June;23;2020-06-02 00:00;73;153;143;296
2020;June;23;2020-06-02 00:00;74;179;140;319
2020;June;23;2020-06-02 00:00;75;174;167;341
2020;June;23;2020-06-02 00:00;76;145;148;293
2020;June;23;2020-06-02 00:00;77;145;151;296
2020;June;23;2020-06-02 00:00;78;130;121;251
2020;June;23;2020-06-02 00:00;79;104;94;198
2020;June;23;2020-06-02 00:00;80;82;115;197
2020;June;23;2020-06-02 00:00;81;83;82;165
2020;June;23;2020-06-02 00:00;82;84;74;158
2020;June;23;2020-06-02 00:00;83;69;65;134
2020;June;23;2020-06-02 00:00;84;82;52;134
2020;June;23;2020-06-02 00:00;85;53;54;107
2020;June;23;2020-06-02 00:00;86;53;39;92
2020;June;23;2020-06-02 00:00;87;49;37;86
2020;June;23;2020-06-02 00:00;88;26;30;56
2020;June;23;2020-06-02 00:00;89;30;21;51
2020;June;23;2020-06-02 00:00;90;32;17;49
2020;June;23;2020-06-02 00:00;91;27;18;45
2020;June;23;2020-06-02 00:00;92;16;11;27
2020;June;23;2020-06-02 00:00;93;22;7;29
2020;June;23;2020-06-02 00:00;94;12;5;17
2020;June;23;2020-06-02 00:00;95;16;4;20
2020;June;23;2020-06-02 00:00;96;6;2;8
2020;June;23;2020-06-02 00:00;97;3;4;7
2020;June;23;2020-06-02 00:00;98;7;0;7
2020;June;23;2020-06-02 00:00;99;1;1;2
2020;June;23;2020-06-02 00:00;100;1;1;2
2020;June;23;2020-06-02 00:00;101;0;1;1
2020;June;23;2020-06-02 00:00;108;1;0;1
2020;June;24;2020-06-09 00:00;0;95;73;168
2020;June;24;2020-06-09 00:00;1;187;197;384
2020;June;24;2020-06-09 00:00;2;212;231;443
2020;June;24;2020-06-09 00:00;3;212;214;426
2020;June;24;2020-06-09 00:00;4;207;234;441
2020;June;24;2020-06-09 00:00;5;211;233;444
2020;June;24;2020-06-09 00:00;6;201;250;451
2020;June;24;2020-06-09 00:00;7;224;239;463
2020;June;24;2020-06-09 00:00;8;207;206;413
2020;June;24;2020-06-09 00:00;9;226;240;466
2020;June;24;2020-06-09 00:00;10;237;242;479
2020;June;24;2020-06-09 00:00;11;216;233;449
2020;June;24;2020-06-09 00:00;12;207;206;413
2020;June;24;2020-06-09 00:00;13;195;210;405
2020;June;24;2020-06-09 00:00;14;228;208;436
2020;June;24;2020-06-09 00:00;15;194;221;415
2020;June;24;2020-06-09 00:00;16;191;209;400
2020;June;24;2020-06-09 00:00;17;178;193;371
2020;June;24;2020-06-09 00:00;18;186;224;410
2020;June;24;2020-06-09 00:00;19;144;180;324
2020;June;24;2020-06-09 00:00;20;168;194;362
2020;June;24;2020-06-09 00:00;21;162;204;366
2020;June;24;2020-06-09 00:00;22;134;168;302
2020;June;24;2020-06-09 00:00;23;140;177;317
2020;June;24;2020-06-09 00:00;24;145;170;315
2020;June;24;2020-06-09 00:00;25;158;185;343
2020;June;24;2020-06-09 00:00;26;180;176;356
2020;June;24;2020-06-09 00:00;27;170;199;369
2020;June;24;2020-06-09 00:00;28;200;178;378
2020;June;24;2020-06-09 00:00;29;199;238;437
2020;June;24;2020-06-09 00:00;30;236;227;463
2020;June;24;2020-06-09 00:00;31;200;229;429
2020;June;24;2020-06-09 00:00;32;216;214;430
2020;June;24;2020-06-09 00:00;33;229;225;454
2020;June;24;2020-06-09 00:00;34;196;208;404
2020;June;24;2020-06-09 00:00;35;212;227;439
2020;June;24;2020-06-09 00:00;36;211;219;430
2020;June;24;2020-06-09 00:00;37;224;190;414
2020;June;24;2020-06-09 00:00;38;225;226;451
2020;June;24;2020-06-09 00:00;39;189;218;407
2020;June;24;2020-06-09 00:00;40;243;221;464
2020;June;24;2020-06-09 00:00;41;215;184;399
2020;June;24;2020-06-09 00:00;42;202;212;414
2020;June;24;2020-06-09 00:00;43;206;222;428
2020;June;24;2020-06-09 00:00;44;220;222;442
2020;June;24;2020-06-09 00:00;45;219;247;466
2020;June;24;2020-06-09 00:00;46;231;285;516
2020;June;24;2020-06-09 00:00;47;216;227;443
2020;June;24;2020-06-09 00:00;48;225;261;486
2020;June;24;2020-06-09 00:00;49;215;221;436
2020;June;24;2020-06-09 00:00;50;201;218;419
2020;June;24;2020-06-09 00:00;51;194;195;389
2020;June;24;2020-06-09 00:00;52;208;223;431
2020;June;24;2020-06-09 00:00;53;240;231;471
2020;June;24;2020-06-09 00:00;54;186;213;399
2020;June;24;2020-06-09 00:00;55;190;212;402
2020;June;24;2020-06-09 00:00;56;187;219;406
2020;June;24;2020-06-09 00:00;57;179;214;393
2020;June;24;2020-06-09 00:00;58;182;179;361
2020;June;24;2020-06-09 00:00;59;153;166;319
2020;June;24;2020-06-09 00:00;60;154;150;304
2020;June;24;2020-06-09 00:00;61;150;157;307
2020;June;24;2020-06-09 00:00;62;147;149;296
2020;June;24;2020-06-09 00:00;63;137;148;285
2020;June;24;2020-06-09 00:00;64;147;155;302
2020;June;24;2020-06-09 00:00;65;129;114;243
2020;June;24;2020-06-09 00:00;66;127;136;263
2020;June;24;2020-06-09 00:00;67;146;130;276
2020;June;24;2020-06-09 00:00;68;133;146;279
2020;June;24;2020-06-09 00:00;69;140;126;266
2020;June;24;2020-06-09 00:00;70;137;151;288
2020;June;24;2020-06-09 00:00;71;146;152;298
2020;June;24;2020-06-09 00:00;72;170;155;325
2020;June;24;2020-06-09 00:00;73;153;143;296
2020;June;24;2020-06-09 00:00;74;179;140;319
2020;June;24;2020-06-09 00:00;75;174;167;341
2020;June;24;2020-06-09 00:00;76;145;148;293
2020;June;24;2020-06-09 00:00;77;145;151;296
2020;June;24;2020-06-09 00:00;78;130;121;251
2020;June;24;2020-06-09 00:00;79;104;94;198
2020;June;24;2020-06-09 00:00;80;82;115;197
2020;June;24;2020-06-09 00:00;81;83;82;165
2020;June;24;2020-06-09 00:00;82;84;74;158
2020;June;24;2020-06-09 00:00;83;69;65;134
2020;June;24;2020-06-09 00:00;84;82;52;134
2020;June;24;2020-06-09 00:00;85;53;54;107
2020;June;24;2020-06-09 00:00;86;53;39;92
2020;June;24;2020-06-09 00:00;87;49;37;86
2020;June;24;2020-06-09 00:00;88;26;30;56
2020;June;24;2020-06-09 00:00;89;30;21;51
2020;June;24;2020-06-09 00:00;90;32;17;49
2020;June;24;2020-06-09 00:00;91;27;18;45
2020;June;24;2020-06-09 00:00;92;16;11;27
2020;June;24;2020-06-09 00:00;93;22;7;29
2020;June;24;2020-06-09 00:00;94;12;5;17
2020;June;24;2020-06-09 00:00;95;16;4;20
2020;June;24;2020-06-09 00:00;96;6;2;8
2020;June;24;2020-06-09 00:00;97;3;4;7
2020;June;24;2020-06-09 00:00;98;7;0;7
2020;June;24;2020-06-09 00:00;99;1;1;2
2020;June;24;2020-06-09 00:00;100;1;1;2
2020;June;24;2020-06-09 00:00;101;0;1;1
2020;June;24;2020-06-09 00:00;108;1;0;1
2020;June;25;2020-06-16 00:00;0;100;79;179
2020;June;25;2020-06-16 00:00;1;189;199;388
2020;June;25;2020-06-16 00:00;2;211;231;442
2020;June;25;2020-06-16 00:00;3;211;214;425
2020;June;25;2020-06-16 00:00;4;206;234;440
2020;June;25;2020-06-16 00:00;5;211;234;445
2020;June;25;2020-06-16 00:00;6;202;249;451
2020;June;25;2020-06-16 00:00;7;224;239;463
2020;June;25;2020-06-16 00:00;8;208;206;414
2020;June;25;2020-06-16 00:00;9;225;239;464
2020;June;25;2020-06-16 00:00;10;236;241;477
2020;June;25;2020-06-16 00:00;11;216;233;449
2020;June;25;2020-06-16 00:00;12;207;205;412
2020;June;25;2020-06-16 00:00;13;196;208;404
2020;June;25;2020-06-16 00:00;14;228;207;435
2020;June;25;2020-06-16 00:00;15;194;221;415
2020;June;25;2020-06-16 00:00;16;190;209;399
2020;June;25;2020-06-16 00:00;17;178;192;370
2020;June;25;2020-06-16 00:00;18;186;224;410
2020;June;25;2020-06-16 00:00;19;144;180;324
2020;June;25;2020-06-16 00:00;20;167;195;362
2020;June;25;2020-06-16 00:00;21;162;202;364
2020;June;25;2020-06-16 00:00;22;134;168;302
2020;June;25;2020-06-16 00:00;23;140;176;316
2020;June;25;2020-06-16 00:00;24;147;171;318
2020;June;25;2020-06-16 00:00;25;158;185;343
2020;June;25;2020-06-16 00:00;26;180;179;359
2020;June;25;2020-06-16 00:00;27;170;201;371
2020;June;25;2020-06-16 00:00;28;199;178;377
2020;June;25;2020-06-16 00:00;29;199;239;438
2020;June;25;2020-06-16 00:00;30;237;228;465
2020;June;25;2020-06-16 00:00;31;201;231;432
2020;June;25;2020-06-16 00:00;32;216;215;431
2020;June;25;2020-06-16 00:00;33;229;225;454
2020;June;25;2020-06-16 00:00;34;196;208;404
2020;June;25;2020-06-16 00:00;35;212;228;440
2020;June;25;2020-06-16 00:00;36;211;220;431
2020;June;25;2020-06-16 00:00;37;224;191;415
2020;June;25;2020-06-16 00:00;38;226;225;451
2020;June;25;2020-06-16 00:00;39;188;218;406
2020;June;25;2020-06-16 00:00;40;245;222;467
2020;June;25;2020-06-16 00:00;41;214;184;398
2020;June;25;2020-06-16 00:00;42;202;210;412
2020;June;25;2020-06-16 00:00;43;206;221;427
2020;June;25;2020-06-16 00:00;44;218;221;439
2020;June;25;2020-06-16 00:00;45;219;247;466
2020;June;25;2020-06-16 00:00;46;230;285;515
2020;June;25;2020-06-16 00:00;47;216;227;443
2020;June;25;2020-06-16 00:00;48;225;260;485
2020;June;25;2020-06-16 00:00;49;216;221;437
2020;June;25;2020-06-16 00:00;50;201;217;418
2020;June;25;2020-06-16 00:00;51;195;195;390
2020;June;25;2020-06-16 00:00;52;207;222;429
2020;June;25;2020-06-16 00:00;53;241;229;470
2020;June;25;2020-06-16 00:00;54;186;213;399
2020;June;25;2020-06-16 00:00;55;190;212;402
2020;June;25;2020-06-16 00:00;56;187;219;406
2020;June;25;2020-06-16 00:00;57;179;214;393
2020;June;25;2020-06-16 00:00;58;182;178;360
2020;June;25;2020-06-16 00:00;59;152;166;318
2020;June;25;2020-06-16 00:00;60;154;150;304
2020;June;25;2020-06-16 00:00;61;150;157;307
2020;June;25;2020-06-16 00:00;62;147;149;296
2020;June;25;2020-06-16 00:00;63;137;148;285
2020;June;25;2020-06-16 00:00;64;147;155;302
2020;June;25;2020-06-16 00:00;65;128;114;242
2020;June;25;2020-06-16 00:00;66;127;136;263
2020;June;25;2020-06-16 00:00;67;146;130;276
2020;June;25;2020-06-16 00:00;68;133;146;279
2020;June;25;2020-06-16 00:00;69;140;126;266
2020;June;25;2020-06-16 00:00;70;137;150;287
2020;June;25;2020-06-16 00:00;71;145;152;297
2020;June;25;2020-06-16 00:00;72;170;155;325
2020;June;25;2020-06-16 00:00;73;153;142;295
2020;June;25;2020-06-16 00:00;74;179;139;318
2020;June;25;2020-06-16 00:00;75;174;167;341
2020;June;25;2020-06-16 00:00;76;145;148;293
2020;June;25;2020-06-16 00:00;77;145;150;295
2020;June;25;2020-06-16 00:00;78;130;121;251
2020;June;25;2020-06-16 00:00;79;104;94;198
2020;June;25;2020-06-16 00:00;80;82;115;197
2020;June;25;2020-06-16 00:00;81;83;82;165
2020;June;25;2020-06-16 00:00;82;84;74;158
2020;June;25;2020-06-16 00:00;83;69;65;134
2020;June;25;2020-06-16 00:00;84;81;52;133
2020;June;25;2020-06-16 00:00;85;53;54;107
2020;June;25;2020-06-16 00:00;86;53;39;92
2020;June;25;2020-06-16 00:00;87;49;37;86
2020;June;25;2020-06-16 00:00;88;26;30;56
2020;June;25;2020-06-16 00:00;89;30;20;50
2020;June;25;2020-06-16 00:00;90;32;17;49
2020;June;25;2020-06-16 00:00;91;27;18;45
2020;June;25;2020-06-16 00:00;92;16;11;27
2020;June;25;2020-06-16 00:00;93;22;7;29
2020;June;25;2020-06-16 00:00;94;12;5;17
2020;June;25;2020-06-16 00:00;95;15;4;19
2020;June;25;2020-06-16 00:00;96;6;2;8
2020;June;25;2020-06-16 00:00;97;3;4;7
2020;June;25;2020-06-16 00:00;98;7;0;7
2020;June;25;2020-06-16 00:00;99;1;1;2
2020;June;25;2020-06-16 00:00;100;1;1;2
2020;June;25;2020-06-16 00:00;101;0;1;1
2020;June;25;2020-06-16 00:00;108;1;0;1
2020;June;26;2020-06-24 00:00;0;104;81;185
2020;June;26;2020-06-24 00:00;1;189;199;388
2020;June;26;2020-06-24 00:00;2;212;231;443
2020;June;26;2020-06-24 00:00;3;211;216;427
2020;June;26;2020-06-24 00:00;4;206;234;440
2020;June;26;2020-06-24 00:00;5;210;234;444
2020;June;26;2020-06-24 00:00;6;202;249;451
2020;June;26;2020-06-24 00:00;7;223;241;464
2020;June;26;2020-06-24 00:00;8;208;208;416
2020;June;26;2020-06-24 00:00;9;225;240;465
2020;June;26;2020-06-24 00:00;10;236;241;477
2020;June;26;2020-06-24 00:00;11;216;233;449
2020;June;26;2020-06-24 00:00;12;207;205;412
2020;June;26;2020-06-24 00:00;13;196;208;404
2020;June;26;2020-06-24 00:00;14;228;207;435
2020;June;26;2020-06-24 00:00;15;194;222;416
2020;June;26;2020-06-24 00:00;16;190;210;400
2020;June;26;2020-06-24 00:00;17;178;193;371
2020;June;26;2020-06-24 00:00;18;187;224;411
2020;June;26;2020-06-24 00:00;19;144;180;324
2020;June;26;2020-06-24 00:00;20;165;196;361
2020;June;26;2020-06-24 00:00;21;162;202;364
2020;June;26;2020-06-24 00:00;22;134;166;300
2020;June;26;2020-06-24 00:00;23;137;175;312
2020;June;26;2020-06-24 00:00;24;147;170;317
2020;June;26;2020-06-24 00:00;25;157;186;343
2020;June;26;2020-06-24 00:00;26;181;180;361
2020;June;26;2020-06-24 00:00;27;169;201;370
2020;June;26;2020-06-24 00:00;28;199;178;377
2020;June;26;2020-06-24 00:00;29;201;239;440
2020;June;26;2020-06-24 00:00;30;237;229;466
2020;June;26;2020-06-24 00:00;31;201;230;431
2020;June;26;2020-06-24 00:00;32;217;216;433
2020;June;26;2020-06-24 00:00;33;229;225;454
2020;June;26;2020-06-24 00:00;34;196;209;405
2020;June;26;2020-06-24 00:00;35;212;228;440
2020;June;26;2020-06-24 00:00;36;211;221;432
2020;June;26;2020-06-24 00:00;37;225;191;416
2020;June;26;2020-06-24 00:00;38;228;225;453
2020;June;26;2020-06-24 00:00;39;188;218;406
2020;June;26;2020-06-24 00:00;40;246;222;468
2020;June;26;2020-06-24 00:00;41;214;186;400
2020;June;26;2020-06-24 00:00;42;202;210;412
2020;June;26;2020-06-24 00:00;43;206;221;427
2020;June;26;2020-06-24 00:00;44;219;221;440
2020;June;26;2020-06-24 00:00;45;219;247;466
2020;June;26;2020-06-24 00:00;46;230;285;515
2020;June;26;2020-06-24 00:00;47;216;228;444
2020;June;26;2020-06-24 00:00;48;225;260;485
2020;June;26;2020-06-24 00:00;49;216;221;437
2020;June;26;2020-06-24 00:00;50;201;217;418
2020;June;26;2020-06-24 00:00;51;195;195;390
2020;June;26;2020-06-24 00:00;52;207;222;429
2020;June;26;2020-06-24 00:00;53;241;229;470
2020;June;26;2020-06-24 00:00;54;186;213;399
2020;June;26;2020-06-24 00:00;55;190;212;402
2020;June;26;2020-06-24 00:00;56;186;219;405
2020;June;26;2020-06-24 00:00;57;179;214;393
2020;June;26;2020-06-24 00:00;58;182;178;360
2020;June;26;2020-06-24 00:00;59;152;166;318
2020;June;26;2020-06-24 00:00;60;154;150;304
2020;June;26;2020-06-24 00:00;61;150;157;307
2020;June;26;2020-06-24 00:00;62;147;149;296
2020;June;26;2020-06-24 00:00;63;137;148;285
2020;June;26;2020-06-24 00:00;64;147;155;302
2020;June;26;2020-06-24 00:00;65;128;114;242
2020;June;26;2020-06-24 00:00;66;127;136;263
2020;June;26;2020-06-24 00:00;67;145;130;275
2020;June;26;2020-06-24 00:00;68;133;146;279
2020;June;26;2020-06-24 00:00;69;140;126;266
2020;June;26;2020-06-24 00:00;70;137;150;287
2020;June;26;2020-06-24 00:00;71;145;152;297
2020;June;26;2020-06-24 00:00;72;170;155;325
2020;June;26;2020-06-24 00:00;73;152;142;294
2020;June;26;2020-06-24 00:00;74;179;139;318
2020;June;26;2020-06-24 00:00;75;174;167;341
2020;June;26;2020-06-24 00:00;76;145;146;291
2020;June;26;2020-06-24 00:00;77;145;150;295
2020;June;26;2020-06-24 00:00;78;130;121;251
2020;June;26;2020-06-24 00:00;79;104;94;198
2020;June;26;2020-06-24 00:00;80;82;115;197
2020;June;26;2020-06-24 00:00;81;83;82;165
2020;June;26;2020-06-24 00:00;82;84;74;158
2020;June;26;2020-06-24 00:00;83;69;65;134
2020;June;26;2020-06-24 00:00;84;81;52;133
2020;June;26;2020-06-24 00:00;85;53;54;107
2020;June;26;2020-06-24 00:00;86;53;39;92
2020;June;26;2020-06-24 00:00;87;49;37;86
2020;June;26;2020-06-24 00:00;88;26;30;56
2020;June;26;2020-06-24 00:00;89;30;20;50
2020;June;26;2020-06-24 00:00;90;32;17;49
2020;June;26;2020-06-24 00:00;91;26;18;44
2020;June;26;2020-06-24 00:00;92;16;11;27
2020;June;26;2020-06-24 00:00;93;22;7;29
2020;June;26;2020-06-24 00:00;94;12;5;17
2020;June;26;2020-06-24 00:00;95;15;4;19
2020;June;26;2020-06-24 00:00;96;6;2;8
2020;June;26;2020-06-24 00:00;97;3;4;7
2020;June;26;2020-06-24 00:00;98;7;0;7
2020;June;26;2020-06-24 00:00;99;1;1;2
2020;June;26;2020-06-24 00:00;100;1;1;2
2020;June;26;2020-06-24 00:00;101;0;1;1
2020;June;26;2020-06-24 00:00;108;1;0;1
2020;June;27;2020-06-30 00:00;0;110;83;193
2020;June;27;2020-06-30 00:00;1;189;200;389
2020;June;27;2020-06-30 00:00;2;212;231;443
2020;June;27;2020-06-30 00:00;3;211;216;427
2020;June;27;2020-06-30 00:00;4;207;235;442
2020;June;27;2020-06-30 00:00;5;209;233;442
2020;June;27;2020-06-30 00:00;6;202;250;452
2020;June;27;2020-06-30 00:00;7;224;240;464
2020;June;27;2020-06-30 00:00;8;208;208;416
2020;June;27;2020-06-30 00:00;9;225;240;465
2020;June;27;2020-06-30 00:00;10;235;241;476
2020;June;27;2020-06-30 00:00;11;216;234;450
2020;June;27;2020-06-30 00:00;12;205;205;410
2020;June;27;2020-06-30 00:00;13;196;208;404
2020;June;27;2020-06-30 00:00;14;228;207;435
2020;June;27;2020-06-30 00:00;15;194;221;415
2020;June;27;2020-06-30 00:00;16;191;211;402
2020;June;27;2020-06-30 00:00;17;178;194;372
2020;June;27;2020-06-30 00:00;18;188;224;412
2020;June;27;2020-06-30 00:00;19;144;180;324
2020;June;27;2020-06-30 00:00;20;166;196;362
2020;June;27;2020-06-30 00:00;21;162;200;362
2020;June;27;2020-06-30 00:00;22;134;165;299
2020;June;27;2020-06-30 00:00;23;137;175;312
2020;June;27;2020-06-30 00:00;24;148;170;318
2020;June;27;2020-06-30 00:00;25;158;186;344
2020;June;27;2020-06-30 00:00;26;180;180;360
2020;June;27;2020-06-30 00:00;27;166;201;367
2020;June;27;2020-06-30 00:00;28;198;178;376
2020;June;27;2020-06-30 00:00;29;202;241;443
2020;June;27;2020-06-30 00:00;30;236;229;465
2020;June;27;2020-06-30 00:00;31;201;230;431
2020;June;27;2020-06-30 00:00;32;219;216;435
2020;June;27;2020-06-30 00:00;33;230;226;456
2020;June;27;2020-06-30 00:00;34;198;208;406
2020;June;27;2020-06-30 00:00;35;212;228;440
2020;June;27;2020-06-30 00:00;36;211;221;432
2020;June;27;2020-06-30 00:00;37;226;193;419
2020;June;27;2020-06-30 00:00;38;227;225;452
2020;June;27;2020-06-30 00:00;39;187;218;405
2020;June;27;2020-06-30 00:00;40;245;221;466
2020;June;27;2020-06-30 00:00;41;214;186;400
2020;June;27;2020-06-30 00:00;42;201;209;410
2020;June;27;2020-06-30 00:00;43;207;221;428
2020;June;27;2020-06-30 00:00;44;219;222;441
2020;June;27;2020-06-30 00:00;45;220;247;467
2020;June;27;2020-06-30 00:00;46;230;284;514
2020;June;27;2020-06-30 00:00;47;217;228;445
2020;June;27;2020-06-30 00:00;48;225;260;485
2020;June;27;2020-06-30 00:00;49;215;221;436
2020;June;27;2020-06-30 00:00;50;201;217;418
2020;June;27;2020-06-30 00:00;51;194;193;387
2020;June;27;2020-06-30 00:00;52;207;223;430
2020;June;27;2020-06-30 00:00;53;241;229;470
2020;June;27;2020-06-30 00:00;54;186;212;398
2020;June;27;2020-06-30 00:00;55;190;212;402
2020;June;27;2020-06-30 00:00;56;186;219;405
2020;June;27;2020-06-30 00:00;57;179;214;393
2020;June;27;2020-06-30 00:00;58;182;178;360
2020;June;27;2020-06-30 00:00;59;152;166;318
2020;June;27;2020-06-30 00:00;60;154;149;303
2020;June;27;2020-06-30 00:00;61;150;157;307
2020;June;27;2020-06-30 00:00;62;147;149;296
2020;June;27;2020-06-30 00:00;63;137;147;284
2020;June;27;2020-06-30 00:00;64;146;155;301
2020;June;27;2020-06-30 00:00;65;128;113;241
2020;June;27;2020-06-30 00:00;66;127;136;263
2020;June;27;2020-06-30 00:00;67;145;129;274
2020;June;27;2020-06-30 00:00;68;133;146;279
2020;June;27;2020-06-30 00:00;69;140;126;266
2020;June;27;2020-06-30 00:00;70;137;150;287
2020;June;27;2020-06-30 00:00;71;145;152;297
2020;June;27;2020-06-30 00:00;72;170;155;325
2020;June;27;2020-06-30 00:00;73;152;142;294
2020;June;27;2020-06-30 00:00;74;179;139;318
2020;June;27;2020-06-30 00:00;75;174;167;341
2020;June;27;2020-06-30 00:00;76;145;146;291
2020;June;27;2020-06-30 00:00;77;145;150;295
2020;June;27;2020-06-30 00:00;78;130;121;251
2020;June;27;2020-06-30 00:00;79;104;94;198
2020;June;27;2020-06-30 00:00;80;82;115;197
2020;June;27;2020-06-30 00:00;81;83;81;164
2020;June;27;2020-06-30 00:00;82;84;74;158
2020;June;27;2020-06-30 00:00;83;69;65;134
2020;June;27;2020-06-30 00:00;84;81;52;133
2020;June;27;2020-06-30 00:00;85;53;54;107
2020;June;27;2020-06-30 00:00;86;53;39;92
2020;June;27;2020-06-30 00:00;87;49;37;86
2020;June;27;2020-06-30 00:00;88;26;30;56
2020;June;27;2020-06-30 00:00;89;30;20;50
2020;June;27;2020-06-30 00:00;90;32;17;49
2020;June;27;2020-06-30 00:00;91;26;18;44
2020;June;27;2020-06-30 00:00;92;16;11;27
2020;June;27;2020-06-30 00:00;93;21;7;28
2020;June;27;2020-06-30 00:00;94;12;5;17
2020;June;27;2020-06-30 00:00;95;15;4;19
2020;June;27;2020-06-30 00:00;96;6;2;8
2020;June;27;2020-06-30 00:00;97;2;3;5
2020;June;27;2020-06-30 00:00;98;7;0;7
2020;June;27;2020-06-30 00:00;99;1;1;2
2020;June;27;2020-06-30 00:00;100;1;1;2
2020;June;27;2020-06-30 00:00;101;0;1;1
2020;June;27;2020-06-30 00:00;108;1;0;1
2020;July;28;2020-07-07 00:00;0;113;92;205
2020;July;28;2020-07-07 00:00;1;186;199;385
2020;July;28;2020-07-07 00:00;2;213;233;446
2020;July;28;2020-07-07 00:00;3;210;217;427
2020;July;28;2020-07-07 00:00;4;208;236;444
2020;July;28;2020-07-07 00:00;5;210;234;444
2020;July;28;2020-07-07 00:00;6;203;251;454
2020;July;28;2020-07-07 00:00;7;222;243;465
2020;July;28;2020-07-07 00:00;8;209;210;419
2020;July;28;2020-07-07 00:00;9;225;238;463
2020;July;28;2020-07-07 00:00;10;237;241;478
2020;July;28;2020-07-07 00:00;11;217;235;452
2020;July;28;2020-07-07 00:00;12;207;205;412
2020;July;28;2020-07-07 00:00;13;196;210;406
2020;July;28;2020-07-07 00:00;14;229;207;436
2020;July;28;2020-07-07 00:00;15;196;222;418
2020;July;28;2020-07-07 00:00;16;192;211;403
2020;July;28;2020-07-07 00:00;17;178;193;371
2020;July;28;2020-07-07 00:00;18;188;223;411
2020;July;28;2020-07-07 00:00;19;145;180;325
2020;July;28;2020-07-07 00:00;20;166;196;362
2020;July;28;2020-07-07 00:00;21;161;198;359
2020;July;28;2020-07-07 00:00;22;135;166;301
2020;July;28;2020-07-07 00:00;23;134;175;309
2020;July;28;2020-07-07 00:00;24;149;169;318
2020;July;28;2020-07-07 00:00;25;157;186;343
2020;July;28;2020-07-07 00:00;26;182;183;365
2020;July;28;2020-07-07 00:00;27;165;203;368
2020;July;28;2020-07-07 00:00;28;197;178;375
2020;July;28;2020-07-07 00:00;29;203;241;444
2020;July;28;2020-07-07 00:00;30;236;230;466
2020;July;28;2020-07-07 00:00;31;205;229;434
2020;July;28;2020-07-07 00:00;32;220;219;439
2020;July;28;2020-07-07 00:00;33;233;225;458
2020;July;28;2020-07-07 00:00;34;201;207;408
2020;July;28;2020-07-07 00:00;35;212;229;441
2020;July;28;2020-07-07 00:00;36;212;223;435
2020;July;28;2020-07-07 00:00;37;227;195;422
2020;July;28;2020-07-07 00:00;38;227;224;451
2020;July;28;2020-07-07 00:00;39;187;219;406
2020;July;28;2020-07-07 00:00;40;245;222;467
2020;July;28;2020-07-07 00:00;41;215;186;401
2020;July;28;2020-07-07 00:00;42;202;209;411
2020;July;28;2020-07-07 00:00;43;205;220;425
2020;July;28;2020-07-07 00:00;44;218;223;441
2020;July;28;2020-07-07 00:00;45;219;247;466
2020;July;28;2020-07-07 00:00;46;230;284;514
2020;July;28;2020-07-07 00:00;47;218;229;447
2020;July;28;2020-07-07 00:00;48;225;261;486
2020;July;28;2020-07-07 00:00;49;215;220;435
2020;July;28;2020-07-07 00:00;50;201;218;419
2020;July;28;2020-07-07 00:00;51;194;194;388
2020;July;28;2020-07-07 00:00;52;207;223;430
2020;July;28;2020-07-07 00:00;53;241;229;470
2020;July;28;2020-07-07 00:00;54;185;211;396
2020;July;28;2020-07-07 00:00;55;190;212;402
2020;July;28;2020-07-07 00:00;56;186;218;404
2020;July;28;2020-07-07 00:00;57;177;214;391
2020;July;28;2020-07-07 00:00;58;182;178;360
2020;July;28;2020-07-07 00:00;59;152;166;318
2020;July;28;2020-07-07 00:00;60;154;149;303
2020;July;28;2020-07-07 00:00;61;150;154;304
2020;July;28;2020-07-07 00:00;62;147;149;296
2020;July;28;2020-07-07 00:00;63;137;147;284
2020;July;28;2020-07-07 00:00;64;146;155;301
2020;July;28;2020-07-07 00:00;65;128;113;241
2020;July;28;2020-07-07 00:00;66;127;136;263
2020;July;28;2020-07-07 00:00;67;145;129;274
2020;July;28;2020-07-07 00:00;68;133;146;279
2020;July;28;2020-07-07 00:00;69;140;126;266
2020;July;28;2020-07-07 00:00;70;137;150;287
2020;July;28;2020-07-07 00:00;71;145;152;297
2020;July;28;2020-07-07 00:00;72;170;155;325
2020;July;28;2020-07-07 00:00;73;152;142;294
2020;July;28;2020-07-07 00:00;74;179;139;318
2020;July;28;2020-07-07 00:00;75;175;167;342
2020;July;28;2020-07-07 00:00;76;145;145;290
2020;July;28;2020-07-07 00:00;77;145;150;295
2020;July;28;2020-07-07 00:00;78;129;121;250
2020;July;28;2020-07-07 00:00;79;104;94;198
2020;July;28;2020-07-07 00:00;80;82;115;197
2020;July;28;2020-07-07 00:00;81;83;81;164
2020;July;28;2020-07-07 00:00;82;84;74;158
2020;July;28;2020-07-07 00:00;83;69;64;133
2020;July;28;2020-07-07 00:00;84;81;52;133
2020;July;28;2020-07-07 00:00;85;53;54;107
2020;July;28;2020-07-07 00:00;86;53;39;92
2020;July;28;2020-07-07 00:00;87;49;37;86
2020;July;28;2020-07-07 00:00;88;27;30;57
2020;July;28;2020-07-07 00:00;89;30;20;50
2020;July;28;2020-07-07 00:00;90;32;17;49
2020;July;28;2020-07-07 00:00;91;26;18;44
2020;July;28;2020-07-07 00:00;92;16;11;27
2020;July;28;2020-07-07 00:00;93;21;7;28
2020;July;28;2020-07-07 00:00;94;12;4;16
2020;July;28;2020-07-07 00:00;95;15;4;19
2020;July;28;2020-07-07 00:00;96;6;2;8
2020;July;28;2020-07-07 00:00;97;2;3;5
2020;July;28;2020-07-07 00:00;98;7;0;7
2020;July;28;2020-07-07 00:00;99;1;1;2
2020;July;28;2020-07-07 00:00;100;1;1;2
2020;July;28;2020-07-07 00:00;101;0;1;1
2020;July;28;2020-07-07 00:00;108;1;0;1
2020;July;29;2020-07-14 00:00;0;118;97;215
2020;July;29;2020-07-14 00:00;1;186;200;386
2020;July;29;2020-07-14 00:00;2;214;232;446
2020;July;29;2020-07-14 00:00;3;211;218;429
2020;July;29;2020-07-14 00:00;4;208;235;443
2020;July;29;2020-07-14 00:00;5;210;234;444
2020;July;29;2020-07-14 00:00;6;204;251;455
2020;July;29;2020-07-14 00:00;7;222;243;465
2020;July;29;2020-07-14 00:00;8;208;210;418
2020;July;29;2020-07-14 00:00;9;225;238;463
2020;July;29;2020-07-14 00:00;10;237;241;478
2020;July;29;2020-07-14 00:00;11;216;235;451
2020;July;29;2020-07-14 00:00;12;207;205;412
2020;July;29;2020-07-14 00:00;13;196;211;407
2020;July;29;2020-07-14 00:00;14;229;207;436
2020;July;29;2020-07-14 00:00;15;196;221;417
2020;July;29;2020-07-14 00:00;16;192;211;403
2020;July;29;2020-07-14 00:00;17;178;193;371
2020;July;29;2020-07-14 00:00;18;188;223;411
2020;July;29;2020-07-14 00:00;19;143;179;322
2020;July;29;2020-07-14 00:00;20;166;195;361
2020;July;29;2020-07-14 00:00;21;161;198;359
2020;July;29;2020-07-14 00:00;22;135;167;302
2020;July;29;2020-07-14 00:00;23;134;175;309
2020;July;29;2020-07-14 00:00;24;149;169;318
2020;July;29;2020-07-14 00:00;25;156;187;343
2020;July;29;2020-07-14 00:00;26;183;184;367
2020;July;29;2020-07-14 00:00;27;165;203;368
2020;July;29;2020-07-14 00:00;28;199;177;376
2020;July;29;2020-07-14 00:00;29;204;243;447
2020;July;29;2020-07-14 00:00;30;236;230;466
2020;July;29;2020-07-14 00:00;31;206;231;437
2020;July;29;2020-07-14 00:00;32;220;219;439
2020;July;29;2020-07-14 00:00;33;234;227;461
2020;July;29;2020-07-14 00:00;34;202;209;411
2020;July;29;2020-07-14 00:00;35;212;229;441
2020;July;29;2020-07-14 00:00;36;211;224;435
2020;July;29;2020-07-14 00:00;37;227;195;422
2020;July;29;2020-07-14 00:00;38;228;224;452
2020;July;29;2020-07-14 00:00;39;187;219;406
2020;July;29;2020-07-14 00:00;40;245;222;467
2020;July;29;2020-07-14 00:00;41;214;186;400
2020;July;29;2020-07-14 00:00;42;202;210;412
2020;July;29;2020-07-14 00:00;43;205;220;425
2020;July;29;2020-07-14 00:00;44;218;223;441
2020;July;29;2020-07-14 00:00;45;219;246;465
2020;July;29;2020-07-14 00:00;46;230;284;514
2020;July;29;2020-07-14 00:00;47;219;230;449
2020;July;29;2020-07-14 00:00;48;225;261;486
2020;July;29;2020-07-14 00:00;49;215;220;435
2020;July;29;2020-07-14 00:00;50;200;217;417
2020;July;29;2020-07-14 00:00;51;194;194;388
2020;July;29;2020-07-14 00:00;52;207;223;430
2020;July;29;2020-07-14 00:00;53;241;229;470
2020;July;29;2020-07-14 00:00;54;185;211;396
2020;July;29;2020-07-14 00:00;55;191;212;403
2020;July;29;2020-07-14 00:00;56;186;218;404
2020;July;29;2020-07-14 00:00;57;177;214;391
2020;July;29;2020-07-14 00:00;58;182;179;361
2020;July;29;2020-07-14 00:00;59;152;166;318
2020;July;29;2020-07-14 00:00;60;154;149;303
2020;July;29;2020-07-14 00:00;61;150;154;304
2020;July;29;2020-07-14 00:00;62;147;148;295
2020;July;29;2020-07-14 00:00;63;137;147;284
2020;July;29;2020-07-14 00:00;64;146;154;300
2020;July;29;2020-07-14 00:00;65;128;113;241
2020;July;29;2020-07-14 00:00;66;127;137;264
2020;July;29;2020-07-14 00:00;67;145;129;274
2020;July;29;2020-07-14 00:00;68;133;146;279
2020;July;29;2020-07-14 00:00;69;140;126;266
2020;July;29;2020-07-14 00:00;70;137;150;287
2020;July;29;2020-07-14 00:00;71;145;152;297
2020;July;29;2020-07-14 00:00;72;170;155;325
2020;July;29;2020-07-14 00:00;73;152;142;294
2020;July;29;2020-07-14 00:00;74;180;139;319
2020;July;29;2020-07-14 00:00;75;175;167;342
2020;July;29;2020-07-14 00:00;76;145;145;290
2020;July;29;2020-07-14 00:00;77;144;150;294
2020;July;29;2020-07-14 00:00;78;129;121;250
2020;July;29;2020-07-14 00:00;79;104;94;198
2020;July;29;2020-07-14 00:00;80;82;115;197
2020;July;29;2020-07-14 00:00;81;83;81;164
2020;July;29;2020-07-14 00:00;82;84;74;158
2020;July;29;2020-07-14 00:00;83;69;64;133
2020;July;29;2020-07-14 00:00;84;81;52;133
2020;July;29;2020-07-14 00:00;85;53;54;107
2020;July;29;2020-07-14 00:00;86;53;39;92
2020;July;29;2020-07-14 00:00;87;49;36;85
2020;July;29;2020-07-14 00:00;88;27;29;56
2020;July;29;2020-07-14 00:00;89;30;20;50
2020;July;29;2020-07-14 00:00;90;32;17;49
2020;July;29;2020-07-14 00:00;91;26;18;44
2020;July;29;2020-07-14 00:00;92;16;11;27
2020;July;29;2020-07-14 00:00;93;21;7;28
2020;July;29;2020-07-14 00:00;94;12;4;16
2020;July;29;2020-07-14 00:00;95;15;4;19
2020;July;29;2020-07-14 00:00;96;6;2;8
2020;July;29;2020-07-14 00:00;97;2;3;5
2020;July;29;2020-07-14 00:00;98;6;0;6
2020;July;29;2020-07-14 00:00;99;1;1;2
2020;July;29;2020-07-14 00:00;100;1;1;2
2020;July;29;2020-07-14 00:00;101;0;1;1
2020;July;29;2020-07-14 00:00;108;1;0;1
2020;July;30;2020-07-21 00:00;0;121;98;219
2020;July;30;2020-07-21 00:00;1;186;200;386
2020;July;30;2020-07-21 00:00;2;214;231;445
2020;July;30;2020-07-21 00:00;3;210;218;428
2020;July;30;2020-07-21 00:00;4;208;235;443
2020;July;30;2020-07-21 00:00;5;210;234;444
2020;July;30;2020-07-21 00:00;6;204;251;455
2020;July;30;2020-07-21 00:00;7;221;242;463
2020;July;30;2020-07-21 00:00;8;208;210;418
2020;July;30;2020-07-21 00:00;9;225;236;461
2020;July;30;2020-07-21 00:00;10;237;241;478
2020;July;30;2020-07-21 00:00;11;216;234;450
2020;July;30;2020-07-21 00:00;12;207;205;412
2020;July;30;2020-07-21 00:00;13;196;211;407
2020;July;30;2020-07-21 00:00;14;229;207;436
2020;July;30;2020-07-21 00:00;15;196;221;417
2020;July;30;2020-07-21 00:00;16;191;211;402
2020;July;30;2020-07-21 00:00;17;178;192;370
2020;July;30;2020-07-21 00:00;18;188;223;411
2020;July;30;2020-07-21 00:00;19;143;178;321
2020;July;30;2020-07-21 00:00;20;165;195;360
2020;July;30;2020-07-21 00:00;21;160;198;358
2020;July;30;2020-07-21 00:00;22;134;167;301
2020;July;30;2020-07-21 00:00;23;133;174;307
2020;July;30;2020-07-21 00:00;24;147;170;317
2020;July;30;2020-07-21 00:00;25;155;186;341
2020;July;30;2020-07-21 00:00;26;183;184;367
2020;July;30;2020-07-21 00:00;27;164;204;368
2020;July;30;2020-07-21 00:00;28;199;179;378
2020;July;30;2020-07-21 00:00;29;205;244;449
2020;July;30;2020-07-21 00:00;30;236;230;466
2020;July;30;2020-07-21 00:00;31;205;231;436
2020;July;30;2020-07-21 00:00;32;220;219;439
2020;July;30;2020-07-21 00:00;33;233;227;460
2020;July;30;2020-07-21 00:00;34;202;208;410
2020;July;30;2020-07-21 00:00;35;213;229;442
2020;July;30;2020-07-21 00:00;36;210;224;434
2020;July;30;2020-07-21 00:00;37;227;195;422
2020;July;30;2020-07-21 00:00;38;227;225;452
2020;July;30;2020-07-21 00:00;39;186;219;405
2020;July;30;2020-07-21 00:00;40;245;223;468
2020;July;30;2020-07-21 00:00;41;214;186;400
2020;July;30;2020-07-21 00:00;42;202;210;412
2020;July;30;2020-07-21 00:00;43;205;220;425
2020;July;30;2020-07-21 00:00;44;218;221;439
2020;July;30;2020-07-21 00:00;45;218;245;463
2020;July;30;2020-07-21 00:00;46;229;284;513
2020;July;30;2020-07-21 00:00;47;219;230;449
2020;July;30;2020-07-21 00:00;48;226;261;487
2020;July;30;2020-07-21 00:00;49;215;219;434
2020;July;30;2020-07-21 00:00;50;201;217;418
2020;July;30;2020-07-21 00:00;51;194;194;388
2020;July;30;2020-07-21 00:00;52;207;223;430
2020;July;30;2020-07-21 00:00;53;241;229;470
2020;July;30;2020-07-21 00:00;54;185;211;396
2020;July;30;2020-07-21 00:00;55;193;212;405
2020;July;30;2020-07-21 00:00;56;186;219;405
2020;July;30;2020-07-21 00:00;57;176;214;390
2020;July;30;2020-07-21 00:00;58;182;180;362
2020;July;30;2020-07-21 00:00;59;152;166;318
2020;July;30;2020-07-21 00:00;60;154;149;303
2020;July;30;2020-07-21 00:00;61;149;154;303
2020;July;30;2020-07-21 00:00;62;147;148;295
2020;July;30;2020-07-21 00:00;63;137;147;284
2020;July;30;2020-07-21 00:00;64;146;154;300
2020;July;30;2020-07-21 00:00;65;128;113;241
2020;July;30;2020-07-21 00:00;66;127;137;264
2020;July;30;2020-07-21 00:00;67;144;129;273
2020;July;30;2020-07-21 00:00;68;133;146;279
2020;July;30;2020-07-21 00:00;69;140;126;266
2020;July;30;2020-07-21 00:00;70;137;150;287
2020;July;30;2020-07-21 00:00;71;145;152;297
2020;July;30;2020-07-21 00:00;72;170;155;325
2020;July;30;2020-07-21 00:00;73;152;142;294
2020;July;30;2020-07-21 00:00;74;179;139;318
2020;July;30;2020-07-21 00:00;75;175;167;342
2020;July;30;2020-07-21 00:00;76;145;145;290
2020;July;30;2020-07-21 00:00;77;144;150;294
2020;July;30;2020-07-21 00:00;78;129;121;250
2020;July;30;2020-07-21 00:00;79;104;94;198
2020;July;30;2020-07-21 00:00;80;82;114;196
2020;July;30;2020-07-21 00:00;81;83;81;164
2020;July;30;2020-07-21 00:00;82;84;74;158
2020;July;30;2020-07-21 00:00;83;69;64;133
2020;July;30;2020-07-21 00:00;84;81;52;133
2020;July;30;2020-07-21 00:00;85;53;53;106
2020;July;30;2020-07-21 00:00;86;53;39;92
2020;July;30;2020-07-21 00:00;87;49;36;85
2020;July;30;2020-07-21 00:00;88;26;29;55
2020;July;30;2020-07-21 00:00;89;30;20;50
2020;July;30;2020-07-21 00:00;90;32;17;49
2020;July;30;2020-07-21 00:00;91;26;18;44
2020;July;30;2020-07-21 00:00;92;16;11;27
2020;July;30;2020-07-21 00:00;93;21;7;28
2020;July;30;2020-07-21 00:00;94;12;4;16
2020;July;30;2020-07-21 00:00;95;15;4;19
2020;July;30;2020-07-21 00:00;96;6;2;8
2020;July;30;2020-07-21 00:00;97;2;3;5
2020;July;30;2020-07-21 00:00;98;6;0;6
2020;July;30;2020-07-21 00:00;99;1;1;2
2020;July;30;2020-07-21 00:00;100;1;1;2
2020;July;30;2020-07-21 00:00;101;0;1;1
2020;July;30;2020-07-21 00:00;108;1;0;1
2020;July;31;2020-07-28 00:00;0;123;99;222
2020;July;31;2020-07-28 00:00;1;186;200;386
2020;July;31;2020-07-28 00:00;2;213;230;443
2020;July;31;2020-07-28 00:00;3;210;217;427
2020;July;31;2020-07-28 00:00;4;208;235;443
2020;July;31;2020-07-28 00:00;5;209;233;442
2020;July;31;2020-07-28 00:00;6;205;251;456
2020;July;31;2020-07-28 00:00;7;221;242;463
2020;July;31;2020-07-28 00:00;8;208;210;418
2020;July;31;2020-07-28 00:00;9;225;237;462
2020;July;31;2020-07-28 00:00;10;237;241;478
2020;July;31;2020-07-28 00:00;11;217;234;451
2020;July;31;2020-07-28 00:00;12;207;205;412
2020;July;31;2020-07-28 00:00;13;196;211;407
2020;July;31;2020-07-28 00:00;14;229;207;436
2020;July;31;2020-07-28 00:00;15;196;221;417
2020;July;31;2020-07-28 00:00;16;191;211;402
2020;July;31;2020-07-28 00:00;17;177;192;369
2020;July;31;2020-07-28 00:00;18;188;223;411
2020;July;31;2020-07-28 00:00;19;144;178;322
2020;July;31;2020-07-28 00:00;20;165;196;361
2020;July;31;2020-07-28 00:00;21;160;198;358
2020;July;31;2020-07-28 00:00;22;135;166;301
2020;July;31;2020-07-28 00:00;23;134;174;308
2020;July;31;2020-07-28 00:00;24;147;168;315
2020;July;31;2020-07-28 00:00;25;155;186;341
2020;July;31;2020-07-28 00:00;26;183;184;367
2020;July;31;2020-07-28 00:00;27;164;206;370
2020;July;31;2020-07-28 00:00;28;199;179;378
2020;July;31;2020-07-28 00:00;29;205;244;449
2020;July;31;2020-07-28 00:00;30;236;230;466
2020;July;31;2020-07-28 00:00;31;204;230;434
2020;July;31;2020-07-28 00:00;32;220;219;439
2020;July;31;2020-07-28 00:00;33;233;225;458
2020;July;31;2020-07-28 00:00;34;202;208;410
2020;July;31;2020-07-28 00:00;35;213;229;442
2020;July;31;2020-07-28 00:00;36;211;224;435
2020;July;31;2020-07-28 00:00;37;227;195;422
2020;July;31;2020-07-28 00:00;38;228;225;453
2020;July;31;2020-07-28 00:00;39;186;219;405
2020;July;31;2020-07-28 00:00;40;245;223;468
2020;July;31;2020-07-28 00:00;41;214;186;400
2020;July;31;2020-07-28 00:00;42;202;211;413
2020;July;31;2020-07-28 00:00;43;205;220;425
2020;July;31;2020-07-28 00:00;44;218;221;439
2020;July;31;2020-07-28 00:00;45;218;245;463
2020;July;31;2020-07-28 00:00;46;229;284;513
2020;July;31;2020-07-28 00:00;47;219;230;449
2020;July;31;2020-07-28 00:00;48;226;261;487
2020;July;31;2020-07-28 00:00;49;215;219;434
2020;July;31;2020-07-28 00:00;50;201;216;417
2020;July;31;2020-07-28 00:00;51;194;194;388
2020;July;31;2020-07-28 00:00;52;207;223;430
2020;July;31;2020-07-28 00:00;53;241;229;470
2020;July;31;2020-07-28 00:00;54;185;211;396
2020;July;31;2020-07-28 00:00;55;193;212;405
2020;July;31;2020-07-28 00:00;56;186;220;406
2020;July;31;2020-07-28 00:00;57;176;213;389
2020;July;31;2020-07-28 00:00;58;182;180;362
2020;July;31;2020-07-28 00:00;59;152;166;318
2020;July;31;2020-07-28 00:00;60;154;149;303
2020;July;31;2020-07-28 00:00;61;148;154;302
2020;July;31;2020-07-28 00:00;62;147;148;295
2020;July;31;2020-07-28 00:00;63;137;147;284
2020;July;31;2020-07-28 00:00;64;146;154;300
2020;July;31;2020-07-28 00:00;65;128;113;241
2020;July;31;2020-07-28 00:00;66;127;137;264
2020;July;31;2020-07-28 00:00;67;144;129;273
2020;July;31;2020-07-28 00:00;68;133;146;279
2020;July;31;2020-07-28 00:00;69;140;126;266
2020;July;31;2020-07-28 00:00;70;137;150;287
2020;July;31;2020-07-28 00:00;71;145;152;297
2020;July;31;2020-07-28 00:00;72;170;155;325
2020;July;31;2020-07-28 00:00;73;152;142;294
2020;July;31;2020-07-28 00:00;74;179;139;318
2020;July;31;2020-07-28 00:00;75;175;167;342
2020;July;31;2020-07-28 00:00;76;144;145;289
2020;July;31;2020-07-28 00:00;77;144;150;294
2020;July;31;2020-07-28 00:00;78;129;121;250
2020;July;31;2020-07-28 00:00;79;104;94;198
2020;July;31;2020-07-28 00:00;80;82;114;196
2020;July;31;2020-07-28 00:00;81;83;81;164
2020;July;31;2020-07-28 00:00;82;84;74;158
2020;July;31;2020-07-28 00:00;83;69;64;133
2020;July;31;2020-07-28 00:00;84;81;52;133
2020;July;31;2020-07-28 00:00;85;53;53;106
2020;July;31;2020-07-28 00:00;86;53;39;92
2020;July;31;2020-07-28 00:00;87;49;36;85
2020;July;31;2020-07-28 00:00;88;26;28;54
2020;July;31;2020-07-28 00:00;89;30;20;50
2020;July;31;2020-07-28 00:00;90;31;17;48
2020;July;31;2020-07-28 00:00;91;26;18;44
2020;July;31;2020-07-28 00:00;92;16;11;27
2020;July;31;2020-07-28 00:00;93;21;6;27
2020;July;31;2020-07-28 00:00;94;12;4;16
2020;July;31;2020-07-28 00:00;95;15;4;19
2020;July;31;2020-07-28 00:00;96;6;2;8
2020;July;31;2020-07-28 00:00;97;2;3;5
2020;July;31;2020-07-28 00:00;98;6;0;6
2020;July;31;2020-07-28 00:00;99;1;1;2
2020;July;31;2020-07-28 00:00;100;1;1;2
2020;July;31;2020-07-28 00:00;101;0;1;1
2020;July;31;2020-07-28 00:00;108;1;0;1
2020;August;32;2020-08-04 00:00;0;126;100;226
2020;August;32;2020-08-04 00:00;1;188;201;389
2020;August;32;2020-08-04 00:00;2;212;229;441
2020;August;32;2020-08-04 00:00;3;210;216;426
2020;August;32;2020-08-04 00:00;4;207;237;444
2020;August;32;2020-08-04 00:00;5;209;234;443
2020;August;32;2020-08-04 00:00;6;207;252;459
2020;August;32;2020-08-04 00:00;7;221;243;464
2020;August;32;2020-08-04 00:00;8;208;211;419
2020;August;32;2020-08-04 00:00;9;224;237;461
2020;August;32;2020-08-04 00:00;10;237;240;477
2020;August;32;2020-08-04 00:00;11;217;234;451
2020;August;32;2020-08-04 00:00;12;208;205;413
2020;August;32;2020-08-04 00:00;13;196;211;407
2020;August;32;2020-08-04 00:00;14;229;207;436
2020;August;32;2020-08-04 00:00;15;196;221;417
2020;August;32;2020-08-04 00:00;16;191;211;402
2020;August;32;2020-08-04 00:00;17;175;192;367
2020;August;32;2020-08-04 00:00;18;188;223;411
2020;August;32;2020-08-04 00:00;19;144;178;322
2020;August;32;2020-08-04 00:00;20;165;196;361
2020;August;32;2020-08-04 00:00;21;159;198;357
2020;August;32;2020-08-04 00:00;22;134;165;299
2020;August;32;2020-08-04 00:00;23;136;175;311
2020;August;32;2020-08-04 00:00;24;146;168;314
2020;August;32;2020-08-04 00:00;25;156;185;341
2020;August;32;2020-08-04 00:00;26;182;181;363
2020;August;32;2020-08-04 00:00;27;167;207;374
2020;August;32;2020-08-04 00:00;28;200;180;380
2020;August;32;2020-08-04 00:00;29;205;244;449
2020;August;32;2020-08-04 00:00;30;234;230;464
2020;August;32;2020-08-04 00:00;31;204;231;435
2020;August;32;2020-08-04 00:00;32;220;220;440
2020;August;32;2020-08-04 00:00;33;234;224;458
2020;August;32;2020-08-04 00:00;34;204;208;412
2020;August;32;2020-08-04 00:00;35;214;230;444
2020;August;32;2020-08-04 00:00;36;212;224;436
2020;August;32;2020-08-04 00:00;37;227;196;423
2020;August;32;2020-08-04 00:00;38;229;226;455
2020;August;32;2020-08-04 00:00;39;186;218;404
2020;August;32;2020-08-04 00:00;40;244;224;468
2020;August;32;2020-08-04 00:00;41;215;187;402
2020;August;32;2020-08-04 00:00;42;202;210;412
2020;August;32;2020-08-04 00:00;43;205;219;424
2020;August;32;2020-08-04 00:00;44;217;221;438
2020;August;32;2020-08-04 00:00;45;218;245;463
2020;August;32;2020-08-04 00:00;46;228;283;511
2020;August;32;2020-08-04 00:00;47;219;230;449
2020;August;32;2020-08-04 00:00;48;226;261;487
2020;August;32;2020-08-04 00:00;49;214;219;433
2020;August;32;2020-08-04 00:00;50;202;216;418
2020;August;32;2020-08-04 00:00;51;193;192;385
2020;August;32;2020-08-04 00:00;52;207;223;430
2020;August;32;2020-08-04 00:00;53;241;229;470
2020;August;32;2020-08-04 00:00;54;184;211;395
2020;August;32;2020-08-04 00:00;55;193;212;405
2020;August;32;2020-08-04 00:00;56;185;219;404
2020;August;32;2020-08-04 00:00;57;176;213;389
2020;August;32;2020-08-04 00:00;58;180;180;360
2020;August;32;2020-08-04 00:00;59;151;166;317
2020;August;32;2020-08-04 00:00;60;154;149;303
2020;August;32;2020-08-04 00:00;61;147;154;301
2020;August;32;2020-08-04 00:00;62;147;148;295
2020;August;32;2020-08-04 00:00;63;137;146;283
2020;August;32;2020-08-04 00:00;64;146;154;300
2020;August;32;2020-08-04 00:00;65;128;112;240
2020;August;32;2020-08-04 00:00;66;126;137;263
2020;August;32;2020-08-04 00:00;67;144;128;272
2020;August;32;2020-08-04 00:00;68;134;145;279
2020;August;32;2020-08-04 00:00;69;140;126;266
2020;August;32;2020-08-04 00:00;70;137;150;287
2020;August;32;2020-08-04 00:00;71;144;152;296
2020;August;32;2020-08-04 00:00;72;169;155;324
2020;August;32;2020-08-04 00:00;73;152;142;294
2020;August;32;2020-08-04 00:00;74;178;139;317
2020;August;32;2020-08-04 00:00;75;174;167;341
2020;August;32;2020-08-04 00:00;76;144;145;289
2020;August;32;2020-08-04 00:00;77;144;149;293
2020;August;32;2020-08-04 00:00;78;129;121;250
2020;August;32;2020-08-04 00:00;79;104;94;198
2020;August;32;2020-08-04 00:00;80;82;114;196
2020;August;32;2020-08-04 00:00;81;83;80;163
2020;August;32;2020-08-04 00:00;82;84;74;158
2020;August;32;2020-08-04 00:00;83;69;64;133
2020;August;32;2020-08-04 00:00;84;81;52;133
2020;August;32;2020-08-04 00:00;85;53;53;106
2020;August;32;2020-08-04 00:00;86;53;39;92
2020;August;32;2020-08-04 00:00;87;49;34;83
2020;August;32;2020-08-04 00:00;88;26;28;54
2020;August;32;2020-08-04 00:00;89;30;20;50
2020;August;32;2020-08-04 00:00;90;31;17;48
2020;August;32;2020-08-04 00:00;91;26;18;44
2020;August;32;2020-08-04 00:00;92;16;11;27
2020;August;32;2020-08-04 00:00;93;21;6;27
2020;August;32;2020-08-04 00:00;94;12;4;16
2020;August;32;2020-08-04 00:00;95;15;4;19
2020;August;32;2020-08-04 00:00;96;6;2;8
2020;August;32;2020-08-04 00:00;97;2;3;5
2020;August;32;2020-08-04 00:00;98;6;0;6
2020;August;32;2020-08-04 00:00;99;1;1;2
2020;August;32;2020-08-04 00:00;100;1;1;2
2020;August;32;2020-08-04 00:00;101;0;1;1
2020;August;32;2020-08-04 00:00;108;1;0;1
2020;August;33;2020-08-12 00:00;0;129;105;234
2020;August;33;2020-08-12 00:00;1;189;201;390
2020;August;33;2020-08-12 00:00;2;212;229;441
2020;August;33;2020-08-12 00:00;3;210;219;429
2020;August;33;2020-08-12 00:00;4;208;236;444
2020;August;33;2020-08-12 00:00;5;209;235;444
2020;August;33;2020-08-12 00:00;6;207;253;460
2020;August;33;2020-08-12 00:00;7;221;244;465
2020;August;33;2020-08-12 00:00;8;208;209;417
2020;August;33;2020-08-12 00:00;9;224;237;461
2020;August;33;2020-08-12 00:00;10;238;240;478
2020;August;33;2020-08-12 00:00;11;217;234;451
2020;August;33;2020-08-12 00:00;12;208;205;413
2020;August;33;2020-08-12 00:00;13;196;211;407
2020;August;33;2020-08-12 00:00;14;228;207;435
2020;August;33;2020-08-12 00:00;15;197;221;418
2020;August;33;2020-08-12 00:00;16;191;211;402
2020;August;33;2020-08-12 00:00;17;175;192;367
2020;August;33;2020-08-12 00:00;18;188;223;411
2020;August;33;2020-08-12 00:00;19;145;177;322
2020;August;33;2020-08-12 00:00;20;165;197;362
2020;August;33;2020-08-12 00:00;21;161;198;359
2020;August;33;2020-08-12 00:00;22;133;165;298
2020;August;33;2020-08-12 00:00;23;135;175;310
2020;August;33;2020-08-12 00:00;24;144;167;311
2020;August;33;2020-08-12 00:00;25;157;183;340
2020;August;33;2020-08-12 00:00;26;182;181;363
2020;August;33;2020-08-12 00:00;27;167;207;374
2020;August;33;2020-08-12 00:00;28;200;181;381
2020;August;33;2020-08-12 00:00;29;205;244;449
2020;August;33;2020-08-12 00:00;30;232;229;461
2020;August;33;2020-08-12 00:00;31;203;228;431
2020;August;33;2020-08-12 00:00;32;220;220;440
2020;August;33;2020-08-12 00:00;33;234;226;460
2020;August;33;2020-08-12 00:00;34;206;207;413
2020;August;33;2020-08-12 00:00;35;215;230;445
2020;August;33;2020-08-12 00:00;36;211;225;436
2020;August;33;2020-08-12 00:00;37;227;197;424
2020;August;33;2020-08-12 00:00;38;228;226;454
2020;August;33;2020-08-12 00:00;39;188;218;406
2020;August;33;2020-08-12 00:00;40;245;224;469
2020;August;33;2020-08-12 00:00;41;215;187;402
2020;August;33;2020-08-12 00:00;42;202;209;411
2020;August;33;2020-08-12 00:00;43;205;219;424
2020;August;33;2020-08-12 00:00;44;218;221;439
2020;August;33;2020-08-12 00:00;45;218;245;463
2020;August;33;2020-08-12 00:00;46;228;283;511
2020;August;33;2020-08-12 00:00;47;219;230;449
2020;August;33;2020-08-12 00:00;48;227;261;488
2020;August;33;2020-08-12 00:00;49;215;219;434
2020;August;33;2020-08-12 00:00;50;202;216;418
2020;August;33;2020-08-12 00:00;51;193;192;385
2020;August;33;2020-08-12 00:00;52;207;224;431
2020;August;33;2020-08-12 00:00;53;241;229;470
2020;August;33;2020-08-12 00:00;54;184;211;395
2020;August;33;2020-08-12 00:00;55;193;212;405
2020;August;33;2020-08-12 00:00;56;185;219;404
2020;August;33;2020-08-12 00:00;57;176;214;390
2020;August;33;2020-08-12 00:00;58;180;180;360
2020;August;33;2020-08-12 00:00;59;151;166;317
2020;August;33;2020-08-12 00:00;60;154;149;303
2020;August;33;2020-08-12 00:00;61;147;154;301
2020;August;33;2020-08-12 00:00;62;148;148;296
2020;August;33;2020-08-12 00:00;63;137;146;283
2020;August;33;2020-08-12 00:00;64;146;154;300
2020;August;33;2020-08-12 00:00;65;128;112;240
2020;August;33;2020-08-12 00:00;66;126;137;263
2020;August;33;2020-08-12 00:00;67;144;128;272
2020;August;33;2020-08-12 00:00;68;134;145;279
2020;August;33;2020-08-12 00:00;69;140;126;266
2020;August;33;2020-08-12 00:00;70;137;150;287
2020;August;33;2020-08-12 00:00;71;144;152;296
2020;August;33;2020-08-12 00:00;72;169;155;324
2020;August;33;2020-08-12 00:00;73;152;142;294
2020;August;33;2020-08-12 00:00;74;178;139;317
2020;August;33;2020-08-12 00:00;75;174;166;340
2020;August;33;2020-08-12 00:00;76;144;145;289
2020;August;33;2020-08-12 00:00;77;144;149;293
2020;August;33;2020-08-12 00:00;78;129;121;250
2020;August;33;2020-08-12 00:00;79;104;94;198
2020;August;33;2020-08-12 00:00;80;82;114;196
2020;August;33;2020-08-12 00:00;81;83;80;163
2020;August;33;2020-08-12 00:00;82;84;74;158
2020;August;33;2020-08-12 00:00;83;69;64;133
2020;August;33;2020-08-12 00:00;84;81;52;133
2020;August;33;2020-08-12 00:00;85;53;53;106
2020;August;33;2020-08-12 00:00;86;53;39;92
2020;August;33;2020-08-12 00:00;87;49;33;82
2020;August;33;2020-08-12 00:00;88;26;28;54
2020;August;33;2020-08-12 00:00;89;30;20;50
2020;August;33;2020-08-12 00:00;90;31;17;48
2020;August;33;2020-08-12 00:00;91;26;18;44
2020;August;33;2020-08-12 00:00;92;16;11;27
2020;August;33;2020-08-12 00:00;93;21;6;27
2020;August;33;2020-08-12 00:00;94;12;4;16
2020;August;33;2020-08-12 00:00;95;15;4;19
2020;August;33;2020-08-12 00:00;96;6;2;8
2020;August;33;2020-08-12 00:00;97;2;3;5
2020;August;33;2020-08-12 00:00;98;6;0;6
2020;August;33;2020-08-12 00:00;99;1;1;2
2020;August;33;2020-08-12 00:00;100;1;1;2
2020;August;33;2020-08-12 00:00;101;0;1;1
2020;August;33;2020-08-12 00:00;108;1;0;1
2020;August;34;2020-08-18 00:00;0;132;106;238
2020;August;34;2020-08-18 00:00;1;189;201;390
2020;August;34;2020-08-18 00:00;2;212;230;442
2020;August;34;2020-08-18 00:00;3;211;219;430
2020;August;34;2020-08-18 00:00;4;208;236;444
2020;August;34;2020-08-18 00:00;5;211;236;447
2020;August;34;2020-08-18 00:00;6;210;253;463
2020;August;34;2020-08-18 00:00;7;221;244;465
2020;August;34;2020-08-18 00:00;8;208;210;418
2020;August;34;2020-08-18 00:00;9;224;237;461
2020;August;34;2020-08-18 00:00;10;238;240;478
2020;August;34;2020-08-18 00:00;11;216;234;450
2020;August;34;2020-08-18 00:00;12;208;205;413
2020;August;34;2020-08-18 00:00;13;196;211;407
2020;August;34;2020-08-18 00:00;14;227;207;434
2020;August;34;2020-08-18 00:00;15;197;222;419
2020;August;34;2020-08-18 00:00;16;191;211;402
2020;August;34;2020-08-18 00:00;17;175;191;366
2020;August;34;2020-08-18 00:00;18;188;223;411
2020;August;34;2020-08-18 00:00;19;146;177;323
2020;August;34;2020-08-18 00:00;20;165;198;363
2020;August;34;2020-08-18 00:00;21;161;196;357
2020;August;34;2020-08-18 00:00;22;134;162;296
2020;August;34;2020-08-18 00:00;23;135;177;312
2020;August;34;2020-08-18 00:00;24;144;167;311
2020;August;34;2020-08-18 00:00;25;158;184;342
2020;August;34;2020-08-18 00:00;26;182;181;363
2020;August;34;2020-08-18 00:00;27;168;207;375
2020;August;34;2020-08-18 00:00;28;200;181;381
2020;August;34;2020-08-18 00:00;29;204;245;449
2020;August;34;2020-08-18 00:00;30;233;229;462
2020;August;34;2020-08-18 00:00;31;203;229;432
2020;August;34;2020-08-18 00:00;32;221;222;443
2020;August;34;2020-08-18 00:00;33;234;227;461
2020;August;34;2020-08-18 00:00;34;207;207;414
2020;August;34;2020-08-18 00:00;35;216;229;445
2020;August;34;2020-08-18 00:00;36;213;224;437
2020;August;34;2020-08-18 00:00;37;227;197;424
2020;August;34;2020-08-18 00:00;38;228;226;454
2020;August;34;2020-08-18 00:00;39;188;218;406
2020;August;34;2020-08-18 00:00;40;245;226;471
2020;August;34;2020-08-18 00:00;41;215;186;401
2020;August;34;2020-08-18 00:00;42;202;209;411
2020;August;34;2020-08-18 00:00;43;205;219;424
2020;August;34;2020-08-18 00:00;44;218;222;440
2020;August;34;2020-08-18 00:00;45;219;246;465
2020;August;34;2020-08-18 00:00;46;229;283;512
2020;August;34;2020-08-18 00:00;47;219;230;449
2020;August;34;2020-08-18 00:00;48;227;261;488
2020;August;34;2020-08-18 00:00;49;214;220;434
2020;August;34;2020-08-18 00:00;50;202;216;418
2020;August;34;2020-08-18 00:00;51;193;192;385
2020;August;34;2020-08-18 00:00;52;206;223;429
2020;August;34;2020-08-18 00:00;53;242;229;471
2020;August;34;2020-08-18 00:00;54;184;211;395
2020;August;34;2020-08-18 00:00;55;193;212;405
2020;August;34;2020-08-18 00:00;56;185;220;405
2020;August;34;2020-08-18 00:00;57;176;215;391
2020;August;34;2020-08-18 00:00;58;182;180;362
2020;August;34;2020-08-18 00:00;59;151;166;317
2020;August;34;2020-08-18 00:00;60;154;149;303
2020;August;34;2020-08-18 00:00;61;147;153;300
2020;August;34;2020-08-18 00:00;62;148;148;296
2020;August;34;2020-08-18 00:00;63;137;146;283
2020;August;34;2020-08-18 00:00;64;146;153;299
2020;August;34;2020-08-18 00:00;65;128;112;240
2020;August;34;2020-08-18 00:00;66;126;137;263
2020;August;34;2020-08-18 00:00;67;144;128;272
2020;August;34;2020-08-18 00:00;68;134;145;279
2020;August;34;2020-08-18 00:00;69;140;126;266
2020;August;34;2020-08-18 00:00;70;137;150;287
2020;August;34;2020-08-18 00:00;71;143;152;295
2020;August;34;2020-08-18 00:00;72;169;155;324
2020;August;34;2020-08-18 00:00;73;152;142;294
2020;August;34;2020-08-18 00:00;74;178;138;316
2020;August;34;2020-08-18 00:00;75;174;166;340
2020;August;34;2020-08-18 00:00;76;144;145;289
2020;August;34;2020-08-18 00:00;77;144;149;293
2020;August;34;2020-08-18 00:00;78;128;121;249
2020;August;34;2020-08-18 00:00;79;104;94;198
2020;August;34;2020-08-18 00:00;80;82;114;196
2020;August;34;2020-08-18 00:00;81;83;80;163
2020;August;34;2020-08-18 00:00;82;84;74;158
2020;August;34;2020-08-18 00:00;83;69;64;133
2020;August;34;2020-08-18 00:00;84;81;52;133
2020;August;34;2020-08-18 00:00;85;53;53;106
2020;August;34;2020-08-18 00:00;86;53;39;92
2020;August;34;2020-08-18 00:00;87;49;33;82
2020;August;34;2020-08-18 00:00;88;26;28;54
2020;August;34;2020-08-18 00:00;89;30;20;50
2020;August;34;2020-08-18 00:00;90;31;17;48
2020;August;34;2020-08-18 00:00;91;26;18;44
2020;August;34;2020-08-18 00:00;92;16;11;27
2020;August;34;2020-08-18 00:00;93;21;6;27
2020;August;34;2020-08-18 00:00;94;12;4;16
2020;August;34;2020-08-18 00:00;95;15;4;19
2020;August;34;2020-08-18 00:00;96;6;2;8
2020;August;34;2020-08-18 00:00;97;2;3;5
2020;August;34;2020-08-18 00:00;98;6;0;6
2020;August;34;2020-08-18 00:00;99;1;1;2
2020;August;34;2020-08-18 00:00;100;1;1;2
2020;August;34;2020-08-18 00:00;101;0;1;1
2020;August;34;2020-08-18 00:00;108;1;0;1
2020;August;35;2020-08-25 00:00;0;134;113;247
2020;August;35;2020-08-25 00:00;1;187;201;388
2020;August;35;2020-08-25 00:00;2;212;231;443
2020;August;35;2020-08-25 00:00;3;211;219;430
2020;August;35;2020-08-25 00:00;4;208;236;444
2020;August;35;2020-08-25 00:00;5;212;236;448
2020;August;35;2020-08-25 00:00;6;210;253;463
2020;August;35;2020-08-25 00:00;7;221;243;464
2020;August;35;2020-08-25 00:00;8;208;212;420
2020;August;35;2020-08-25 00:00;9;224;237;461
2020;August;35;2020-08-25 00:00;10;240;240;480
2020;August;35;2020-08-25 00:00;11;216;234;450
2020;August;35;2020-08-25 00:00;12;208;205;413
2020;August;35;2020-08-25 00:00;13;196;212;408
2020;August;35;2020-08-25 00:00;14;226;207;433
2020;August;35;2020-08-25 00:00;15;197;222;419
2020;August;35;2020-08-25 00:00;16;191;210;401
2020;August;35;2020-08-25 00:00;17;175;192;367
2020;August;35;2020-08-25 00:00;18;188;223;411
2020;August;35;2020-08-25 00:00;19;146;176;322
2020;August;35;2020-08-25 00:00;20;162;197;359
2020;August;35;2020-08-25 00:00;21;158;197;355
2020;August;35;2020-08-25 00:00;22;132;161;293
2020;August;35;2020-08-25 00:00;23;134;176;310
2020;August;35;2020-08-25 00:00;24;143;167;310
2020;August;35;2020-08-25 00:00;25;157;184;341
2020;August;35;2020-08-25 00:00;26;182;178;360
2020;August;35;2020-08-25 00:00;27;168;207;375
2020;August;35;2020-08-25 00:00;28;200;179;379
2020;August;35;2020-08-25 00:00;29;204;245;449
2020;August;35;2020-08-25 00:00;30;234;230;464
2020;August;35;2020-08-25 00:00;31;203;228;431
2020;August;35;2020-08-25 00:00;32;221;222;443
2020;August;35;2020-08-25 00:00;33;234;227;461
2020;August;35;2020-08-25 00:00;34;208;207;415
2020;August;35;2020-08-25 00:00;35;216;229;445
2020;August;35;2020-08-25 00:00;36;213;224;437
2020;August;35;2020-08-25 00:00;37;227;195;422
2020;August;35;2020-08-25 00:00;38;228;225;453
2020;August;35;2020-08-25 00:00;39;188;217;405
2020;August;35;2020-08-25 00:00;40;246;225;471
2020;August;35;2020-08-25 00:00;41;214;186;400
2020;August;35;2020-08-25 00:00;42;202;209;411
2020;August;35;2020-08-25 00:00;43;205;219;424
2020;August;35;2020-08-25 00:00;44;218;222;440
2020;August;35;2020-08-25 00:00;45;219;246;465
2020;August;35;2020-08-25 00:00;46;228;283;511
2020;August;35;2020-08-25 00:00;47;219;230;449
2020;August;35;2020-08-25 00:00;48;227;261;488
2020;August;35;2020-08-25 00:00;49;212;219;431
2020;August;35;2020-08-25 00:00;50;202;216;418
2020;August;35;2020-08-25 00:00;51;193;192;385
2020;August;35;2020-08-25 00:00;52;206;222;428
2020;August;35;2020-08-25 00:00;53;241;230;471
2020;August;35;2020-08-25 00:00;54;184;211;395
2020;August;35;2020-08-25 00:00;55;194;212;406
2020;August;35;2020-08-25 00:00;56;185;221;406
2020;August;35;2020-08-25 00:00;57;176;215;391
2020;August;35;2020-08-25 00:00;58;182;180;362
2020;August;35;2020-08-25 00:00;59;151;166;317
2020;August;35;2020-08-25 00:00;60;154;149;303
2020;August;35;2020-08-25 00:00;61;147;153;300
2020;August;35;2020-08-25 00:00;62;148;148;296
2020;August;35;2020-08-25 00:00;63;137;146;283
2020;August;35;2020-08-25 00:00;64;146;153;299
2020;August;35;2020-08-25 00:00;65;128;112;240
2020;August;35;2020-08-25 00:00;66;126;137;263
2020;August;35;2020-08-25 00:00;67;144;128;272
2020;August;35;2020-08-25 00:00;68;134;145;279
2020;August;35;2020-08-25 00:00;69;140;126;266
2020;August;35;2020-08-25 00:00;70;137;150;287
2020;August;35;2020-08-25 00:00;71;143;152;295
2020;August;35;2020-08-25 00:00;72;169;155;324
2020;August;35;2020-08-25 00:00;73;152;142;294
2020;August;35;2020-08-25 00:00;74;178;138;316
2020;August;35;2020-08-25 00:00;75;174;166;340
2020;August;35;2020-08-25 00:00;76;144;145;289
2020;August;35;2020-08-25 00:00;77;144;149;293
2020;August;35;2020-08-25 00:00;78;128;121;249
2020;August;35;2020-08-25 00:00;79;104;94;198
2020;August;35;2020-08-25 00:00;80;82;114;196
2020;August;35;2020-08-25 00:00;81;83;80;163
2020;August;35;2020-08-25 00:00;82;84;74;158
2020;August;35;2020-08-25 00:00;83;69;64;133
2020;August;35;2020-08-25 00:00;84;81;52;133
2020;August;35;2020-08-25 00:00;85;53;53;106
2020;August;35;2020-08-25 00:00;86;53;39;92
2020;August;35;2020-08-25 00:00;87;49;33;82
2020;August;35;2020-08-25 00:00;88;26;28;54
2020;August;35;2020-08-25 00:00;89;30;20;50
2020;August;35;2020-08-25 00:00;90;31;17;48
2020;August;35;2020-08-25 00:00;91;26;18;44
2020;August;35;2020-08-25 00:00;92;16;11;27
2020;August;35;2020-08-25 00:00;93;21;6;27
2020;August;35;2020-08-25 00:00;94;12;4;16
2020;August;35;2020-08-25 00:00;95;15;4;19
2020;August;35;2020-08-25 00:00;96;6;2;8
2020;August;35;2020-08-25 00:00;97;2;3;5
2020;August;35;2020-08-25 00:00;98;6;0;6
2020;August;35;2020-08-25 00:00;99;1;1;2
2020;August;35;2020-08-25 00:00;100;1;1;2
2020;August;35;2020-08-25 00:00;101;0;1;1
2020;August;35;2020-08-25 00:00;108;1;0;1
2020;September;36;2020-09-01 00:00;0;136;119;255
2020;September;36;2020-09-01 00:00;1;187;201;388
2020;September;36;2020-09-01 00:00;2;212;231;443
2020;September;36;2020-09-01 00:00;3;211;219;430
2020;September;36;2020-09-01 00:00;4;208;236;444
2020;September;36;2020-09-01 00:00;5;212;236;448
2020;September;36;2020-09-01 00:00;6;210;253;463
2020;September;36;2020-09-01 00:00;7;221;243;464
2020;September;36;2020-09-01 00:00;8;208;212;420
2020;September;36;2020-09-01 00:00;9;224;237;461
2020;September;36;2020-09-01 00:00;10;240;239;479
2020;September;36;2020-09-01 00:00;11;216;234;450
2020;September;36;2020-09-01 00:00;12;208;205;413
2020;September;36;2020-09-01 00:00;13;196;212;408
2020;September;36;2020-09-01 00:00;14;226;208;434
2020;September;36;2020-09-01 00:00;15;197;222;419
2020;September;36;2020-09-01 00:00;16;191;210;401
2020;September;36;2020-09-01 00:00;17;175;192;367
2020;September;36;2020-09-01 00:00;18;188;223;411
2020;September;36;2020-09-01 00:00;19;145;175;320
2020;September;36;2020-09-01 00:00;20;162;196;358
2020;September;36;2020-09-01 00:00;21;156;196;352
2020;September;36;2020-09-01 00:00;22;134;161;295
2020;September;36;2020-09-01 00:00;23;135;177;312
2020;September;36;2020-09-01 00:00;24;143;167;310
2020;September;36;2020-09-01 00:00;25;156;185;341
2020;September;36;2020-09-01 00:00;26;184;178;362
2020;September;36;2020-09-01 00:00;27;168;208;376
2020;September;36;2020-09-01 00:00;28;200;179;379
2020;September;36;2020-09-01 00:00;29;206;245;451
2020;September;36;2020-09-01 00:00;30;234;230;464
2020;September;36;2020-09-01 00:00;31;203;230;433
2020;September;36;2020-09-01 00:00;32;221;223;444
2020;September;36;2020-09-01 00:00;33;234;227;461
2020;September;36;2020-09-01 00:00;34;209;207;416
2020;September;36;2020-09-01 00:00;35;216;229;445
2020;September;36;2020-09-01 00:00;36;213;225;438
2020;September;36;2020-09-01 00:00;37;227;195;422
2020;September;36;2020-09-01 00:00;38;227;225;452
2020;September;36;2020-09-01 00:00;39;189;217;406
2020;September;36;2020-09-01 00:00;40;246;225;471
2020;September;36;2020-09-01 00:00;41;214;186;400
2020;September;36;2020-09-01 00:00;42;202;209;411
2020;September;36;2020-09-01 00:00;43;205;219;424
2020;September;36;2020-09-01 00:00;44;218;222;440
2020;September;36;2020-09-01 00:00;45;219;245;464
2020;September;36;2020-09-01 00:00;46;228;282;510
2020;September;36;2020-09-01 00:00;47;219;229;448
2020;September;36;2020-09-01 00:00;48;227;261;488
2020;September;36;2020-09-01 00:00;49;211;219;430
2020;September;36;2020-09-01 00:00;50;201;216;417
2020;September;36;2020-09-01 00:00;51;194;192;386
2020;September;36;2020-09-01 00:00;52;206;222;428
2020;September;36;2020-09-01 00:00;53;240;230;470
2020;September;36;2020-09-01 00:00;54;184;212;396
2020;September;36;2020-09-01 00:00;55;194;212;406
2020;September;36;2020-09-01 00:00;56;185;220;405
2020;September;36;2020-09-01 00:00;57;176;215;391
2020;September;36;2020-09-01 00:00;58;183;180;363
2020;September;36;2020-09-01 00:00;59;151;166;317
2020;September;36;2020-09-01 00:00;60;154;150;304
2020;September;36;2020-09-01 00:00;61;147;153;300
2020;September;36;2020-09-01 00:00;62;148;148;296
2020;September;36;2020-09-01 00:00;63;137;146;283
2020;September;36;2020-09-01 00:00;64;146;153;299
2020;September;36;2020-09-01 00:00;65;128;112;240
2020;September;36;2020-09-01 00:00;66;126;137;263
2020;September;36;2020-09-01 00:00;67;144;128;272
2020;September;36;2020-09-01 00:00;68;134;145;279
2020;September;36;2020-09-01 00:00;69;140;125;265
2020;September;36;2020-09-01 00:00;70;136;150;286
2020;September;36;2020-09-01 00:00;71;143;151;294
2020;September;36;2020-09-01 00:00;72;169;155;324
2020;September;36;2020-09-01 00:00;73;151;142;293
2020;September;36;2020-09-01 00:00;74;178;137;315
2020;September;36;2020-09-01 00:00;75;173;166;339
2020;September;36;2020-09-01 00:00;76;144;145;289
2020;September;36;2020-09-01 00:00;77;144;149;293
2020;September;36;2020-09-01 00:00;78;128;121;249
2020;September;36;2020-09-01 00:00;79;104;94;198
2020;September;36;2020-09-01 00:00;80;82;114;196
2020;September;36;2020-09-01 00:00;81;83;80;163
2020;September;36;2020-09-01 00:00;82;84;73;157
2020;September;36;2020-09-01 00:00;83;69;64;133
2020;September;36;2020-09-01 00:00;84;81;52;133
2020;September;36;2020-09-01 00:00;85;53;53;106
2020;September;36;2020-09-01 00:00;86;53;39;92
2020;September;36;2020-09-01 00:00;87;49;33;82
2020;September;36;2020-09-01 00:00;88;26;28;54
2020;September;36;2020-09-01 00:00;89;29;20;49
2020;September;36;2020-09-01 00:00;90;31;17;48
2020;September;36;2020-09-01 00:00;91;26;18;44
2020;September;36;2020-09-01 00:00;92;16;11;27
2020;September;36;2020-09-01 00:00;93;21;6;27
2020;September;36;2020-09-01 00:00;94;11;4;15
2020;September;36;2020-09-01 00:00;95;15;4;19
2020;September;36;2020-09-01 00:00;96;6;2;8
2020;September;36;2020-09-01 00:00;97;1;3;4
2020;September;36;2020-09-01 00:00;98;6;0;6
2020;September;36;2020-09-01 00:00;99;1;1;2
2020;September;36;2020-09-01 00:00;100;1;1;2
2020;September;36;2020-09-01 00:00;101;0;1;1
2020;September;36;2020-09-01 00:00;108;1;0;1
2020;September;37;2020-09-08 00:00;0;137;122;259
2020;September;37;2020-09-08 00:00;1;187;202;389
2020;September;37;2020-09-08 00:00;2;212;230;442
2020;September;37;2020-09-08 00:00;3;208;220;428
2020;September;37;2020-09-08 00:00;4;208;237;445
2020;September;37;2020-09-08 00:00;5;212;235;447
2020;September;37;2020-09-08 00:00;6;210;253;463
2020;September;37;2020-09-08 00:00;7;221;243;464
2020;September;37;2020-09-08 00:00;8;207;212;419
2020;September;37;2020-09-08 00:00;9;224;237;461
2020;September;37;2020-09-08 00:00;10;239;239;478
2020;September;37;2020-09-08 00:00;11;217;234;451
2020;September;37;2020-09-08 00:00;12;209;205;414
2020;September;37;2020-09-08 00:00;13;196;211;407
2020;September;37;2020-09-08 00:00;14;226;208;434
2020;September;37;2020-09-08 00:00;15;197;222;419
2020;September;37;2020-09-08 00:00;16;191;209;400
2020;September;37;2020-09-08 00:00;17;175;192;367
2020;September;37;2020-09-08 00:00;18;187;223;410
2020;September;37;2020-09-08 00:00;19;144;173;317
2020;September;37;2020-09-08 00:00;20;164;194;358
2020;September;37;2020-09-08 00:00;21;153;196;349
2020;September;37;2020-09-08 00:00;22;134;161;295
2020;September;37;2020-09-08 00:00;23;133;177;310
2020;September;37;2020-09-08 00:00;24;143;166;309
2020;September;37;2020-09-08 00:00;25;155;183;338
2020;September;37;2020-09-08 00:00;26;181;180;361
2020;September;37;2020-09-08 00:00;27;168;207;375
2020;September;37;2020-09-08 00:00;28;201;181;382
2020;September;37;2020-09-08 00:00;29;205;245;450
2020;September;37;2020-09-08 00:00;30;234;230;464
2020;September;37;2020-09-08 00:00;31;205;230;435
2020;September;37;2020-09-08 00:00;32;222;223;445
2020;September;37;2020-09-08 00:00;33;234;227;461
2020;September;37;2020-09-08 00:00;34;208;209;417
2020;September;37;2020-09-08 00:00;35;216;231;447
2020;September;37;2020-09-08 00:00;36;211;226;437
2020;September;37;2020-09-08 00:00;37;227;195;422
2020;September;37;2020-09-08 00:00;38;227;225;452
2020;September;37;2020-09-08 00:00;39;190;216;406
2020;September;37;2020-09-08 00:00;40;246;225;471
2020;September;37;2020-09-08 00:00;41;214;186;400
2020;September;37;2020-09-08 00:00;42;202;209;411
2020;September;37;2020-09-08 00:00;43;205;219;424
2020;September;37;2020-09-08 00:00;44;218;222;440
2020;September;37;2020-09-08 00:00;45;219;245;464
2020;September;37;2020-09-08 00:00;46;229;282;511
2020;September;37;2020-09-08 00:00;47;219;230;449
2020;September;37;2020-09-08 00:00;48;227;260;487
2020;September;37;2020-09-08 00:00;49;211;219;430
2020;September;37;2020-09-08 00:00;50;201;216;417
2020;September;37;2020-09-08 00:00;51;194;193;387
2020;September;37;2020-09-08 00:00;52;207;222;429
2020;September;37;2020-09-08 00:00;53;240;230;470
2020;September;37;2020-09-08 00:00;54;184;212;396
2020;September;37;2020-09-08 00:00;55;193;212;405
2020;September;37;2020-09-08 00:00;56;185;220;405
2020;September;37;2020-09-08 00:00;57;176;214;390
2020;September;37;2020-09-08 00:00;58;183;180;363
2020;September;37;2020-09-08 00:00;59;151;166;317
2020;September;37;2020-09-08 00:00;60;154;150;304
2020;September;37;2020-09-08 00:00;61;147;154;301
2020;September;37;2020-09-08 00:00;62;148;148;296
2020;September;37;2020-09-08 00:00;63;137;146;283
2020;September;37;2020-09-08 00:00;64;146;153;299
2020;September;37;2020-09-08 00:00;65;127;112;239
2020;September;37;2020-09-08 00:00;66;126;137;263
2020;September;37;2020-09-08 00:00;67;144;128;272
2020;September;37;2020-09-08 00:00;68;134;145;279
2020;September;37;2020-09-08 00:00;69;140;125;265
2020;September;37;2020-09-08 00:00;70;136;149;285
2020;September;37;2020-09-08 00:00;71;143;151;294
2020;September;37;2020-09-08 00:00;72;169;155;324
2020;September;37;2020-09-08 00:00;73;151;142;293
2020;September;37;2020-09-08 00:00;74;178;138;316
2020;September;37;2020-09-08 00:00;75;172;166;338
2020;September;37;2020-09-08 00:00;76;144;145;289
2020;September;37;2020-09-08 00:00;77;144;149;293
2020;September;37;2020-09-08 00:00;78;128;120;248
2020;September;37;2020-09-08 00:00;79;104;94;198
2020;September;37;2020-09-08 00:00;80;82;114;196
2020;September;37;2020-09-08 00:00;81;82;80;162
2020;September;37;2020-09-08 00:00;82;84;73;157
2020;September;37;2020-09-08 00:00;83;69;64;133
2020;September;37;2020-09-08 00:00;84;81;52;133
2020;September;37;2020-09-08 00:00;85;53;52;105
2020;September;37;2020-09-08 00:00;86;53;39;92
2020;September;37;2020-09-08 00:00;87;49;33;82
2020;September;37;2020-09-08 00:00;88;26;28;54
2020;September;37;2020-09-08 00:00;89;29;20;49
2020;September;37;2020-09-08 00:00;90;31;17;48
2020;September;37;2020-09-08 00:00;91;26;18;44
2020;September;37;2020-09-08 00:00;92;16;11;27
2020;September;37;2020-09-08 00:00;93;21;6;27
2020;September;37;2020-09-08 00:00;94;11;4;15
2020;September;37;2020-09-08 00:00;95;15;4;19
2020;September;37;2020-09-08 00:00;96;6;2;8
2020;September;37;2020-09-08 00:00;97;1;3;4
2020;September;37;2020-09-08 00:00;98;6;0;6
2020;September;37;2020-09-08 00:00;99;1;1;2
2020;September;37;2020-09-08 00:00;100;1;1;2
2020;September;37;2020-09-08 00:00;101;0;1;1
2020;September;37;2020-09-08 00:00;108;1;0;1
2020;September;38;2020-09-15 00:00;0;145;123;268
2020;September;38;2020-09-15 00:00;1;186;202;388
2020;September;38;2020-09-15 00:00;2;212;229;441
2020;September;38;2020-09-15 00:00;3;208;220;428
2020;September;38;2020-09-15 00:00;4;208;237;445
2020;September;38;2020-09-15 00:00;5;212;235;447
2020;September;38;2020-09-15 00:00;6;209;253;462
2020;September;38;2020-09-15 00:00;7;221;243;464
2020;September;38;2020-09-15 00:00;8;207;212;419
2020;September;38;2020-09-15 00:00;9;224;237;461
2020;September;38;2020-09-15 00:00;10;239;239;478
2020;September;38;2020-09-15 00:00;11;217;235;452
2020;September;38;2020-09-15 00:00;12;208;206;414
2020;September;38;2020-09-15 00:00;13;196;211;407
2020;September;38;2020-09-15 00:00;14;226;208;434
2020;September;38;2020-09-15 00:00;15;197;222;419
2020;September;38;2020-09-15 00:00;16;191;209;400
2020;September;38;2020-09-15 00:00;17;175;192;367
2020;September;38;2020-09-15 00:00;18;188;223;411
2020;September;38;2020-09-15 00:00;19;143;172;315
2020;September;38;2020-09-15 00:00;20;163;194;357
2020;September;38;2020-09-15 00:00;21;153;197;350
2020;September;38;2020-09-15 00:00;22;135;161;296
2020;September;38;2020-09-15 00:00;23;134;176;310
2020;September;38;2020-09-15 00:00;24;144;166;310
2020;September;38;2020-09-15 00:00;25;155;184;339
2020;September;38;2020-09-15 00:00;26;182;179;361
2020;September;38;2020-09-15 00:00;27;169;207;376
2020;September;38;2020-09-15 00:00;28;201;181;382
2020;September;38;2020-09-15 00:00;29;205;244;449
2020;September;38;2020-09-15 00:00;30;234;231;465
2020;September;38;2020-09-15 00:00;31;205;229;434
2020;September;38;2020-09-15 00:00;32;222;223;445
2020;September;38;2020-09-15 00:00;33;234;229;463
2020;September;38;2020-09-15 00:00;34;208;211;419
2020;September;38;2020-09-15 00:00;35;216;231;447
2020;September;38;2020-09-15 00:00;36;211;225;436
2020;September;38;2020-09-15 00:00;37;227;195;422
2020;September;38;2020-09-15 00:00;38;227;225;452
2020;September;38;2020-09-15 00:00;39;191;216;407
2020;September;38;2020-09-15 00:00;40;245;226;471
2020;September;38;2020-09-15 00:00;41;214;185;399
2020;September;38;2020-09-15 00:00;42;203;209;412
2020;September;38;2020-09-15 00:00;43;206;220;426
2020;September;38;2020-09-15 00:00;44;218;222;440
2020;September;38;2020-09-15 00:00;45;219;245;464
2020;September;38;2020-09-15 00:00;46;229;281;510
2020;September;38;2020-09-15 00:00;47;219;230;449
2020;September;38;2020-09-15 00:00;48;227;259;486
2020;September;38;2020-09-15 00:00;49;211;220;431
2020;September;38;2020-09-15 00:00;50;201;216;417
2020;September;38;2020-09-15 00:00;51;194;194;388
2020;September;38;2020-09-15 00:00;52;207;222;429
2020;September;38;2020-09-15 00:00;53;240;229;469
2020;September;38;2020-09-15 00:00;54;184;212;396
2020;September;38;2020-09-15 00:00;55;193;212;405
2020;September;38;2020-09-15 00:00;56;185;220;405
2020;September;38;2020-09-15 00:00;57;176;213;389
2020;September;38;2020-09-15 00:00;58;183;180;363
2020;September;38;2020-09-15 00:00;59;151;166;317
2020;September;38;2020-09-15 00:00;60;154;150;304
2020;September;38;2020-09-15 00:00;61;147;154;301
2020;September;38;2020-09-15 00:00;62;147;148;295
2020;September;38;2020-09-15 00:00;63;137;146;283
2020;September;38;2020-09-15 00:00;64;146;153;299
2020;September;38;2020-09-15 00:00;65;127;112;239
2020;September;38;2020-09-15 00:00;66;126;137;263
2020;September;38;2020-09-15 00:00;67;145;128;273
2020;September;38;2020-09-15 00:00;68;134;145;279
2020;September;38;2020-09-15 00:00;69;140;125;265
2020;September;38;2020-09-15 00:00;70;136;149;285
2020;September;38;2020-09-15 00:00;71;143;152;295
2020;September;38;2020-09-15 00:00;72;169;155;324
2020;September;38;2020-09-15 00:00;73;151;142;293
2020;September;38;2020-09-15 00:00;74;178;138;316
2020;September;38;2020-09-15 00:00;75;172;166;338
2020;September;38;2020-09-15 00:00;76;144;145;289
2020;September;38;2020-09-15 00:00;77;144;149;293
2020;September;38;2020-09-15 00:00;78;128;119;247
2020;September;38;2020-09-15 00:00;79;104;94;198
2020;September;38;2020-09-15 00:00;80;82;114;196
2020;September;38;2020-09-15 00:00;81;82;80;162
2020;September;38;2020-09-15 00:00;82;84;72;156
2020;September;38;2020-09-15 00:00;83;69;64;133
2020;September;38;2020-09-15 00:00;84;81;52;133
2020;September;38;2020-09-15 00:00;85;53;52;105
2020;September;38;2020-09-15 00:00;86;53;39;92
2020;September;38;2020-09-15 00:00;87;49;33;82
2020;September;38;2020-09-15 00:00;88;26;28;54
2020;September;38;2020-09-15 00:00;89;29;20;49
2020;September;38;2020-09-15 00:00;90;31;17;48
2020;September;38;2020-09-15 00:00;91;26;18;44
2020;September;38;2020-09-15 00:00;92;16;11;27
2020;September;38;2020-09-15 00:00;93;21;6;27
2020;September;38;2020-09-15 00:00;94;10;4;14
2020;September;38;2020-09-15 00:00;95;15;4;19
2020;September;38;2020-09-15 00:00;96;6;2;8
2020;September;38;2020-09-15 00:00;97;1;3;4
2020;September;38;2020-09-15 00:00;98;6;0;6
2020;September;38;2020-09-15 00:00;99;1;1;2
2020;September;38;2020-09-15 00:00;100;1;1;2
2020;September;38;2020-09-15 00:00;101;0;1;1
2020;September;38;2020-09-15 00:00;108;1;0;1
2020;September;39;2020-09-22 00:00;0;149;130;279
2020;September;39;2020-09-22 00:00;1;187;202;389
2020;September;39;2020-09-22 00:00;2;212;229;441
2020;September;39;2020-09-22 00:00;3;208;220;428
2020;September;39;2020-09-22 00:00;4;208;237;445
2020;September;39;2020-09-22 00:00;5;212;235;447
2020;September;39;2020-09-22 00:00;6;210;253;463
2020;September;39;2020-09-22 00:00;7;221;243;464
2020;September;39;2020-09-22 00:00;8;207;212;419
2020;September;39;2020-09-22 00:00;9;223;236;459
2020;September;39;2020-09-22 00:00;10;239;239;478
2020;September;39;2020-09-22 00:00;11;217;235;452
2020;September;39;2020-09-22 00:00;12;208;205;413
2020;September;39;2020-09-22 00:00;13;196;211;407
2020;September;39;2020-09-22 00:00;14;226;208;434
2020;September;39;2020-09-22 00:00;15;197;222;419
2020;September;39;2020-09-22 00:00;16;191;209;400
2020;September;39;2020-09-22 00:00;17;175;192;367
2020;September;39;2020-09-22 00:00;18;188;223;411
2020;September;39;2020-09-22 00:00;19;144;174;318
2020;September;39;2020-09-22 00:00;20;162;193;355
2020;September;39;2020-09-22 00:00;21;153;197;350
2020;September;39;2020-09-22 00:00;22;135;160;295
2020;September;39;2020-09-22 00:00;23;132;176;308
2020;September;39;2020-09-22 00:00;24;145;165;310
2020;September;39;2020-09-22 00:00;25;155;184;339
2020;September;39;2020-09-22 00:00;26;182;178;360
2020;September;39;2020-09-22 00:00;27;171;207;378
2020;September;39;2020-09-22 00:00;28;200;181;381
2020;September;39;2020-09-22 00:00;29;205;245;450
2020;September;39;2020-09-22 00:00;30;234;230;464
2020;September;39;2020-09-22 00:00;31;205;229;434
2020;September;39;2020-09-22 00:00;32;222;222;444
2020;September;39;2020-09-22 00:00;33;235;230;465
2020;September;39;2020-09-22 00:00;34;208;211;419
2020;September;39;2020-09-22 00:00;35;216;231;447
2020;September;39;2020-09-22 00:00;36;211;226;437
2020;September;39;2020-09-22 00:00;37;226;195;421
2020;September;39;2020-09-22 00:00;38;227;225;452
2020;September;39;2020-09-22 00:00;39;191;217;408
2020;September;39;2020-09-22 00:00;40;247;226;473
2020;September;39;2020-09-22 00:00;41;214;185;399
2020;September;39;2020-09-22 00:00;42;203;209;412
2020;September;39;2020-09-22 00:00;43;205;219;424
2020;September;39;2020-09-22 00:00;44;218;222;440
2020;September;39;2020-09-22 00:00;45;218;245;463
2020;September;39;2020-09-22 00:00;46;229;281;510
2020;September;39;2020-09-22 00:00;47;219;230;449
2020;September;39;2020-09-22 00:00;48;227;259;486
2020;September;39;2020-09-22 00:00;49;211;220;431
2020;September;39;2020-09-22 00:00;50;201;216;417
2020;September;39;2020-09-22 00:00;51;194;194;388
2020;September;39;2020-09-22 00:00;52;207;221;428
2020;September;39;2020-09-22 00:00;53;240;229;469
2020;September;39;2020-09-22 00:00;54;184;212;396
2020;September;39;2020-09-22 00:00;55;193;212;405
2020;September;39;2020-09-22 00:00;56;185;218;403
2020;September;39;2020-09-22 00:00;57;176;214;390
2020;September;39;2020-09-22 00:00;58;183;180;363
2020;September;39;2020-09-22 00:00;59;151;166;317
2020;September;39;2020-09-22 00:00;60;154;150;304
2020;September;39;2020-09-22 00:00;61;146;153;299
2020;September;39;2020-09-22 00:00;62;147;148;295
2020;September;39;2020-09-22 00:00;63;137;146;283
2020;September;39;2020-09-22 00:00;64;146;153;299
2020;September;39;2020-09-22 00:00;65;127;112;239
2020;September;39;2020-09-22 00:00;66;126;137;263
2020;September;39;2020-09-22 00:00;67;145;128;273
2020;September;39;2020-09-22 00:00;68;134;145;279
2020;September;39;2020-09-22 00:00;69;140;125;265
2020;September;39;2020-09-22 00:00;70;136;149;285
2020;September;39;2020-09-22 00:00;71;143;152;295
2020;September;39;2020-09-22 00:00;72;169;155;324
2020;September;39;2020-09-22 00:00;73;151;142;293
2020;September;39;2020-09-22 00:00;74;178;138;316
2020;September;39;2020-09-22 00:00;75;172;166;338
2020;September;39;2020-09-22 00:00;76;144;145;289
2020;September;39;2020-09-22 00:00;77;144;149;293
2020;September;39;2020-09-22 00:00;78;128;119;247
2020;September;39;2020-09-22 00:00;79;104;94;198
2020;September;39;2020-09-22 00:00;80;82;114;196
2020;September;39;2020-09-22 00:00;81;82;80;162
2020;September;39;2020-09-22 00:00;82;83;72;155
2020;September;39;2020-09-22 00:00;83;69;64;133
2020;September;39;2020-09-22 00:00;84;81;52;133
2020;September;39;2020-09-22 00:00;85;53;52;105
2020;September;39;2020-09-22 00:00;86;52;39;91
2020;September;39;2020-09-22 00:00;87;49;33;82
2020;September;39;2020-09-22 00:00;88;26;28;54
2020;September;39;2020-09-22 00:00;89;28;20;48
2020;September;39;2020-09-22 00:00;90;31;17;48
2020;September;39;2020-09-22 00:00;91;27;18;45
2020;September;39;2020-09-22 00:00;92;16;10;26
2020;September;39;2020-09-22 00:00;93;21;6;27
2020;September;39;2020-09-22 00:00;94;10;4;14
2020;September;39;2020-09-22 00:00;95;15;4;19
2020;September;39;2020-09-22 00:00;96;6;2;8
2020;September;39;2020-09-22 00:00;97;1;3;4
2020;September;39;2020-09-22 00:00;98;6;0;6
2020;September;39;2020-09-22 00:00;99;1;1;2
2020;September;39;2020-09-22 00:00;100;1;1;2
2020;September;39;2020-09-22 00:00;101;0;1;1
2020;September;39;2020-09-22 00:00;108;1;0;1
2020;September;40;2020-09-29 00:00;0;154;133;287
2020;September;40;2020-09-29 00:00;1;187;204;391
2020;September;40;2020-09-29 00:00;2;213;228;441
2020;September;40;2020-09-29 00:00;3;209;221;430
2020;September;40;2020-09-29 00:00;4;209;237;446
2020;September;40;2020-09-29 00:00;5;212;234;446
2020;September;40;2020-09-29 00:00;6;210;253;463
2020;September;40;2020-09-29 00:00;7;221;243;464
2020;September;40;2020-09-29 00:00;8;207;212;419
2020;September;40;2020-09-29 00:00;9;223;236;459
2020;September;40;2020-09-29 00:00;10;239;239;478
2020;September;40;2020-09-29 00:00;11;217;235;452
2020;September;40;2020-09-29 00:00;12;208;205;413
2020;September;40;2020-09-29 00:00;13;196;212;408
2020;September;40;2020-09-29 00:00;14;226;208;434
2020;September;40;2020-09-29 00:00;15;197;222;419
2020;September;40;2020-09-29 00:00;16;191;210;401
2020;September;40;2020-09-29 00:00;17;175;192;367
2020;September;40;2020-09-29 00:00;18;189;224;413
2020;September;40;2020-09-29 00:00;19;143;173;316
2020;September;40;2020-09-29 00:00;20;162;193;355
2020;September;40;2020-09-29 00:00;21;151;197;348
2020;September;40;2020-09-29 00:00;22;134;159;293
2020;September;40;2020-09-29 00:00;23;133;175;308
2020;September;40;2020-09-29 00:00;24;144;165;309
2020;September;40;2020-09-29 00:00;25;154;184;338
2020;September;40;2020-09-29 00:00;26;184;178;362
2020;September;40;2020-09-29 00:00;27;171;207;378
2020;September;40;2020-09-29 00:00;28;202;179;381
2020;September;40;2020-09-29 00:00;29;204;243;447
2020;September;40;2020-09-29 00:00;30;234;230;464
2020;September;40;2020-09-29 00:00;31;206;230;436
2020;September;40;2020-09-29 00:00;32;224;224;448
2020;September;40;2020-09-29 00:00;33;234;231;465
2020;September;40;2020-09-29 00:00;34;208;210;418
2020;September;40;2020-09-29 00:00;35;216;231;447
2020;September;40;2020-09-29 00:00;36;211;226;437
2020;September;40;2020-09-29 00:00;37;225;195;420
2020;September;40;2020-09-29 00:00;38;227;225;452
2020;September;40;2020-09-29 00:00;39;192;216;408
2020;September;40;2020-09-29 00:00;40;247;226;473
2020;September;40;2020-09-29 00:00;41;214;185;399
2020;September;40;2020-09-29 00:00;42;203;209;412
2020;September;40;2020-09-29 00:00;43;205;218;423
2020;September;40;2020-09-29 00:00;44;218;221;439
2020;September;40;2020-09-29 00:00;45;218;246;464
2020;September;40;2020-09-29 00:00;46;229;281;510
2020;September;40;2020-09-29 00:00;47;219;230;449
2020;September;40;2020-09-29 00:00;48;227;260;487
2020;September;40;2020-09-29 00:00;49;211;220;431
2020;September;40;2020-09-29 00:00;50;201;216;417
2020;September;40;2020-09-29 00:00;51;194;194;388
2020;September;40;2020-09-29 00:00;52;205;221;426
2020;September;40;2020-09-29 00:00;53;240;229;469
2020;September;40;2020-09-29 00:00;54;185;213;398
2020;September;40;2020-09-29 00:00;55;193;212;405
2020;September;40;2020-09-29 00:00;56;185;218;403
2020;September;40;2020-09-29 00:00;57;176;214;390
2020;September;40;2020-09-29 00:00;58;182;180;362
2020;September;40;2020-09-29 00:00;59;152;166;318
2020;September;40;2020-09-29 00:00;60;154;150;304
2020;September;40;2020-09-29 00:00;61;146;153;299
2020;September;40;2020-09-29 00:00;62;147;147;294
2020;September;40;2020-09-29 00:00;63;137;146;283
2020;September;40;2020-09-29 00:00;64;146;153;299
2020;September;40;2020-09-29 00:00;65;127;112;239
2020;September;40;2020-09-29 00:00;66;126;137;263
2020;September;40;2020-09-29 00:00;67;145;128;273
2020;September;40;2020-09-29 00:00;68;134;145;279
2020;September;40;2020-09-29 00:00;69;140;125;265
2020;September;40;2020-09-29 00:00;70;136;149;285
2020;September;40;2020-09-29 00:00;71;143;152;295
2020;September;40;2020-09-29 00:00;72;169;155;324
2020;September;40;2020-09-29 00:00;73;150;142;292
2020;September;40;2020-09-29 00:00;74;178;138;316
2020;September;40;2020-09-29 00:00;75;172;166;338
2020;September;40;2020-09-29 00:00;76;144;145;289
2020;September;40;2020-09-29 00:00;77;144;149;293
2020;September;40;2020-09-29 00:00;78;127;119;246
2020;September;40;2020-09-29 00:00;79;104;93;197
2020;September;40;2020-09-29 00:00;80;82;114;196
2020;September;40;2020-09-29 00:00;81;82;80;162
2020;September;40;2020-09-29 00:00;82;83;72;155
2020;September;40;2020-09-29 00:00;83;69;64;133
2020;September;40;2020-09-29 00:00;84;81;51;132
2020;September;40;2020-09-29 00:00;85;53;52;105
2020;September;40;2020-09-29 00:00;86;53;39;92
2020;September;40;2020-09-29 00:00;87;49;33;82
2020;September;40;2020-09-29 00:00;88;26;28;54
2020;September;40;2020-09-29 00:00;89;28;20;48
2020;September;40;2020-09-29 00:00;90;31;16;47
2020;September;40;2020-09-29 00:00;91;27;18;45
2020;September;40;2020-09-29 00:00;92;16;10;26
2020;September;40;2020-09-29 00:00;93;21;6;27
2020;September;40;2020-09-29 00:00;94;10;4;14
2020;September;40;2020-09-29 00:00;95;15;4;19
2020;September;40;2020-09-29 00:00;96;6;2;8
2020;September;40;2020-09-29 00:00;97;1;3;4
2020;September;40;2020-09-29 00:00;98;6;0;6
2020;September;40;2020-09-29 00:00;99;1;1;2
2020;September;40;2020-09-29 00:00;100;1;1;2
2020;September;40;2020-09-29 00:00;101;0;1;1
2020;September;40;2020-09-29 00:00;108;1;0;1
2020;October;41;2020-10-06 00:00;0;158;134;292
2020;October;41;2020-10-06 00:00;1;186;206;392
2020;October;41;2020-10-06 00:00;2;210;228;438
2020;October;41;2020-10-06 00:00;3;207;220;427
2020;October;41;2020-10-06 00:00;4;209;236;445
2020;October;41;2020-10-06 00:00;5;211;234;445
2020;October;41;2020-10-06 00:00;6;211;251;462
2020;October;41;2020-10-06 00:00;7;221;244;465
2020;October;41;2020-10-06 00:00;8;207;212;419
2020;October;41;2020-10-06 00:00;9;223;237;460
2020;October;41;2020-10-06 00:00;10;239;239;478
2020;October;41;2020-10-06 00:00;11;217;235;452
2020;October;41;2020-10-06 00:00;12;208;206;414
2020;October;41;2020-10-06 00:00;13;196;212;408
2020;October;41;2020-10-06 00:00;14;226;209;435
2020;October;41;2020-10-06 00:00;15;197;221;418
2020;October;41;2020-10-06 00:00;16;191;210;401
2020;October;41;2020-10-06 00:00;17;177;192;369
2020;October;41;2020-10-06 00:00;18;189;224;413
2020;October;41;2020-10-06 00:00;19;143;173;316
2020;October;41;2020-10-06 00:00;20;158;190;348
2020;October;41;2020-10-06 00:00;21;152;195;347
2020;October;41;2020-10-06 00:00;22;133;159;292
2020;October;41;2020-10-06 00:00;23;132;173;305
2020;October;41;2020-10-06 00:00;24;143;166;309
2020;October;41;2020-10-06 00:00;25;152;181;333
2020;October;41;2020-10-06 00:00;26;181;178;359
2020;October;41;2020-10-06 00:00;27;170;206;376
2020;October;41;2020-10-06 00:00;28;201;178;379
2020;October;41;2020-10-06 00:00;29;203;242;445
2020;October;41;2020-10-06 00:00;30;234;230;464
2020;October;41;2020-10-06 00:00;31;207;231;438
2020;October;41;2020-10-06 00:00;32;223;221;444
2020;October;41;2020-10-06 00:00;33;235;230;465
2020;October;41;2020-10-06 00:00;34;209;210;419
2020;October;41;2020-10-06 00:00;35;217;230;447
2020;October;41;2020-10-06 00:00;36;210;226;436
2020;October;41;2020-10-06 00:00;37;225;195;420
2020;October;41;2020-10-06 00:00;38;226;225;451
2020;October;41;2020-10-06 00:00;39;189;217;406
2020;October;41;2020-10-06 00:00;40;247;225;472
2020;October;41;2020-10-06 00:00;41;213;185;398
2020;October;41;2020-10-06 00:00;42;203;209;412
2020;October;41;2020-10-06 00:00;43;204;219;423
2020;October;41;2020-10-06 00:00;44;220;222;442
2020;October;41;2020-10-06 00:00;45;219;246;465
2020;October;41;2020-10-06 00:00;46;229;281;510
2020;October;41;2020-10-06 00:00;47;219;230;449
2020;October;41;2020-10-06 00:00;48;226;262;488
2020;October;41;2020-10-06 00:00;49;211;220;431
2020;October;41;2020-10-06 00:00;50;202;216;418
2020;October;41;2020-10-06 00:00;51;195;194;389
2020;October;41;2020-10-06 00:00;52;206;220;426
2020;October;41;2020-10-06 00:00;53;239;229;468
2020;October;41;2020-10-06 00:00;54;185;213;398
2020;October;41;2020-10-06 00:00;55;194;215;409
2020;October;41;2020-10-06 00:00;56;184;219;403
2020;October;41;2020-10-06 00:00;57;176;214;390
2020;October;41;2020-10-06 00:00;58;183;181;364
2020;October;41;2020-10-06 00:00;59;152;165;317
2020;October;41;2020-10-06 00:00;60;155;150;305
2020;October;41;2020-10-06 00:00;61;146;153;299
2020;October;41;2020-10-06 00:00;62;147;147;294
2020;October;41;2020-10-06 00:00;63;137;145;282
2020;October;41;2020-10-06 00:00;64;146;153;299
2020;October;41;2020-10-06 00:00;65;127;111;238
2020;October;41;2020-10-06 00:00;66;126;137;263
2020;October;41;2020-10-06 00:00;67;145;128;273
2020;October;41;2020-10-06 00:00;68;133;145;278
2020;October;41;2020-10-06 00:00;69;140;125;265
2020;October;41;2020-10-06 00:00;70;136;149;285
2020;October;41;2020-10-06 00:00;71;142;151;293
2020;October;41;2020-10-06 00:00;72;169;154;323
2020;October;41;2020-10-06 00:00;73;150;142;292
2020;October;41;2020-10-06 00:00;74;178;138;316
2020;October;41;2020-10-06 00:00;75;173;166;339
2020;October;41;2020-10-06 00:00;76;144;145;289
2020;October;41;2020-10-06 00:00;77;144;149;293
2020;October;41;2020-10-06 00:00;78;127;119;246
2020;October;41;2020-10-06 00:00;79;103;93;196
2020;October;41;2020-10-06 00:00;80;81;114;195
2020;October;41;2020-10-06 00:00;81;82;80;162
2020;October;41;2020-10-06 00:00;82;83;72;155
2020;October;41;2020-10-06 00:00;83;69;64;133
2020;October;41;2020-10-06 00:00;84;81;51;132
2020;October;41;2020-10-06 00:00;85;53;52;105
2020;October;41;2020-10-06 00:00;86;53;38;91
2020;October;41;2020-10-06 00:00;87;49;33;82
2020;October;41;2020-10-06 00:00;88;26;28;54
2020;October;41;2020-10-06 00:00;89;28;20;48
2020;October;41;2020-10-06 00:00;90;31;16;47
2020;October;41;2020-10-06 00:00;91;27;18;45
2020;October;41;2020-10-06 00:00;92;16;10;26
2020;October;41;2020-10-06 00:00;93;20;6;26
2020;October;41;2020-10-06 00:00;94;10;4;14
2020;October;41;2020-10-06 00:00;95;15;4;19
2020;October;41;2020-10-06 00:00;96;6;2;8
2020;October;41;2020-10-06 00:00;97;1;3;4
2020;October;41;2020-10-06 00:00;98;6;0;6
2020;October;41;2020-10-06 00:00;99;1;1;2
2020;October;41;2020-10-06 00:00;100;1;1;2
2020;October;41;2020-10-06 00:00;101;0;1;1
2020;October;41;2020-10-06 00:00;108;1;0;1
2020;October;43;2020-10-20 00:00;0;165;142;307
2020;October;43;2020-10-20 00:00;1;187;207;394
2020;October;43;2020-10-20 00:00;2;210;230;440
2020;October;43;2020-10-20 00:00;3;206;220;426
2020;October;43;2020-10-20 00:00;4;210;235;445
2020;October;43;2020-10-20 00:00;5;211;234;445
2020;October;43;2020-10-20 00:00;6;211;251;462
2020;October;43;2020-10-20 00:00;7;221;244;465
2020;October;43;2020-10-20 00:00;8;207;213;420
2020;October;43;2020-10-20 00:00;9;223;237;460
2020;October;43;2020-10-20 00:00;10;239;239;478
2020;October;43;2020-10-20 00:00;11;217;235;452
2020;October;43;2020-10-20 00:00;12;209;206;415
2020;October;43;2020-10-20 00:00;13;196;212;408
2020;October;43;2020-10-20 00:00;14;227;209;436
2020;October;43;2020-10-20 00:00;15;196;221;417
2020;October;43;2020-10-20 00:00;16;192;209;401
2020;October;43;2020-10-20 00:00;17;178;192;370
2020;October;43;2020-10-20 00:00;18;190;224;414
2020;October;43;2020-10-20 00:00;19;139;174;313
2020;October;43;2020-10-20 00:00;20;159;190;349
2020;October;43;2020-10-20 00:00;21;150;194;344
2020;October;43;2020-10-20 00:00;22;133;159;292
2020;October;43;2020-10-20 00:00;23;134;173;307
2020;October;43;2020-10-20 00:00;24;145;168;313
2020;October;43;2020-10-20 00:00;25;150;182;332
2020;October;43;2020-10-20 00:00;26;180;180;360
2020;October;43;2020-10-20 00:00;27;171;208;379
2020;October;43;2020-10-20 00:00;28;200;177;377
2020;October;43;2020-10-20 00:00;29;203;241;444
2020;October;43;2020-10-20 00:00;30;235;229;464
2020;October;43;2020-10-20 00:00;31;207;233;440
2020;October;43;2020-10-20 00:00;32;223;221;444
2020;October;43;2020-10-20 00:00;33;234;230;464
2020;October;43;2020-10-20 00:00;34;210;209;419
2020;October;43;2020-10-20 00:00;35;218;229;447
2020;October;43;2020-10-20 00:00;36;212;225;437
2020;October;43;2020-10-20 00:00;37;226;196;422
2020;October;43;2020-10-20 00:00;38;226;225;451
2020;October;43;2020-10-20 00:00;39;190;219;409
2020;October;43;2020-10-20 00:00;40;245;226;471
2020;October;43;2020-10-20 00:00;41;213;185;398
2020;October;43;2020-10-20 00:00;42;203;208;411
2020;October;43;2020-10-20 00:00;43;204;219;423
2020;October;43;2020-10-20 00:00;44;220;223;443
2020;October;43;2020-10-20 00:00;45;220;245;465
2020;October;43;2020-10-20 00:00;46;229;281;510
2020;October;43;2020-10-20 00:00;47;219;230;449
2020;October;43;2020-10-20 00:00;48;226;263;489
2020;October;43;2020-10-20 00:00;49;211;220;431
2020;October;43;2020-10-20 00:00;50;201;215;416
2020;October;43;2020-10-20 00:00;51;195;194;389
2020;October;43;2020-10-20 00:00;52;207;220;427
2020;October;43;2020-10-20 00:00;53;239;230;469
2020;October;43;2020-10-20 00:00;54;186;212;398
2020;October;43;2020-10-20 00:00;55;195;215;410
2020;October;43;2020-10-20 00:00;56;185;219;404
2020;October;43;2020-10-20 00:00;57;176;214;390
2020;October;43;2020-10-20 00:00;58;183;181;364
2020;October;43;2020-10-20 00:00;59;152;165;317
2020;October;43;2020-10-20 00:00;60;156;150;306
2020;October;43;2020-10-20 00:00;61;146;154;300
2020;October;43;2020-10-20 00:00;62;148;147;295
2020;October;43;2020-10-20 00:00;63;137;145;282
2020;October;43;2020-10-20 00:00;64;146;153;299
2020;October;43;2020-10-20 00:00;65;127;112;239
2020;October;43;2020-10-20 00:00;66;126;137;263
2020;October;43;2020-10-20 00:00;67;145;127;272
2020;October;43;2020-10-20 00:00;68;132;145;277
2020;October;43;2020-10-20 00:00;69;140;125;265
2020;October;43;2020-10-20 00:00;70;136;148;284
2020;October;43;2020-10-20 00:00;71;142;151;293
2020;October;43;2020-10-20 00:00;72;169;154;323
2020;October;43;2020-10-20 00:00;73;150;142;292
2020;October;43;2020-10-20 00:00;74;178;138;316
2020;October;43;2020-10-20 00:00;75;173;166;339
2020;October;43;2020-10-20 00:00;76;144;145;289
2020;October;43;2020-10-20 00:00;77;144;150;294
2020;October;43;2020-10-20 00:00;78;127;119;246
2020;October;43;2020-10-20 00:00;79;103;93;196
2020;October;43;2020-10-20 00:00;80;81;113;194
2020;October;43;2020-10-20 00:00;81;83;80;163
2020;October;43;2020-10-20 00:00;82;83;72;155
2020;October;43;2020-10-20 00:00;83;69;63;132
2020;October;43;2020-10-20 00:00;84;81;51;132
2020;October;43;2020-10-20 00:00;85;52;52;104
2020;October;43;2020-10-20 00:00;86;53;38;91
2020;October;43;2020-10-20 00:00;87;49;33;82
2020;October;43;2020-10-20 00:00;88;26;27;53
2020;October;43;2020-10-20 00:00;89;28;20;48
2020;October;43;2020-10-20 00:00;90;31;16;47
2020;October;43;2020-10-20 00:00;91;27;18;45
2020;October;43;2020-10-20 00:00;92;16;10;26
2020;October;43;2020-10-20 00:00;93;20;6;26
2020;October;43;2020-10-20 00:00;94;10;4;14
2020;October;43;2020-10-20 00:00;95;15;4;19
2020;October;43;2020-10-20 00:00;96;6;2;8
2020;October;43;2020-10-20 00:00;97;1;3;4
2020;October;43;2020-10-20 00:00;98;6;0;6
2020;October;43;2020-10-20 00:00;99;1;1;2
2020;October;43;2020-10-20 00:00;100;1;1;2
2020;October;43;2020-10-20 00:00;101;0;1;1
2020;October;43;2020-10-20 00:00;108;1;0;1
2020;October;44;2020-10-27 00:00;0;171;145;316
2020;October;44;2020-10-27 00:00;1;187;207;394
2020;October;44;2020-10-27 00:00;2;209;230;439
2020;October;44;2020-10-27 00:00;3;206;220;426
2020;October;44;2020-10-27 00:00;4;210;234;444
2020;October;44;2020-10-27 00:00;5;211;234;445
2020;October;44;2020-10-27 00:00;6;211;251;462
2020;October;44;2020-10-27 00:00;7;221;244;465
2020;October;44;2020-10-27 00:00;8;207;213;420
2020;October;44;2020-10-27 00:00;9;224;237;461
2020;October;44;2020-10-27 00:00;10;239;239;478
2020;October;44;2020-10-27 00:00;11;217;236;453
2020;October;44;2020-10-27 00:00;12;209;205;414
2020;October;44;2020-10-27 00:00;13;195;212;407
2020;October;44;2020-10-27 00:00;14;227;209;436
2020;October;44;2020-10-27 00:00;15;196;221;417
2020;October;44;2020-10-27 00:00;16;192;209;401
2020;October;44;2020-10-27 00:00;17;178;192;370
2020;October;44;2020-10-27 00:00;18;189;224;413
2020;October;44;2020-10-27 00:00;19;140;175;315
2020;October;44;2020-10-27 00:00;20;160;190;350
2020;October;44;2020-10-27 00:00;21;149;195;344
2020;October;44;2020-10-27 00:00;22;133;159;292
2020;October;44;2020-10-27 00:00;23;133;173;306
2020;October;44;2020-10-27 00:00;24;145;168;313
2020;October;44;2020-10-27 00:00;25;150;182;332
2020;October;44;2020-10-27 00:00;26;181;180;361
2020;October;44;2020-10-27 00:00;27;171;208;379
2020;October;44;2020-10-27 00:00;28;200;178;378
2020;October;44;2020-10-27 00:00;29;203;241;444
2020;October;44;2020-10-27 00:00;30;235;230;465
2020;October;44;2020-10-27 00:00;31;208;233;441
2020;October;44;2020-10-27 00:00;32;223;221;444
2020;October;44;2020-10-27 00:00;33;233;230;463
2020;October;44;2020-10-27 00:00;34;210;209;419
2020;October;44;2020-10-27 00:00;35;217;229;446
2020;October;44;2020-10-27 00:00;36;212;225;437
2020;October;44;2020-10-27 00:00;37;226;196;422
2020;October;44;2020-10-27 00:00;38;226;225;451
2020;October;44;2020-10-27 00:00;39;190;219;409
2020;October;44;2020-10-27 00:00;40;245;225;470
2020;October;44;2020-10-27 00:00;41;213;185;398
2020;October;44;2020-10-27 00:00;42;204;210;414
2020;October;44;2020-10-27 00:00;43;204;219;423
2020;October;44;2020-10-27 00:00;44;220;223;443
2020;October;44;2020-10-27 00:00;45;220;245;465
2020;October;44;2020-10-27 00:00;46;229;280;509
2020;October;44;2020-10-27 00:00;47;219;229;448
2020;October;44;2020-10-27 00:00;48;226;263;489
2020;October;44;2020-10-27 00:00;49;211;220;431
2020;October;44;2020-10-27 00:00;50;201;215;416
2020;October;44;2020-10-27 00:00;51;195;194;389
2020;October;44;2020-10-27 00:00;52;207;220;427
2020;October;44;2020-10-27 00:00;53;240;230;470
2020;October;44;2020-10-27 00:00;54;186;212;398
2020;October;44;2020-10-27 00:00;55;195;215;410
2020;October;44;2020-10-27 00:00;56;185;219;404
2020;October;44;2020-10-27 00:00;57;176;214;390
2020;October;44;2020-10-27 00:00;58;183;181;364
2020;October;44;2020-10-27 00:00;59;152;165;317
2020;October;44;2020-10-27 00:00;60;156;150;306
2020;October;44;2020-10-27 00:00;61;146;154;300
2020;October;44;2020-10-27 00:00;62;148;147;295
2020;October;44;2020-10-27 00:00;63;136;145;281
2020;October;44;2020-10-27 00:00;64;146;153;299
2020;October;44;2020-10-27 00:00;65;127;112;239
2020;October;44;2020-10-27 00:00;66;126;137;263
2020;October;44;2020-10-27 00:00;67;145;127;272
2020;October;44;2020-10-27 00:00;68;132;145;277
2020;October;44;2020-10-27 00:00;69;140;125;265
2020;October;44;2020-10-27 00:00;70;136;148;284
2020;October;44;2020-10-27 00:00;71;142;151;293
2020;October;44;2020-10-27 00:00;72;169;153;322
2020;October;44;2020-10-27 00:00;73;150;142;292
2020;October;44;2020-10-27 00:00;74;178;138;316
2020;October;44;2020-10-27 00:00;75;173;166;339
2020;October;44;2020-10-27 00:00;76;144;144;288
2020;October;44;2020-10-27 00:00;77;144;150;294
2020;October;44;2020-10-27 00:00;78;127;119;246
2020;October;44;2020-10-27 00:00;79;103;93;196
2020;October;44;2020-10-27 00:00;80;81;113;194
2020;October;44;2020-10-27 00:00;81;83;80;163
2020;October;44;2020-10-27 00:00;82;83;72;155
2020;October;44;2020-10-27 00:00;83;69;63;132
2020;October;44;2020-10-27 00:00;84;81;51;132
2020;October;44;2020-10-27 00:00;85;52;51;103
2020;October;44;2020-10-27 00:00;86;53;38;91
2020;October;44;2020-10-27 00:00;87;49;33;82
2020;October;44;2020-10-27 00:00;88;26;27;53
2020;October;44;2020-10-27 00:00;89;27;20;47
2020;October;44;2020-10-27 00:00;90;31;16;47
2020;October;44;2020-10-27 00:00;91;27;18;45
2020;October;44;2020-10-27 00:00;92;16;10;26
2020;October;44;2020-10-27 00:00;93;20;6;26
2020;October;44;2020-10-27 00:00;94;10;4;14
2020;October;44;2020-10-27 00:00;95;15;4;19
2020;October;44;2020-10-27 00:00;96;6;2;8
2020;October;44;2020-10-27 00:00;97;1;3;4
2020;October;44;2020-10-27 00:00;98;6;0;6
2020;October;44;2020-10-27 00:00;99;1;1;2
2020;October;44;2020-10-27 00:00;100;1;1;2
2020;October;44;2020-10-27 00:00;101;0;1;1
2020;October;44;2020-10-27 00:00;108;1;0;1
2020;November;45;2020-11-03 00:00;0;176;149;325
2020;November;45;2020-11-03 00:00;1;186;207;393
2020;November;45;2020-11-03 00:00;2;210;230;440
2020;November;45;2020-11-03 00:00;3;205;218;423
2020;November;45;2020-11-03 00:00;4;210;231;441
2020;November;45;2020-11-03 00:00;5;211;233;444
2020;November;45;2020-11-03 00:00;6;211;250;461
2020;November;45;2020-11-03 00:00;7;220;243;463
2020;November;45;2020-11-03 00:00;8;207;213;420
2020;November;45;2020-11-03 00:00;9;224;237;461
2020;November;45;2020-11-03 00:00;10;239;239;478
2020;November;45;2020-11-03 00:00;11;215;235;450
2020;November;45;2020-11-03 00:00;12;209;206;415
2020;November;45;2020-11-03 00:00;13;196;211;407
2020;November;45;2020-11-03 00:00;14;227;209;436
2020;November;45;2020-11-03 00:00;15;196;221;417
2020;November;45;2020-11-03 00:00;16;193;209;402
2020;November;45;2020-11-03 00:00;17;179;192;371
2020;November;45;2020-11-03 00:00;18;192;225;417
2020;November;45;2020-11-03 00:00;19;139;175;314
2020;November;45;2020-11-03 00:00;20;160;191;351
2020;November;45;2020-11-03 00:00;21;149;195;344
2020;November;45;2020-11-03 00:00;22;134;158;292
2020;November;45;2020-11-03 00:00;23;131;175;306
2020;November;45;2020-11-03 00:00;24;144;168;312
2020;November;45;2020-11-03 00:00;25;149;182;331
2020;November;45;2020-11-03 00:00;26;183;178;361
2020;November;45;2020-11-03 00:00;27;168;208;376
2020;November;45;2020-11-03 00:00;28;201;180;381
2020;November;45;2020-11-03 00:00;29;202;239;441
2020;November;45;2020-11-03 00:00;30;234;229;463
2020;November;45;2020-11-03 00:00;31;207;232;439
2020;November;45;2020-11-03 00:00;32;224;221;445
2020;November;45;2020-11-03 00:00;33;234;230;464
2020;November;45;2020-11-03 00:00;34;209;209;418
2020;November;45;2020-11-03 00:00;35;216;229;445
2020;November;45;2020-11-03 00:00;36;211;224;435
2020;November;45;2020-11-03 00:00;37;226;197;423
2020;November;45;2020-11-03 00:00;38;226;224;450
2020;November;45;2020-11-03 00:00;39;190;219;409
2020;November;45;2020-11-03 00:00;40;247;226;473
2020;November;45;2020-11-03 00:00;41;213;185;398
2020;November;45;2020-11-03 00:00;42;204;210;414
2020;November;45;2020-11-03 00:00;43;205;219;424
2020;November;45;2020-11-03 00:00;44;220;223;443
2020;November;45;2020-11-03 00:00;45;219;245;464
2020;November;45;2020-11-03 00:00;46;229;277;506
2020;November;45;2020-11-03 00:00;47;219;230;449
2020;November;45;2020-11-03 00:00;48;226;264;490
2020;November;45;2020-11-03 00:00;49;211;220;431
2020;November;45;2020-11-03 00:00;50;201;215;416
2020;November;45;2020-11-03 00:00;51;195;193;388
2020;November;45;2020-11-03 00:00;52;207;220;427
2020;November;45;2020-11-03 00:00;53;239;230;469
2020;November;45;2020-11-03 00:00;54;186;211;397
2020;November;45;2020-11-03 00:00;55;196;215;411
2020;November;45;2020-11-03 00:00;56;185;219;404
2020;November;45;2020-11-03 00:00;57;175;214;389
2020;November;45;2020-11-03 00:00;58;183;181;364
2020;November;45;2020-11-03 00:00;59;152;165;317
2020;November;45;2020-11-03 00:00;60;156;149;305
2020;November;45;2020-11-03 00:00;61;146;154;300
2020;November;45;2020-11-03 00:00;62;147;147;294
2020;November;45;2020-11-03 00:00;63;136;145;281
2020;November;45;2020-11-03 00:00;64;146;153;299
2020;November;45;2020-11-03 00:00;65;127;112;239
2020;November;45;2020-11-03 00:00;66;127;137;264
2020;November;45;2020-11-03 00:00;67;145;127;272
2020;November;45;2020-11-03 00:00;68;131;144;275
2020;November;45;2020-11-03 00:00;69;140;125;265
2020;November;45;2020-11-03 00:00;70;136;148;284
2020;November;45;2020-11-03 00:00;71;142;151;293
2020;November;45;2020-11-03 00:00;72;168;153;321
2020;November;45;2020-11-03 00:00;73;149;142;291
2020;November;45;2020-11-03 00:00;74;178;139;317
2020;November;45;2020-11-03 00:00;75;173;166;339
2020;November;45;2020-11-03 00:00;76;144;144;288
2020;November;45;2020-11-03 00:00;77;144;150;294
2020;November;45;2020-11-03 00:00;78;127;119;246
2020;November;45;2020-11-03 00:00;79;103;93;196
2020;November;45;2020-11-03 00:00;80;81;113;194
2020;November;45;2020-11-03 00:00;81;83;80;163
2020;November;45;2020-11-03 00:00;82;83;72;155
2020;November;45;2020-11-03 00:00;83;68;63;131
2020;November;45;2020-11-03 00:00;84;81;51;132
2020;November;45;2020-11-03 00:00;85;52;51;103
2020;November;45;2020-11-03 00:00;86;53;38;91
2020;November;45;2020-11-03 00:00;87;49;33;82
2020;November;45;2020-11-03 00:00;88;26;27;53
2020;November;45;2020-11-03 00:00;89;27;20;47
2020;November;45;2020-11-03 00:00;90;31;16;47
2020;November;45;2020-11-03 00:00;91;27;18;45
2020;November;45;2020-11-03 00:00;92;16;10;26
2020;November;45;2020-11-03 00:00;93;20;6;26
2020;November;45;2020-11-03 00:00;94;10;3;13
2020;November;45;2020-11-03 00:00;95;15;4;19
2020;November;45;2020-11-03 00:00;96;6;2;8
2020;November;45;2020-11-03 00:00;97;1;3;4
2020;November;45;2020-11-03 00:00;98;6;0;6
2020;November;45;2020-11-03 00:00;99;1;1;2
2020;November;45;2020-11-03 00:00;100;1;1;2
2020;November;45;2020-11-03 00:00;101;0;1;1
2020;November;45;2020-11-03 00:00;108;1;0;1
2020;November;46;2020-11-10 00:00;0;180;156;336
2020;November;46;2020-11-10 00:00;1;186;209;395
2020;November;46;2020-11-10 00:00;2;210;230;440
2020;November;46;2020-11-10 00:00;3;205;218;423
2020;November;46;2020-11-10 00:00;4;210;233;443
2020;November;46;2020-11-10 00:00;5;211;234;445
2020;November;46;2020-11-10 00:00;6;211;251;462
2020;November;46;2020-11-10 00:00;7;220;243;463
2020;November;46;2020-11-10 00:00;8;207;214;421
2020;November;46;2020-11-10 00:00;9;224;237;461
2020;November;46;2020-11-10 00:00;10;239;239;478
2020;November;46;2020-11-10 00:00;11;215;235;450
2020;November;46;2020-11-10 00:00;12;210;206;416
2020;November;46;2020-11-10 00:00;13;196;212;408
2020;November;46;2020-11-10 00:00;14;227;210;437
2020;November;46;2020-11-10 00:00;15;196;221;417
2020;November;46;2020-11-10 00:00;16;193;209;402
2020;November;46;2020-11-10 00:00;17;179;192;371
2020;November;46;2020-11-10 00:00;18;192;225;417
2020;November;46;2020-11-10 00:00;19;139;176;315
2020;November;46;2020-11-10 00:00;20;158;191;349
2020;November;46;2020-11-10 00:00;21;148;196;344
2020;November;46;2020-11-10 00:00;22;133;157;290
2020;November;46;2020-11-10 00:00;23;132;174;306
2020;November;46;2020-11-10 00:00;24;144;169;313
2020;November;46;2020-11-10 00:00;25;149;180;329
2020;November;46;2020-11-10 00:00;26;183;178;361
2020;November;46;2020-11-10 00:00;27;170;207;377
2020;November;46;2020-11-10 00:00;28;202;180;382
2020;November;46;2020-11-10 00:00;29;202;239;441
2020;November;46;2020-11-10 00:00;30;235;230;465
2020;November;46;2020-11-10 00:00;31;207;233;440
2020;November;46;2020-11-10 00:00;32;224;223;447
2020;November;46;2020-11-10 00:00;33;234;230;464
2020;November;46;2020-11-10 00:00;34;209;209;418
2020;November;46;2020-11-10 00:00;35;216;229;445
2020;November;46;2020-11-10 00:00;36;211;224;435
2020;November;46;2020-11-10 00:00;37;226;197;423
2020;November;46;2020-11-10 00:00;38;225;223;448
2020;November;46;2020-11-10 00:00;39;191;219;410
2020;November;46;2020-11-10 00:00;40;247;227;474
2020;November;46;2020-11-10 00:00;41;213;185;398
2020;November;46;2020-11-10 00:00;42;204;210;414
2020;November;46;2020-11-10 00:00;43;205;219;424
2020;November;46;2020-11-10 00:00;44;220;223;443
2020;November;46;2020-11-10 00:00;45;219;245;464
2020;November;46;2020-11-10 00:00;46;229;277;506
2020;November;46;2020-11-10 00:00;47;219;230;449
2020;November;46;2020-11-10 00:00;48;226;264;490
2020;November;46;2020-11-10 00:00;49;211;220;431
2020;November;46;2020-11-10 00:00;50;201;214;415
2020;November;46;2020-11-10 00:00;51;195;193;388
2020;November;46;2020-11-10 00:00;52;208;220;428
2020;November;46;2020-11-10 00:00;53;239;230;469
2020;November;46;2020-11-10 00:00;54;187;211;398
2020;November;46;2020-11-10 00:00;55;196;215;411
2020;November;46;2020-11-10 00:00;56;185;219;404
2020;November;46;2020-11-10 00:00;57;175;212;387
2020;November;46;2020-11-10 00:00;58;183;181;364
2020;November;46;2020-11-10 00:00;59;151;165;316
2020;November;46;2020-11-10 00:00;60;156;150;306
2020;November;46;2020-11-10 00:00;61;146;155;301
2020;November;46;2020-11-10 00:00;62;147;147;294
2020;November;46;2020-11-10 00:00;63;136;145;281
2020;November;46;2020-11-10 00:00;64;146;153;299
2020;November;46;2020-11-10 00:00;65;128;112;240
2020;November;46;2020-11-10 00:00;66;127;137;264
2020;November;46;2020-11-10 00:00;67;145;127;272
2020;November;46;2020-11-10 00:00;68;131;144;275
2020;November;46;2020-11-10 00:00;69;140;125;265
2020;November;46;2020-11-10 00:00;70;136;148;284
2020;November;46;2020-11-10 00:00;71;142;151;293
2020;November;46;2020-11-10 00:00;72;168;152;320
2020;November;46;2020-11-10 00:00;73;149;142;291
2020;November;46;2020-11-10 00:00;74;178;139;317
2020;November;46;2020-11-10 00:00;75;173;166;339
2020;November;46;2020-11-10 00:00;76;144;144;288
2020;November;46;2020-11-10 00:00;77;144;150;294
2020;November;46;2020-11-10 00:00;78;127;119;246
2020;November;46;2020-11-10 00:00;79;103;93;196
2020;November;46;2020-11-10 00:00;80;80;113;193
2020;November;46;2020-11-10 00:00;81;83;80;163
2020;November;46;2020-11-10 00:00;82;83;72;155
2020;November;46;2020-11-10 00:00;83;68;63;131
2020;November;46;2020-11-10 00:00;84;81;51;132
2020;November;46;2020-11-10 00:00;85;52;51;103
2020;November;46;2020-11-10 00:00;86;53;38;91
2020;November;46;2020-11-10 00:00;87;49;33;82
2020;November;46;2020-11-10 00:00;88;26;27;53
2020;November;46;2020-11-10 00:00;89;27;20;47
2020;November;46;2020-11-10 00:00;90;31;16;47
2020;November;46;2020-11-10 00:00;91;27;18;45
2020;November;46;2020-11-10 00:00;92;16;10;26
2020;November;46;2020-11-10 00:00;93;20;6;26
2020;November;46;2020-11-10 00:00;94;10;3;13
2020;November;46;2020-11-10 00:00;95;14;4;18
2020;November;46;2020-11-10 00:00;96;6;2;8
2020;November;46;2020-11-10 00:00;97;1;3;4
2020;November;46;2020-11-10 00:00;98;6;0;6
2020;November;46;2020-11-10 00:00;99;1;1;2
2020;November;46;2020-11-10 00:00;100;1;1;2
2020;November;46;2020-11-10 00:00;101;0;1;1
2020;November;46;2020-11-10 00:00;108;1;0;1
2020;November;47;2020-11-17 00:00;0;184;160;344
2020;November;47;2020-11-17 00:00;1;186;210;396
2020;November;47;2020-11-17 00:00;2;209;230;439
2020;November;47;2020-11-17 00:00;3;206;219;425
2020;November;47;2020-11-17 00:00;4;210;233;443
2020;November;47;2020-11-17 00:00;5;211;234;445
2020;November;47;2020-11-17 00:00;6;212;252;464
2020;November;47;2020-11-17 00:00;7;221;244;465
2020;November;47;2020-11-17 00:00;8;207;214;421
2020;November;47;2020-11-17 00:00;9;224;237;461
2020;November;47;2020-11-17 00:00;10;239;239;478
2020;November;47;2020-11-17 00:00;11;215;235;450
2020;November;47;2020-11-17 00:00;12;210;206;416
2020;November;47;2020-11-17 00:00;13;196;212;408
2020;November;47;2020-11-17 00:00;14;227;210;437
2020;November;47;2020-11-17 00:00;15;196;221;417
2020;November;47;2020-11-17 00:00;16;193;208;401
2020;November;47;2020-11-17 00:00;17;179;191;370
2020;November;47;2020-11-17 00:00;18;191;225;416
2020;November;47;2020-11-17 00:00;19;139;176;315
2020;November;47;2020-11-17 00:00;20;160;192;352
2020;November;47;2020-11-17 00:00;21;147;196;343
2020;November;47;2020-11-17 00:00;22;133;157;290
2020;November;47;2020-11-17 00:00;23;132;175;307
2020;November;47;2020-11-17 00:00;24;143;170;313
2020;November;47;2020-11-17 00:00;25;148;179;327
2020;November;47;2020-11-17 00:00;26;183;178;361
2020;November;47;2020-11-17 00:00;27;170;206;376
2020;November;47;2020-11-17 00:00;28;203;180;383
2020;November;47;2020-11-17 00:00;29;202;238;440
2020;November;47;2020-11-17 00:00;30;236;230;466
2020;November;47;2020-11-17 00:00;31;207;234;441
2020;November;47;2020-11-17 00:00;32;224;223;447
2020;November;47;2020-11-17 00:00;33;234;229;463
2020;November;47;2020-11-17 00:00;34;209;210;419
2020;November;47;2020-11-17 00:00;35;216;229;445
2020;November;47;2020-11-17 00:00;36;211;225;436
2020;November;47;2020-11-17 00:00;37;226;197;423
2020;November;47;2020-11-17 00:00;38;225;223;448
2020;November;47;2020-11-17 00:00;39;191;221;412
2020;November;47;2020-11-17 00:00;40;247;227;474
2020;November;47;2020-11-17 00:00;41;214;186;400
2020;November;47;2020-11-17 00:00;42;204;209;413
2020;November;47;2020-11-17 00:00;43;205;219;424
2020;November;47;2020-11-17 00:00;44;220;223;443
2020;November;47;2020-11-17 00:00;45;219;245;464
2020;November;47;2020-11-17 00:00;46;229;277;506
2020;November;47;2020-11-17 00:00;47;219;230;449
2020;November;47;2020-11-17 00:00;48;226;264;490
2020;November;47;2020-11-17 00:00;49;211;220;431
2020;November;47;2020-11-17 00:00;50;201;213;414
2020;November;47;2020-11-17 00:00;51;195;193;388
2020;November;47;2020-11-17 00:00;52;208;220;428
2020;November;47;2020-11-17 00:00;53;239;230;469
2020;November;47;2020-11-17 00:00;54;186;211;397
2020;November;47;2020-11-17 00:00;55;196;215;411
2020;November;47;2020-11-17 00:00;56;185;220;405
2020;November;47;2020-11-17 00:00;57;174;211;385
2020;November;47;2020-11-17 00:00;58;183;180;363
2020;November;47;2020-11-17 00:00;59;151;165;316
2020;November;47;2020-11-17 00:00;60;156;150;306
2020;November;47;2020-11-17 00:00;61;146;155;301
2020;November;47;2020-11-17 00:00;62;147;147;294
2020;November;47;2020-11-17 00:00;63;136;145;281
2020;November;47;2020-11-17 00:00;64;146;153;299
2020;November;47;2020-11-17 00:00;65;128;112;240
2020;November;47;2020-11-17 00:00;66;127;137;264
2020;November;47;2020-11-17 00:00;67;145;127;272
2020;November;47;2020-11-17 00:00;68;131;144;275
2020;November;47;2020-11-17 00:00;69;140;124;264
2020;November;47;2020-11-17 00:00;70;136;148;284
2020;November;47;2020-11-17 00:00;71;142;151;293
2020;November;47;2020-11-17 00:00;72;168;152;320
2020;November;47;2020-11-17 00:00;73;149;142;291
2020;November;47;2020-11-17 00:00;74;179;139;318
2020;November;47;2020-11-17 00:00;75;173;166;339
2020;November;47;2020-11-17 00:00;76;144;144;288
2020;November;47;2020-11-17 00:00;77;144;150;294
2020;November;47;2020-11-17 00:00;78;126;119;245
2020;November;47;2020-11-17 00:00;79;103;93;196
2020;November;47;2020-11-17 00:00;80;79;113;192
2020;November;47;2020-11-17 00:00;81;84;80;164
2020;November;47;2020-11-17 00:00;82;83;72;155
2020;November;47;2020-11-17 00:00;83;68;63;131
2020;November;47;2020-11-17 00:00;84;81;51;132
2020;November;47;2020-11-17 00:00;85;51;52;103
2020;November;47;2020-11-17 00:00;86;53;38;91
2020;November;47;2020-11-17 00:00;87;49;33;82
2020;November;47;2020-11-17 00:00;88;26;27;53
2020;November;47;2020-11-17 00:00;89;27;20;47
2020;November;47;2020-11-17 00:00;90;31;16;47
2020;November;47;2020-11-17 00:00;91;25;18;43
2020;November;47;2020-11-17 00:00;92;16;9;25
2020;November;47;2020-11-17 00:00;93;20;6;26
2020;November;47;2020-11-17 00:00;94;10;3;13
2020;November;47;2020-11-17 00:00;95;14;4;18
2020;November;47;2020-11-17 00:00;96;6;2;8
2020;November;47;2020-11-17 00:00;97;1;3;4
2020;November;47;2020-11-17 00:00;98;5;0;5
2020;November;47;2020-11-17 00:00;99;1;1;2
2020;November;47;2020-11-17 00:00;100;1;1;2
2020;November;47;2020-11-17 00:00;101;0;1;1
2020;November;47;2020-11-17 00:00;108;1;0;1
2020;November;48;2020-11-24 00:00;0;188;161;349
2020;November;48;2020-11-24 00:00;1;187;211;398
2020;November;48;2020-11-24 00:00;2;208;230;438
2020;November;48;2020-11-24 00:00;3;206;219;425
2020;November;48;2020-11-24 00:00;4;209;233;442
2020;November;48;2020-11-24 00:00;5;212;234;446
2020;November;48;2020-11-24 00:00;6;212;252;464
2020;November;48;2020-11-24 00:00;7;221;245;466
2020;November;48;2020-11-24 00:00;8;207;214;421
2020;November;48;2020-11-24 00:00;9;225;237;462
2020;November;48;2020-11-24 00:00;10;239;239;478
2020;November;48;2020-11-24 00:00;11;215;235;450
2020;November;48;2020-11-24 00:00;12;210;206;416
2020;November;48;2020-11-24 00:00;13;196;212;408
2020;November;48;2020-11-24 00:00;14;228;210;438
2020;November;48;2020-11-24 00:00;15;196;221;417
2020;November;48;2020-11-24 00:00;16;193;208;401
2020;November;48;2020-11-24 00:00;17;180;191;371
2020;November;48;2020-11-24 00:00;18;191;226;417
2020;November;48;2020-11-24 00:00;19;140;176;316
2020;November;48;2020-11-24 00:00;20;160;192;352
2020;November;48;2020-11-24 00:00;21;147;195;342
2020;November;48;2020-11-24 00:00;22;132;157;289
2020;November;48;2020-11-24 00:00;23;131;175;306
2020;November;48;2020-11-24 00:00;24;143;170;313
2020;November;48;2020-11-24 00:00;25;148;179;327
2020;November;48;2020-11-24 00:00;26;181;178;359
2020;November;48;2020-11-24 00:00;27;170;207;377
2020;November;48;2020-11-24 00:00;28;203;179;382
2020;November;48;2020-11-24 00:00;29;202;240;442
2020;November;48;2020-11-24 00:00;30;237;229;466
2020;November;48;2020-11-24 00:00;31;207;234;441
2020;November;48;2020-11-24 00:00;32;224;222;446
2020;November;48;2020-11-24 00:00;33;235;227;462
2020;November;48;2020-11-24 00:00;34;209;210;419
2020;November;48;2020-11-24 00:00;35;215;229;444
2020;November;48;2020-11-24 00:00;36;212;225;437
2020;November;48;2020-11-24 00:00;37;225;197;422
2020;November;48;2020-11-24 00:00;38;225;223;448
2020;November;48;2020-11-24 00:00;39;192;220;412
2020;November;48;2020-11-24 00:00;40;247;227;474
2020;November;48;2020-11-24 00:00;41;214;186;400
2020;November;48;2020-11-24 00:00;42;204;209;413
2020;November;48;2020-11-24 00:00;43;205;219;424
2020;November;48;2020-11-24 00:00;44;220;223;443
2020;November;48;2020-11-24 00:00;45;219;245;464
2020;November;48;2020-11-24 00:00;46;229;277;506
2020;November;48;2020-11-24 00:00;47;219;230;449
2020;November;48;2020-11-24 00:00;48;226;265;491
2020;November;48;2020-11-24 00:00;49;211;220;431
2020;November;48;2020-11-24 00:00;50;201;213;414
2020;November;48;2020-11-24 00:00;51;196;193;389
2020;November;48;2020-11-24 00:00;52;208;220;428
2020;November;48;2020-11-24 00:00;53;239;230;469
2020;November;48;2020-11-24 00:00;54;186;212;398
2020;November;48;2020-11-24 00:00;55;195;215;410
2020;November;48;2020-11-24 00:00;56;185;220;405
2020;November;48;2020-11-24 00:00;57;174;211;385
2020;November;48;2020-11-24 00:00;58;183;181;364
2020;November;48;2020-11-24 00:00;59;151;165;316
2020;November;48;2020-11-24 00:00;60;156;149;305
2020;November;48;2020-11-24 00:00;61;146;154;300
2020;November;48;2020-11-24 00:00;62;147;147;294
2020;November;48;2020-11-24 00:00;63;135;145;280
2020;November;48;2020-11-24 00:00;64;146;153;299
2020;November;48;2020-11-24 00:00;65;128;112;240
2020;November;48;2020-11-24 00:00;66;127;138;265
2020;November;48;2020-11-24 00:00;67;145;127;272
2020;November;48;2020-11-24 00:00;68;131;143;274
2020;November;48;2020-11-24 00:00;69;140;124;264
2020;November;48;2020-11-24 00:00;70;136;148;284
2020;November;48;2020-11-24 00:00;71;142;151;293
2020;November;48;2020-11-24 00:00;72;168;152;320
2020;November;48;2020-11-24 00:00;73;149;142;291
2020;November;48;2020-11-24 00:00;74;179;139;318
2020;November;48;2020-11-24 00:00;75;173;166;339
2020;November;48;2020-11-24 00:00;76;144;144;288
2020;November;48;2020-11-24 00:00;77;143;149;292
2020;November;48;2020-11-24 00:00;78;126;119;245
2020;November;48;2020-11-24 00:00;79;103;93;196
2020;November;48;2020-11-24 00:00;80;80;113;193
2020;November;48;2020-11-24 00:00;81;84;79;163
2020;November;48;2020-11-24 00:00;82;83;72;155
2020;November;48;2020-11-24 00:00;83;68;64;132
2020;November;48;2020-11-24 00:00;84;81;52;133
2020;November;48;2020-11-24 00:00;85;51;52;103
2020;November;48;2020-11-24 00:00;86;53;38;91
2020;November;48;2020-11-24 00:00;87;49;34;83
2020;November;48;2020-11-24 00:00;88;26;27;53
2020;November;48;2020-11-24 00:00;89;27;20;47
2020;November;48;2020-11-24 00:00;90;31;16;47
2020;November;48;2020-11-24 00:00;91;25;18;43
2020;November;48;2020-11-24 00:00;92;16;8;24
2020;November;48;2020-11-24 00:00;93;20;6;26
2020;November;48;2020-11-24 00:00;94;10;3;13
2020;November;48;2020-11-24 00:00;95;14;4;18
2020;November;48;2020-11-24 00:00;96;6;2;8
2020;November;48;2020-11-24 00:00;97;1;3;4
2020;November;48;2020-11-24 00:00;98;5;0;5
2020;November;48;2020-11-24 00:00;99;1;1;2
2020;November;48;2020-11-24 00:00;100;1;1;2
2020;November;48;2020-11-24 00:00;101;0;1;1
2020;November;48;2020-11-24 00:00;108;1;0;1
2020;December;49;2020-12-01 00:00;0;191;165;356
2020;December;49;2020-12-01 00:00;1;187;210;397
2020;December;49;2020-12-01 00:00;2;208;229;437
2020;December;49;2020-12-01 00:00;3;206;220;426
2020;December;49;2020-12-01 00:00;4;208;233;441
2020;December;49;2020-12-01 00:00;5;212;234;446
2020;December;49;2020-12-01 00:00;6;212;252;464
2020;December;49;2020-12-01 00:00;7;221;245;466
2020;December;49;2020-12-01 00:00;8;207;213;420
2020;December;49;2020-12-01 00:00;9;225;237;462
2020;December;49;2020-12-01 00:00;10;238;239;477
2020;December;49;2020-12-01 00:00;11;215;235;450
2020;December;49;2020-12-01 00:00;12;210;206;416
2020;December;49;2020-12-01 00:00;13;196;212;408
2020;December;49;2020-12-01 00:00;14;230;210;440
2020;December;49;2020-12-01 00:00;15;196;221;417
2020;December;49;2020-12-01 00:00;16;193;208;401
2020;December;49;2020-12-01 00:00;17;180;192;372
2020;December;49;2020-12-01 00:00;18;191;225;416
2020;December;49;2020-12-01 00:00;19;139;176;315
2020;December;49;2020-12-01 00:00;20;160;192;352
2020;December;49;2020-12-01 00:00;21;147;196;343
2020;December;49;2020-12-01 00:00;22;130;158;288
2020;December;49;2020-12-01 00:00;23;130;174;304
2020;December;49;2020-12-01 00:00;24;144;169;313
2020;December;49;2020-12-01 00:00;25;147;180;327
2020;December;49;2020-12-01 00:00;26;183;179;362
2020;December;49;2020-12-01 00:00;27;172;209;381
2020;December;49;2020-12-01 00:00;28;204;180;384
2020;December;49;2020-12-01 00:00;29;201;240;441
2020;December;49;2020-12-01 00:00;30;236;229;465
2020;December;49;2020-12-01 00:00;31;209;234;443
2020;December;49;2020-12-01 00:00;32;224;224;448
2020;December;49;2020-12-01 00:00;33;236;229;465
2020;December;49;2020-12-01 00:00;34;209;210;419
2020;December;49;2020-12-01 00:00;35;214;230;444
2020;December;49;2020-12-01 00:00;36;212;224;436
2020;December;49;2020-12-01 00:00;37;225;196;421
2020;December;49;2020-12-01 00:00;38;225;223;448
2020;December;49;2020-12-01 00:00;39;192;220;412
2020;December;49;2020-12-01 00:00;40;248;227;475
2020;December;49;2020-12-01 00:00;41;214;186;400
2020;December;49;2020-12-01 00:00;42;204;209;413
2020;December;49;2020-12-01 00:00;43;205;219;424
2020;December;49;2020-12-01 00:00;44;220;222;442
2020;December;49;2020-12-01 00:00;45;220;244;464
2020;December;49;2020-12-01 00:00;46;229;277;506
2020;December;49;2020-12-01 00:00;47;219;230;449
2020;December;49;2020-12-01 00:00;48;227;265;492
2020;December;49;2020-12-01 00:00;49;210;221;431
2020;December;49;2020-12-01 00:00;50;201;213;414
2020;December;49;2020-12-01 00:00;51;196;193;389
2020;December;49;2020-12-01 00:00;52;207;221;428
2020;December;49;2020-12-01 00:00;53;238;230;468
2020;December;49;2020-12-01 00:00;54;186;214;400
2020;December;49;2020-12-01 00:00;55;195;215;410
2020;December;49;2020-12-01 00:00;56;186;219;405
2020;December;49;2020-12-01 00:00;57;174;212;386
2020;December;49;2020-12-01 00:00;58;183;181;364
2020;December;49;2020-12-01 00:00;59;151;165;316
2020;December;49;2020-12-01 00:00;60;155;148;303
2020;December;49;2020-12-01 00:00;61;145;154;299
2020;December;49;2020-12-01 00:00;62;147;147;294
2020;December;49;2020-12-01 00:00;63;135;145;280
2020;December;49;2020-12-01 00:00;64;146;153;299
2020;December;49;2020-12-01 00:00;65;128;112;240
2020;December;49;2020-12-01 00:00;66;128;138;266
2020;December;49;2020-12-01 00:00;67;144;127;271
2020;December;49;2020-12-01 00:00;68;131;143;274
2020;December;49;2020-12-01 00:00;69;140;124;264
2020;December;49;2020-12-01 00:00;70;135;148;283
2020;December;49;2020-12-01 00:00;71;142;151;293
2020;December;49;2020-12-01 00:00;72;168;152;320
2020;December;49;2020-12-01 00:00;73;149;142;291
2020;December;49;2020-12-01 00:00;74;179;138;317
2020;December;49;2020-12-01 00:00;75;173;166;339
2020;December;49;2020-12-01 00:00;76;144;144;288
2020;December;49;2020-12-01 00:00;77;143;149;292
2020;December;49;2020-12-01 00:00;78;126;119;245
2020;December;49;2020-12-01 00:00;79;103;93;196
2020;December;49;2020-12-01 00:00;80;80;113;193
2020;December;49;2020-12-01 00:00;81;84;79;163
2020;December;49;2020-12-01 00:00;82;83;72;155
2020;December;49;2020-12-01 00:00;83;68;64;132
2020;December;49;2020-12-01 00:00;84;81;52;133
2020;December;49;2020-12-01 00:00;85;51;52;103
2020;December;49;2020-12-01 00:00;86;53;38;91
2020;December;49;2020-12-01 00:00;87;49;34;83
2020;December;49;2020-12-01 00:00;88;26;27;53
2020;December;49;2020-12-01 00:00;89;27;20;47
2020;December;49;2020-12-01 00:00;90;31;16;47
2020;December;49;2020-12-01 00:00;91;25;18;43
2020;December;49;2020-12-01 00:00;92;16;8;24
2020;December;49;2020-12-01 00:00;93;20;6;26
2020;December;49;2020-12-01 00:00;94;10;3;13
2020;December;49;2020-12-01 00:00;95;14;4;18
2020;December;49;2020-12-01 00:00;96;6;2;8
2020;December;49;2020-12-01 00:00;97;1;3;4
2020;December;49;2020-12-01 00:00;98;5;0;5
2020;December;49;2020-12-01 00:00;99;1;1;2
2020;December;49;2020-12-01 00:00;100;1;1;2
2020;December;49;2020-12-01 00:00;101;0;1;1
2020;December;49;2020-12-01 00:00;108;1;0;1
2020;December;50;2020-12-08 00:00;0;195;169;364
2020;December;50;2020-12-08 00:00;1;186;211;397
2020;December;50;2020-12-08 00:00;2;207;228;435
2020;December;50;2020-12-08 00:00;3;205;220;425
2020;December;50;2020-12-08 00:00;4;210;234;444
2020;December;50;2020-12-08 00:00;5;212;234;446
2020;December;50;2020-12-08 00:00;6;212;252;464
2020;December;50;2020-12-08 00:00;7;222;246;468
2020;December;50;2020-12-08 00:00;8;207;213;420
2020;December;50;2020-12-08 00:00;9;225;236;461
2020;December;50;2020-12-08 00:00;10;238;239;477
2020;December;50;2020-12-08 00:00;11;216;235;451
2020;December;50;2020-12-08 00:00;12;210;207;417
2020;December;50;2020-12-08 00:00;13;197;212;409
2020;December;50;2020-12-08 00:00;14;229;210;439
2020;December;50;2020-12-08 00:00;15;196;221;417
2020;December;50;2020-12-08 00:00;16;193;209;402
2020;December;50;2020-12-08 00:00;17;179;191;370
2020;December;50;2020-12-08 00:00;18;191;225;416
2020;December;50;2020-12-08 00:00;19;140;178;318
2020;December;50;2020-12-08 00:00;20;160;191;351
2020;December;50;2020-12-08 00:00;21;144;199;343
2020;December;50;2020-12-08 00:00;22;128;157;285
2020;December;50;2020-12-08 00:00;23;131;173;304
2020;December;50;2020-12-08 00:00;24;145;169;314
2020;December;50;2020-12-08 00:00;25;147;180;327
2020;December;50;2020-12-08 00:00;26;183;179;362
2020;December;50;2020-12-08 00:00;27;171;207;378
2020;December;50;2020-12-08 00:00;28;207;179;386
2020;December;50;2020-12-08 00:00;29;201;239;440
2020;December;50;2020-12-08 00:00;30;236;229;465
2020;December;50;2020-12-08 00:00;31;210;235;445
2020;December;50;2020-12-08 00:00;32;225;222;447
2020;December;50;2020-12-08 00:00;33;236;230;466
2020;December;50;2020-12-08 00:00;34;210;213;423
2020;December;50;2020-12-08 00:00;35;216;232;448
2020;December;50;2020-12-08 00:00;36;214;224;438
2020;December;50;2020-12-08 00:00;37;225;195;420
2020;December;50;2020-12-08 00:00;38;226;224;450
2020;December;50;2020-12-08 00:00;39;192;222;414
2020;December;50;2020-12-08 00:00;40;249;226;475
2020;December;50;2020-12-08 00:00;41;216;187;403
2020;December;50;2020-12-08 00:00;42;204;209;413
2020;December;50;2020-12-08 00:00;43;205;220;425
2020;December;50;2020-12-08 00:00;44;220;223;443
2020;December;50;2020-12-08 00:00;45;218;244;462
2020;December;50;2020-12-08 00:00;46;228;277;505
2020;December;50;2020-12-08 00:00;47;221;230;451
2020;December;50;2020-12-08 00:00;48;226;264;490
2020;December;50;2020-12-08 00:00;49;211;221;432
2020;December;50;2020-12-08 00:00;50;200;213;413
2020;December;50;2020-12-08 00:00;51;196;193;389
2020;December;50;2020-12-08 00:00;52;207;221;428
2020;December;50;2020-12-08 00:00;53;239;229;468
2020;December;50;2020-12-08 00:00;54;186;215;401
2020;December;50;2020-12-08 00:00;55;193;215;408
2020;December;50;2020-12-08 00:00;56;187;218;405
2020;December;50;2020-12-08 00:00;57;174;212;386
2020;December;50;2020-12-08 00:00;58;183;182;365
2020;December;50;2020-12-08 00:00;59;152;166;318
2020;December;50;2020-12-08 00:00;60;155;147;302
2020;December;50;2020-12-08 00:00;61;145;154;299
2020;December;50;2020-12-08 00:00;62;148;147;295
2020;December;50;2020-12-08 00:00;63;135;145;280
2020;December;50;2020-12-08 00:00;64;145;152;297
2020;December;50;2020-12-08 00:00;65;128;113;241
2020;December;50;2020-12-08 00:00;66;128;137;265
2020;December;50;2020-12-08 00:00;67;144;127;271
2020;December;50;2020-12-08 00:00;68;131;143;274
2020;December;50;2020-12-08 00:00;69;140;124;264
2020;December;50;2020-12-08 00:00;70;135;147;282
2020;December;50;2020-12-08 00:00;71;142;151;293
2020;December;50;2020-12-08 00:00;72;168;152;320
2020;December;50;2020-12-08 00:00;73;149;142;291
2020;December;50;2020-12-08 00:00;74;179;137;316
2020;December;50;2020-12-08 00:00;75;172;165;337
2020;December;50;2020-12-08 00:00;76;144;143;287
2020;December;50;2020-12-08 00:00;77;144;150;294
2020;December;50;2020-12-08 00:00;78;126;119;245
2020;December;50;2020-12-08 00:00;79;103;93;196
2020;December;50;2020-12-08 00:00;80;80;113;193
2020;December;50;2020-12-08 00:00;81;84;80;164
2020;December;50;2020-12-08 00:00;82;83;72;155
2020;December;50;2020-12-08 00:00;83;68;64;132
2020;December;50;2020-12-08 00:00;84;81;52;133
2020;December;50;2020-12-08 00:00;85;51;51;102
2020;December;50;2020-12-08 00:00;86;53;38;91
2020;December;50;2020-12-08 00:00;87;49;34;83
2020;December;50;2020-12-08 00:00;88;26;27;53
2020;December;50;2020-12-08 00:00;89;27;19;46
2020;December;50;2020-12-08 00:00;90;31;16;47
2020;December;50;2020-12-08 00:00;91;25;18;43
2020;December;50;2020-12-08 00:00;92;16;8;24
2020;December;50;2020-12-08 00:00;93;20;6;26
2020;December;50;2020-12-08 00:00;94;10;3;13
2020;December;50;2020-12-08 00:00;95;14;4;18
2020;December;50;2020-12-08 00:00;96;6;2;8
2020;December;50;2020-12-08 00:00;97;1;3;4
2020;December;50;2020-12-08 00:00;98;5;0;5
2020;December;50;2020-12-08 00:00;99;1;1;2
2020;December;50;2020-12-08 00:00;100;1;1;2
2020;December;50;2020-12-08 00:00;101;0;1;1
2020;December;50;2020-12-08 00:00;108;1;0;1
2020;December;51;2020-12-15 00:00;0;197;173;370
2020;December;51;2020-12-15 00:00;1;187;211;398
2020;December;51;2020-12-15 00:00;2;208;228;436
2020;December;51;2020-12-15 00:00;3;207;221;428
2020;December;51;2020-12-15 00:00;4;211;233;444
2020;December;51;2020-12-15 00:00;5;215;234;449
2020;December;51;2020-12-15 00:00;6;212;252;464
2020;December;51;2020-12-15 00:00;7;222;246;468
2020;December;51;2020-12-15 00:00;8;207;213;420
2020;December;51;2020-12-15 00:00;9;225;238;463
2020;December;51;2020-12-15 00:00;10;237;240;477
2020;December;51;2020-12-15 00:00;11;214;235;449
2020;December;51;2020-12-15 00:00;12;210;207;417
2020;December;51;2020-12-15 00:00;13;197;210;407
2020;December;51;2020-12-15 00:00;14;230;210;440
2020;December;51;2020-12-15 00:00;15;196;221;417
2020;December;51;2020-12-15 00:00;16;193;210;403
2020;December;51;2020-12-15 00:00;17;179;191;370
2020;December;51;2020-12-15 00:00;18;190;225;415
2020;December;51;2020-12-15 00:00;19;141;179;320
2020;December;51;2020-12-15 00:00;20;160;192;352
2020;December;51;2020-12-15 00:00;21;144;199;343
2020;December;51;2020-12-15 00:00;22;126;155;281
2020;December;51;2020-12-15 00:00;23;132;172;304
2020;December;51;2020-12-15 00:00;24;146;169;315
2020;December;51;2020-12-15 00:00;25;147;180;327
2020;December;51;2020-12-15 00:00;26;186;180;366
2020;December;51;2020-12-15 00:00;27;174;208;382
2020;December;51;2020-12-15 00:00;28;208;180;388
2020;December;51;2020-12-15 00:00;29;202;239;441
2020;December;51;2020-12-15 00:00;30;237;229;466
2020;December;51;2020-12-15 00:00;31;210;236;446
2020;December;51;2020-12-15 00:00;32;226;221;447
2020;December;51;2020-12-15 00:00;33;234;232;466
2020;December;51;2020-12-15 00:00;34;212;211;423
2020;December;51;2020-12-15 00:00;35;214;233;447
2020;December;51;2020-12-15 00:00;36;215;224;439
2020;December;51;2020-12-15 00:00;37;225;196;421
2020;December;51;2020-12-15 00:00;38;225;227;452
2020;December;51;2020-12-15 00:00;39;192;222;414
2020;December;51;2020-12-15 00:00;40;249;226;475
2020;December;51;2020-12-15 00:00;41;215;187;402
2020;December;51;2020-12-15 00:00;42;205;209;414
2020;December;51;2020-12-15 00:00;43;205;219;424
2020;December;51;2020-12-15 00:00;44;220;224;444
2020;December;51;2020-12-15 00:00;45;218;244;462
2020;December;51;2020-12-15 00:00;46;228;277;505
2020;December;51;2020-12-15 00:00;47;221;230;451
2020;December;51;2020-12-15 00:00;48;226;264;490
2020;December;51;2020-12-15 00:00;49;211;220;431
2020;December;51;2020-12-15 00:00;50;200;213;413
2020;December;51;2020-12-15 00:00;51;195;193;388
2020;December;51;2020-12-15 00:00;52;207;221;428
2020;December;51;2020-12-15 00:00;53;239;229;468
2020;December;51;2020-12-15 00:00;54;186;215;401
2020;December;51;2020-12-15 00:00;55;193;215;408
2020;December;51;2020-12-15 00:00;56;188;218;406
2020;December;51;2020-12-15 00:00;57;174;212;386
2020;December;51;2020-12-15 00:00;58;183;182;365
2020;December;51;2020-12-15 00:00;59;152;167;319
2020;December;51;2020-12-15 00:00;60;155;147;302
2020;December;51;2020-12-15 00:00;61;145;154;299
2020;December;51;2020-12-15 00:00;62;148;147;295
2020;December;51;2020-12-15 00:00;63;135;145;280
2020;December;51;2020-12-15 00:00;64;145;154;299
2020;December;51;2020-12-15 00:00;65;127;113;240
2020;December;51;2020-12-15 00:00;66;128;137;265
2020;December;51;2020-12-15 00:00;67;144;127;271
2020;December;51;2020-12-15 00:00;68;131;143;274
2020;December;51;2020-12-15 00:00;69;140;124;264
2020;December;51;2020-12-15 00:00;70;135;147;282
2020;December;51;2020-12-15 00:00;71;142;151;293
2020;December;51;2020-12-15 00:00;72;168;152;320
2020;December;51;2020-12-15 00:00;73;148;142;290
2020;December;51;2020-12-15 00:00;74;179;137;316
2020;December;51;2020-12-15 00:00;75;172;165;337
2020;December;51;2020-12-15 00:00;76;145;141;286
2020;December;51;2020-12-15 00:00;77;144;150;294
2020;December;51;2020-12-15 00:00;78;126;118;244
2020;December;51;2020-12-15 00:00;79;103;94;197
2020;December;51;2020-12-15 00:00;80;80;113;193
2020;December;51;2020-12-15 00:00;81;84;80;164
2020;December;51;2020-12-15 00:00;82;83;71;154
2020;December;51;2020-12-15 00:00;83;68;64;132
2020;December;51;2020-12-15 00:00;84;80;52;132
2020;December;51;2020-12-15 00:00;85;50;50;100
2020;December;51;2020-12-15 00:00;86;53;38;91
2020;December;51;2020-12-15 00:00;87;49;34;83
2020;December;51;2020-12-15 00:00;88;26;27;53
2020;December;51;2020-12-15 00:00;89;27;19;46
2020;December;51;2020-12-15 00:00;90;31;16;47
2020;December;51;2020-12-15 00:00;91;25;18;43
2020;December;51;2020-12-15 00:00;92;16;8;24
2020;December;51;2020-12-15 00:00;93;20;6;26
2020;December;51;2020-12-15 00:00;94;9;3;12
2020;December;51;2020-12-15 00:00;95;14;4;18
2020;December;51;2020-12-15 00:00;96;6;2;8
2020;December;51;2020-12-15 00:00;97;1;3;4
2020;December;51;2020-12-15 00:00;98;5;0;5
2020;December;51;2020-12-15 00:00;99;1;1;2
2020;December;51;2020-12-15 00:00;100;1;1;2
2020;December;51;2020-12-15 00:00;101;0;1;1
2020;December;51;2020-12-15 00:00;108;1;0;1
2021;January;2;2021-01-05 00:00;1;204;178;382
2021;January;2;2021-01-05 00:00;2;188;210;398
2021;January;2;2021-01-05 00:00;3;209;229;438
2021;January;2;2021-01-05 00:00;4;207;223;430
2021;January;2;2021-01-05 00:00;5;210;232;442
2021;January;2;2021-01-05 00:00;6;216;234;450
2021;January;2;2021-01-05 00:00;7;212;253;465
2021;January;2;2021-01-05 00:00;8;222;246;468
2021;January;2;2021-01-05 00:00;9;207;213;420
2021;January;2;2021-01-05 00:00;10;226;237;463
2021;January;2;2021-01-05 00:00;11;237;240;477
2021;January;2;2021-01-05 00:00;12;214;235;449
2021;January;2;2021-01-05 00:00;13;210;207;417
2021;January;2;2021-01-05 00:00;14;197;210;407
2021;January;2;2021-01-05 00:00;15;231;209;440
2021;January;2;2021-01-05 00:00;16;196;221;417
2021;January;2;2021-01-05 00:00;17;192;211;403
2021;January;2;2021-01-05 00:00;18;178;192;370
2021;January;2;2021-01-05 00:00;19;189;225;414
2021;January;2;2021-01-05 00:00;20;141;180;321
2021;January;2;2021-01-05 00:00;21;159;192;351
2021;January;2;2021-01-05 00:00;22;143;200;343
2021;January;2;2021-01-05 00:00;23;125;155;280
2021;January;2;2021-01-05 00:00;24;133;172;305
2021;January;2;2021-01-05 00:00;25;144;170;314
2021;January;2;2021-01-05 00:00;26;147;179;326
2021;January;2;2021-01-05 00:00;27;188;181;369
2021;January;2;2021-01-05 00:00;28;175;208;383
2021;January;2;2021-01-05 00:00;29;207;182;389
2021;January;2;2021-01-05 00:00;30;202;240;442
2021;January;2;2021-01-05 00:00;31;240;228;468
2021;January;2;2021-01-05 00:00;32;209;235;444
2021;January;2;2021-01-05 00:00;33;229;221;450
2021;January;2;2021-01-05 00:00;34;235;232;467
2021;January;2;2021-01-05 00:00;35;212;214;426
2021;January;2;2021-01-05 00:00;36;214;231;445
2021;January;2;2021-01-05 00:00;37;215;224;439
2021;January;2;2021-01-05 00:00;38;224;195;419
2021;January;2;2021-01-05 00:00;39;224;227;451
2021;January;2;2021-01-05 00:00;40;191;223;414
2021;January;2;2021-01-05 00:00;41;251;226;477
2021;January;2;2021-01-05 00:00;42;215;188;403
2021;January;2;2021-01-05 00:00;43;206;209;415
2021;January;2;2021-01-05 00:00;44;204;218;422
2021;January;2;2021-01-05 00:00;45;221;224;445
2021;January;2;2021-01-05 00:00;46;219;245;464
2021;January;2;2021-01-05 00:00;47;226;277;503
2021;January;2;2021-01-05 00:00;48;221;231;452
2021;January;2;2021-01-05 00:00;49;226;264;490
2021;January;2;2021-01-05 00:00;50;211;220;431
2021;January;2;2021-01-05 00:00;51;201;213;414
2021;January;2;2021-01-05 00:00;52;195;193;388
2021;January;2;2021-01-05 00:00;53;207;221;428
2021;January;2;2021-01-05 00:00;54;239;230;469
2021;January;2;2021-01-05 00:00;55;186;215;401
2021;January;2;2021-01-05 00:00;56;193;216;409
2021;January;2;2021-01-05 00:00;57;189;216;405
2021;January;2;2021-01-05 00:00;58;174;212;386
2021;January;2;2021-01-05 00:00;59;183;184;367
2021;January;2;2021-01-05 00:00;60;153;167;320
2021;January;2;2021-01-05 00:00;61;155;147;302
2021;January;2;2021-01-05 00:00;62;145;155;300
2021;January;2;2021-01-05 00:00;63;148;147;295
2021;January;2;2021-01-05 00:00;64;135;145;280
2021;January;2;2021-01-05 00:00;65;145;154;299
2021;January;2;2021-01-05 00:00;66;127;113;240
2021;January;2;2021-01-05 00:00;67;128;136;264
2021;January;2;2021-01-05 00:00;68;144;127;271
2021;January;2;2021-01-05 00:00;69;131;143;274
2021;January;2;2021-01-05 00:00;70;140;124;264
2021;January;2;2021-01-05 00:00;71;135;147;282
2021;January;2;2021-01-05 00:00;72;142;151;293
2021;January;2;2021-01-05 00:00;73;168;152;320
2021;January;2;2021-01-05 00:00;74;148;142;290
2021;January;2;2021-01-05 00:00;75;179;137;316
2021;January;2;2021-01-05 00:00;76;172;165;337
2021;January;2;2021-01-05 00:00;77;145;141;286
2021;January;2;2021-01-05 00:00;78;143;149;292
2021;January;2;2021-01-05 00:00;79;126;117;243
2021;January;2;2021-01-05 00:00;80;103;94;197
2021;January;2;2021-01-05 00:00;81;80;112;192
2021;January;2;2021-01-05 00:00;82;84;80;164
2021;January;2;2021-01-05 00:00;83;83;71;154
2021;January;2;2021-01-05 00:00;84;69;64;133
2021;January;2;2021-01-05 00:00;85;80;52;132
2021;January;2;2021-01-05 00:00;86;50;50;100
2021;January;2;2021-01-05 00:00;87;53;37;90
2021;January;2;2021-01-05 00:00;88;49;33;82
2021;January;2;2021-01-05 00:00;89;26;27;53
2021;January;2;2021-01-05 00:00;90;27;19;46
2021;January;2;2021-01-05 00:00;91;31;16;47
2021;January;2;2021-01-05 00:00;92;25;18;43
2021;January;2;2021-01-05 00:00;93;16;8;24
2021;January;2;2021-01-05 00:00;94;20;6;26
2021;January;2;2021-01-05 00:00;95;9;3;12
2021;January;2;2021-01-05 00:00;96;14;4;18
2021;January;2;2021-01-05 00:00;97;6;2;8
2021;January;2;2021-01-05 00:00;98;1;3;4
2021;January;2;2021-01-05 00:00;99;5;0;5
2021;January;2;2021-01-05 00:00;100;1;1;2
2021;January;2;2021-01-05 00:00;101;1;1;2
2021;January;2;2021-01-05 00:00;102;0;1;1
2021;January;2;2021-01-05 00:00;109;1;0;1
2021;January;3;2021-01-12 00:00;0;4;11;15
2021;January;3;2021-01-12 00:00;1;207;179;386
2021;January;3;2021-01-12 00:00;2;189;209;398
2021;January;3;2021-01-12 00:00;3;209;231;440
2021;January;3;2021-01-12 00:00;4;205;223;428
2021;January;3;2021-01-12 00:00;5;209;232;441
2021;January;3;2021-01-12 00:00;6;217;234;451
2021;January;3;2021-01-12 00:00;7;213;253;466
2021;January;3;2021-01-12 00:00;8;221;246;467
2021;January;3;2021-01-12 00:00;9;207;215;422
2021;January;3;2021-01-12 00:00;10;226;238;464
2021;January;3;2021-01-12 00:00;11;237;240;477
2021;January;3;2021-01-12 00:00;12;214;235;449
2021;January;3;2021-01-12 00:00;13;210;208;418
2021;January;3;2021-01-12 00:00;14;197;209;406
2021;January;3;2021-01-12 00:00;15;231;209;440
2021;January;3;2021-01-12 00:00;16;197;221;418
2021;January;3;2021-01-12 00:00;17;192;211;403
2021;January;3;2021-01-12 00:00;18;178;194;372
2021;January;3;2021-01-12 00:00;19;189;225;414
2021;January;3;2021-01-12 00:00;20;142;181;323
2021;January;3;2021-01-12 00:00;21;161;192;353
2021;January;3;2021-01-12 00:00;22;144;199;343
2021;January;3;2021-01-12 00:00;23;127;154;281
2021;January;3;2021-01-12 00:00;24;135;173;308
2021;January;3;2021-01-12 00:00;25;143;169;312
2021;January;3;2021-01-12 00:00;26;146;180;326
2021;January;3;2021-01-12 00:00;27;187;183;370
2021;January;3;2021-01-12 00:00;28;175;206;381
2021;January;3;2021-01-12 00:00;29;206;183;389
2021;January;3;2021-01-12 00:00;30;199;241;440
2021;January;3;2021-01-12 00:00;31;242;229;471
2021;January;3;2021-01-12 00:00;32;208;233;441
2021;January;3;2021-01-12 00:00;33;229;220;449
2021;January;3;2021-01-12 00:00;34;236;233;469
2021;January;3;2021-01-12 00:00;35;215;213;428
2021;January;3;2021-01-12 00:00;36;216;234;450
2021;January;3;2021-01-12 00:00;37;214;224;438
2021;January;3;2021-01-12 00:00;38;224;200;424
2021;January;3;2021-01-12 00:00;39;225;225;450
2021;January;3;2021-01-12 00:00;40;189;222;411
2021;January;3;2021-01-12 00:00;41;251;227;478
2021;January;3;2021-01-12 00:00;42;215;188;403
2021;January;3;2021-01-12 00:00;43;206;210;416
2021;January;3;2021-01-12 00:00;44;203;218;421
2021;January;3;2021-01-12 00:00;45;221;223;444
2021;January;3;2021-01-12 00:00;46;219;245;464
2021;January;3;2021-01-12 00:00;47;226;277;503
2021;January;3;2021-01-12 00:00;48;220;231;451
2021;January;3;2021-01-12 00:00;49;226;264;490
2021;January;3;2021-01-12 00:00;50;211;220;431
2021;January;3;2021-01-12 00:00;51;201;214;415
2021;January;3;2021-01-12 00:00;52;195;194;389
2021;January;3;2021-01-12 00:00;53;207;220;427
2021;January;3;2021-01-12 00:00;54;239;230;469
2021;January;3;2021-01-12 00:00;55;187;213;400
2021;January;3;2021-01-12 00:00;56;192;215;407
2021;January;3;2021-01-12 00:00;57;189;217;406
2021;January;3;2021-01-12 00:00;58;174;212;386
2021;January;3;2021-01-12 00:00;59;183;184;367
2021;January;3;2021-01-12 00:00;60;153;168;321
2021;January;3;2021-01-12 00:00;61;155;148;303
2021;January;3;2021-01-12 00:00;62;145;154;299
2021;January;3;2021-01-12 00:00;63;148;145;293
2021;January;3;2021-01-12 00:00;64;135;145;280
2021;January;3;2021-01-12 00:00;65;145;154;299
2021;January;3;2021-01-12 00:00;66;127;112;239
2021;January;3;2021-01-12 00:00;67;128;136;264
2021;January;3;2021-01-12 00:00;68;144;127;271
2021;January;3;2021-01-12 00:00;69;131;144;275
2021;January;3;2021-01-12 00:00;70;140;123;263
2021;January;3;2021-01-12 00:00;71;135;147;282
2021;January;3;2021-01-12 00:00;72;142;150;292
2021;January;3;2021-01-12 00:00;73;168;152;320
2021;January;3;2021-01-12 00:00;74;148;142;290
2021;January;3;2021-01-12 00:00;75;179;137;316
2021;January;3;2021-01-12 00:00;76;172;164;336
2021;January;3;2021-01-12 00:00;77;145;141;286
2021;January;3;2021-01-12 00:00;78;143;148;291
2021;January;3;2021-01-12 00:00;79;125;116;241
2021;January;3;2021-01-12 00:00;80;103;94;197
2021;January;3;2021-01-12 00:00;81;80;111;191
2021;January;3;2021-01-12 00:00;82;84;79;163
2021;January;3;2021-01-12 00:00;83;83;70;153
2021;January;3;2021-01-12 00:00;84;69;63;132
2021;January;3;2021-01-12 00:00;85;80;52;132
2021;January;3;2021-01-12 00:00;86;50;50;100
2021;January;3;2021-01-12 00:00;87;52;37;89
2021;January;3;2021-01-12 00:00;88;49;33;82
2021;January;3;2021-01-12 00:00;89;26;27;53
2021;January;3;2021-01-12 00:00;90;27;19;46
2021;January;3;2021-01-12 00:00;91;31;16;47
2021;January;3;2021-01-12 00:00;92;25;17;42
2021;January;3;2021-01-12 00:00;93;16;8;24
2021;January;3;2021-01-12 00:00;94;20;6;26
2021;January;3;2021-01-12 00:00;95;9;3;12
2021;January;3;2021-01-12 00:00;96;14;4;18
2021;January;3;2021-01-12 00:00;97;6;2;8
2021;January;3;2021-01-12 00:00;98;1;3;4
2021;January;3;2021-01-12 00:00;99;5;0;5
2021;January;3;2021-01-12 00:00;100;1;1;2
2021;January;3;2021-01-12 00:00;101;1;1;2
2021;January;3;2021-01-12 00:00;102;0;1;1
2021;January;3;2021-01-12 00:00;109;1;0;1
2021;January;4;2021-01-19 00:00;0;7;12;19
2021;January;4;2021-01-19 00:00;1;207;179;386
2021;January;4;2021-01-19 00:00;2;190;210;400
2021;January;4;2021-01-19 00:00;3;209;232;441
2021;January;4;2021-01-19 00:00;4;205;222;427
2021;January;4;2021-01-19 00:00;5;209;233;442
2021;January;4;2021-01-19 00:00;6;217;235;452
2021;January;4;2021-01-19 00:00;7;213;253;466
2021;January;4;2021-01-19 00:00;8;221;246;467
2021;January;4;2021-01-19 00:00;9;208;215;423
2021;January;4;2021-01-19 00:00;10;226;239;465
2021;January;4;2021-01-19 00:00;11;237;240;477
2021;January;4;2021-01-19 00:00;12;214;235;449
2021;January;4;2021-01-19 00:00;13;211;208;419
2021;January;4;2021-01-19 00:00;14;197;209;406
2021;January;4;2021-01-19 00:00;15;231;209;440
2021;January;4;2021-01-19 00:00;16;196;221;417
2021;January;4;2021-01-19 00:00;17;193;211;404
2021;January;4;2021-01-19 00:00;18;178;194;372
2021;January;4;2021-01-19 00:00;19;190;225;415
2021;January;4;2021-01-19 00:00;20;141;181;322
2021;January;4;2021-01-19 00:00;21;162;192;354
2021;January;4;2021-01-19 00:00;22;143;198;341
2021;January;4;2021-01-19 00:00;23;128;153;281
2021;January;4;2021-01-19 00:00;24;135;171;306
2021;January;4;2021-01-19 00:00;25;144;169;313
2021;January;4;2021-01-19 00:00;26;147;183;330
2021;January;4;2021-01-19 00:00;27;185;182;367
2021;January;4;2021-01-19 00:00;28;174;205;379
2021;January;4;2021-01-19 00:00;29;206;183;389
2021;January;4;2021-01-19 00:00;30;199;240;439
2021;January;4;2021-01-19 00:00;31;242;229;471
2021;January;4;2021-01-19 00:00;32;207;232;439
2021;January;4;2021-01-19 00:00;33;229;222;451
2021;January;4;2021-01-19 00:00;34;236;233;469
2021;January;4;2021-01-19 00:00;35;215;213;428
2021;January;4;2021-01-19 00:00;36;216;233;449
2021;January;4;2021-01-19 00:00;37;214;223;437
2021;January;4;2021-01-19 00:00;38;224;201;425
2021;January;4;2021-01-19 00:00;39;225;226;451
2021;January;4;2021-01-19 00:00;40;189;222;411
2021;January;4;2021-01-19 00:00;41;251;227;478
2021;January;4;2021-01-19 00:00;42;215;188;403
2021;January;4;2021-01-19 00:00;43;206;210;416
2021;January;4;2021-01-19 00:00;44;203;218;421
2021;January;4;2021-01-19 00:00;45;221;222;443
2021;January;4;2021-01-19 00:00;46;218;246;464
2021;January;4;2021-01-19 00:00;47;226;276;502
2021;January;4;2021-01-19 00:00;48;220;231;451
2021;January;4;2021-01-19 00:00;49;226;263;489
2021;January;4;2021-01-19 00:00;50;210;218;428
2021;January;4;2021-01-19 00:00;51;201;215;416
2021;January;4;2021-01-19 00:00;52;195;194;389
2021;January;4;2021-01-19 00:00;53;208;220;428
2021;January;4;2021-01-19 00:00;54;239;231;470
2021;January;4;2021-01-19 00:00;55;187;213;400
2021;January;4;2021-01-19 00:00;56;191;215;406
2021;January;4;2021-01-19 00:00;57;189;216;405
2021;January;4;2021-01-19 00:00;58;174;212;386
2021;January;4;2021-01-19 00:00;59;183;184;367
2021;January;4;2021-01-19 00:00;60;153;168;321
2021;January;4;2021-01-19 00:00;61;155;148;303
2021;January;4;2021-01-19 00:00;62;145;154;299
2021;January;4;2021-01-19 00:00;63;148;145;293
2021;January;4;2021-01-19 00:00;64;135;145;280
2021;January;4;2021-01-19 00:00;65;145;154;299
2021;January;4;2021-01-19 00:00;66;127;112;239
2021;January;4;2021-01-19 00:00;67;127;136;263
2021;January;4;2021-01-19 00:00;68;144;127;271
2021;January;4;2021-01-19 00:00;69;130;144;274
2021;January;4;2021-01-19 00:00;70;140;123;263
2021;January;4;2021-01-19 00:00;71;135;146;281
2021;January;4;2021-01-19 00:00;72;142;150;292
2021;January;4;2021-01-19 00:00;73;168;151;319
2021;January;4;2021-01-19 00:00;74;148;142;290
2021;January;4;2021-01-19 00:00;75;179;137;316
2021;January;4;2021-01-19 00:00;76;172;164;336
2021;January;4;2021-01-19 00:00;77;144;140;284
2021;January;4;2021-01-19 00:00;78;143;148;291
2021;January;4;2021-01-19 00:00;79;125;116;241
2021;January;4;2021-01-19 00:00;80;103;93;196
2021;January;4;2021-01-19 00:00;81;80;111;191
2021;January;4;2021-01-19 00:00;82;84;79;163
2021;January;4;2021-01-19 00:00;83;83;70;153
2021;January;4;2021-01-19 00:00;84;68;63;131
2021;January;4;2021-01-19 00:00;85;80;52;132
2021;January;4;2021-01-19 00:00;86;50;50;100
2021;January;4;2021-01-19 00:00;87;51;37;88
2021;January;4;2021-01-19 00:00;88;49;33;82
2021;January;4;2021-01-19 00:00;89;25;26;51
2021;January;4;2021-01-19 00:00;90;27;19;46
2021;January;4;2021-01-19 00:00;91;31;16;47
2021;January;4;2021-01-19 00:00;92;25;17;42
2021;January;4;2021-01-19 00:00;93;15;8;23
2021;January;4;2021-01-19 00:00;94;20;6;26
2021;January;4;2021-01-19 00:00;95;9;3;12
2021;January;4;2021-01-19 00:00;96;14;4;18
2021;January;4;2021-01-19 00:00;97;6;2;8
2021;January;4;2021-01-19 00:00;98;1;3;4
2021;January;4;2021-01-19 00:00;99;4;0;4
2021;January;4;2021-01-19 00:00;100;1;1;2
2021;January;4;2021-01-19 00:00;101;1;1;2
2021;January;4;2021-01-19 00:00;102;0;1;1
2021;January;4;2021-01-19 00:00;109;1;0;1
2021;January;5;2021-01-26 00:00;0;12;14;26
2021;January;5;2021-01-26 00:00;1;208;181;389
2021;January;5;2021-01-26 00:00;2;191;210;401
2021;January;5;2021-01-26 00:00;3;211;233;444
2021;January;5;2021-01-26 00:00;4;207;223;430
2021;January;5;2021-01-26 00:00;5;210;234;444
2021;January;5;2021-01-26 00:00;6;216;236;452
2021;January;5;2021-01-26 00:00;7;213;253;466
2021;January;5;2021-01-26 00:00;8;221;246;467
2021;January;5;2021-01-26 00:00;9;208;215;423
2021;January;5;2021-01-26 00:00;10;226;239;465
2021;January;5;2021-01-26 00:00;11;237;241;478
2021;January;5;2021-01-26 00:00;12;214;235;449
2021;January;5;2021-01-26 00:00;13;211;208;419
2021;January;5;2021-01-26 00:00;14;197;209;406
2021;January;5;2021-01-26 00:00;15;231;209;440
2021;January;5;2021-01-26 00:00;16;196;221;417
2021;January;5;2021-01-26 00:00;17;193;211;404
2021;January;5;2021-01-26 00:00;18;178;193;371
2021;January;5;2021-01-26 00:00;19;190;225;415
2021;January;5;2021-01-26 00:00;20;140;181;321
2021;January;5;2021-01-26 00:00;21;162;192;354
2021;January;5;2021-01-26 00:00;22;143;198;341
2021;January;5;2021-01-26 00:00;23;128;153;281
2021;January;5;2021-01-26 00:00;24;134;171;305
2021;January;5;2021-01-26 00:00;25;144;168;312
2021;January;5;2021-01-26 00:00;26;148;182;330
2021;January;5;2021-01-26 00:00;27;185;183;368
2021;January;5;2021-01-26 00:00;28;173;206;379
2021;January;5;2021-01-26 00:00;29;207;183;390
2021;January;5;2021-01-26 00:00;30;200;240;440
2021;January;5;2021-01-26 00:00;31;242;229;471
2021;January;5;2021-01-26 00:00;32;209;233;442
2021;January;5;2021-01-26 00:00;33;229;223;452
2021;January;5;2021-01-26 00:00;34;238;234;472
2021;January;5;2021-01-26 00:00;35;215;214;429
2021;January;5;2021-01-26 00:00;36;216;234;450
2021;January;5;2021-01-26 00:00;37;215;221;436
2021;January;5;2021-01-26 00:00;38;224;201;425
2021;January;5;2021-01-26 00:00;39;225;226;451
2021;January;5;2021-01-26 00:00;40;188;222;410
2021;January;5;2021-01-26 00:00;41;251;227;478
2021;January;5;2021-01-26 00:00;42;215;188;403
2021;January;5;2021-01-26 00:00;43;206;210;416
2021;January;5;2021-01-26 00:00;44;203;218;421
2021;January;5;2021-01-26 00:00;45;221;223;444
2021;January;5;2021-01-26 00:00;46;218;245;463
2021;January;5;2021-01-26 00:00;47;226;276;502
2021;January;5;2021-01-26 00:00;48;220;231;451
2021;January;5;2021-01-26 00:00;49;226;264;490
2021;January;5;2021-01-26 00:00;50;209;218;427
2021;January;5;2021-01-26 00:00;51;200;215;415
2021;January;5;2021-01-26 00:00;52;195;194;389
2021;January;5;2021-01-26 00:00;53;207;220;427
2021;January;5;2021-01-26 00:00;54;239;231;470
2021;January;5;2021-01-26 00:00;55;187;213;400
2021;January;5;2021-01-26 00:00;56;191;215;406
2021;January;5;2021-01-26 00:00;57;189;216;405
2021;January;5;2021-01-26 00:00;58;174;212;386
2021;January;5;2021-01-26 00:00;59;183;183;366
2021;January;5;2021-01-26 00:00;60;153;167;320
2021;January;5;2021-01-26 00:00;61;156;148;304
2021;January;5;2021-01-26 00:00;62;145;153;298
2021;January;5;2021-01-26 00:00;63;148;144;292
2021;January;5;2021-01-26 00:00;64;135;145;280
2021;January;5;2021-01-26 00:00;65;145;154;299
2021;January;5;2021-01-26 00:00;66;127;112;239
2021;January;5;2021-01-26 00:00;67;127;136;263
2021;January;5;2021-01-26 00:00;68;144;127;271
2021;January;5;2021-01-26 00:00;69;130;144;274
2021;January;5;2021-01-26 00:00;70;140;123;263
2021;January;5;2021-01-26 00:00;71;135;146;281
2021;January;5;2021-01-26 00:00;72;142;150;292
2021;January;5;2021-01-26 00:00;73;168;151;319
2021;January;5;2021-01-26 00:00;74;148;142;290
2021;January;5;2021-01-26 00:00;75;179;137;316
2021;January;5;2021-01-26 00:00;76;172;164;336
2021;January;5;2021-01-26 00:00;77;144;140;284
2021;January;5;2021-01-26 00:00;78;143;148;291
2021;January;5;2021-01-26 00:00;79;125;116;241
2021;January;5;2021-01-26 00:00;80;102;93;195
2021;January;5;2021-01-26 00:00;81;79;111;190
2021;January;5;2021-01-26 00:00;82;84;78;162
2021;January;5;2021-01-26 00:00;83;83;70;153
2021;January;5;2021-01-26 00:00;84;67;63;130
2021;January;5;2021-01-26 00:00;85;80;51;131
2021;January;5;2021-01-26 00:00;86;50;50;100
2021;January;5;2021-01-26 00:00;87;51;37;88
2021;January;5;2021-01-26 00:00;88;49;33;82
2021;January;5;2021-01-26 00:00;89;25;26;51
2021;January;5;2021-01-26 00:00;90;27;19;46
2021;January;5;2021-01-26 00:00;91;31;16;47
2021;January;5;2021-01-26 00:00;92;25;17;42
2021;January;5;2021-01-26 00:00;93;15;8;23
2021;January;5;2021-01-26 00:00;94;20;6;26
2021;January;5;2021-01-26 00:00;95;9;3;12
2021;January;5;2021-01-26 00:00;96;14;4;18
2021;January;5;2021-01-26 00:00;97;6;1;7
2021;January;5;2021-01-26 00:00;98;1;3;4
2021;January;5;2021-01-26 00:00;99;4;0;4
2021;January;5;2021-01-26 00:00;100;1;1;2
2021;January;5;2021-01-26 00:00;101;1;1;2
2021;January;5;2021-01-26 00:00;102;0;1;1
2021;January;5;2021-01-26 00:00;109;1;0;1
2021;February;6;2021-02-02 00:00;0;16;21;37
2021;February;6;2021-02-02 00:00;1;208;182;390
2021;February;6;2021-02-02 00:00;2;193;211;404
2021;February;6;2021-02-02 00:00;3;212;235;447
2021;February;6;2021-02-02 00:00;4;207;224;431
2021;February;6;2021-02-02 00:00;5;209;233;442
2021;February;6;2021-02-02 00:00;6;216;236;452
2021;February;6;2021-02-02 00:00;7;213;253;466
2021;February;6;2021-02-02 00:00;8;221;246;467
2021;February;6;2021-02-02 00:00;9;208;215;423
2021;February;6;2021-02-02 00:00;10;226;239;465
2021;February;6;2021-02-02 00:00;11;236;241;477
2021;February;6;2021-02-02 00:00;12;213;235;448
2021;February;6;2021-02-02 00:00;13;210;207;417
2021;February;6;2021-02-02 00:00;14;197;209;406
2021;February;6;2021-02-02 00:00;15;231;210;441
2021;February;6;2021-02-02 00:00;16;195;221;416
2021;February;6;2021-02-02 00:00;17;193;211;404
2021;February;6;2021-02-02 00:00;18;178;193;371
2021;February;6;2021-02-02 00:00;19;189;224;413
2021;February;6;2021-02-02 00:00;20;139;183;322
2021;February;6;2021-02-02 00:00;21;162;191;353
2021;February;6;2021-02-02 00:00;22;142;196;338
2021;February;6;2021-02-02 00:00;23;128;152;280
2021;February;6;2021-02-02 00:00;24;135;169;304
2021;February;6;2021-02-02 00:00;25;144;167;311
2021;February;6;2021-02-02 00:00;26;148;181;329
2021;February;6;2021-02-02 00:00;27;187;186;373
2021;February;6;2021-02-02 00:00;28;172;208;380
2021;February;6;2021-02-02 00:00;29;210;182;392
2021;February;6;2021-02-02 00:00;30;202;239;441
2021;February;6;2021-02-02 00:00;31;242;229;471
2021;February;6;2021-02-02 00:00;32;209;232;441
2021;February;6;2021-02-02 00:00;33;229;226;455
2021;February;6;2021-02-02 00:00;34;238;235;473
2021;February;6;2021-02-02 00:00;35;215;215;430
2021;February;6;2021-02-02 00:00;36;217;235;452
2021;February;6;2021-02-02 00:00;37;215;221;436
2021;February;6;2021-02-02 00:00;38;224;201;425
2021;February;6;2021-02-02 00:00;39;225;226;451
2021;February;6;2021-02-02 00:00;40;188;222;410
2021;February;6;2021-02-02 00:00;41;252;228;480
2021;February;6;2021-02-02 00:00;42;214;188;402
2021;February;6;2021-02-02 00:00;43;206;210;416
2021;February;6;2021-02-02 00:00;44;202;218;420
2021;February;6;2021-02-02 00:00;45;222;223;445
2021;February;6;2021-02-02 00:00;46;218;245;463
2021;February;6;2021-02-02 00:00;47;226;277;503
2021;February;6;2021-02-02 00:00;48;220;230;450
2021;February;6;2021-02-02 00:00;49;226;264;490
2021;February;6;2021-02-02 00:00;50;209;218;427
2021;February;6;2021-02-02 00:00;51;200;215;415
2021;February;6;2021-02-02 00:00;52;195;195;390
2021;February;6;2021-02-02 00:00;53;207;219;426
2021;February;6;2021-02-02 00:00;54;239;231;470
2021;February;6;2021-02-02 00:00;55;187;212;399
2021;February;6;2021-02-02 00:00;56;191;215;406
2021;February;6;2021-02-02 00:00;57;189;216;405
2021;February;6;2021-02-02 00:00;58;174;213;387
2021;February;6;2021-02-02 00:00;59;184;183;367
2021;February;6;2021-02-02 00:00;60;153;166;319
2021;February;6;2021-02-02 00:00;61;157;148;305
2021;February;6;2021-02-02 00:00;62;145;153;298
2021;February;6;2021-02-02 00:00;63;148;142;290
2021;February;6;2021-02-02 00:00;64;135;145;280
2021;February;6;2021-02-02 00:00;65;145;154;299
2021;February;6;2021-02-02 00:00;66;127;112;239
2021;February;6;2021-02-02 00:00;67;127;136;263
2021;February;6;2021-02-02 00:00;68;144;128;272
2021;February;6;2021-02-02 00:00;69;131;144;275
2021;February;6;2021-02-02 00:00;70;140;123;263
2021;February;6;2021-02-02 00:00;71;135;146;281
2021;February;6;2021-02-02 00:00;72;142;151;293
2021;February;6;2021-02-02 00:00;73;168;151;319
2021;February;6;2021-02-02 00:00;74;148;142;290
2021;February;6;2021-02-02 00:00;75;179;137;316
2021;February;6;2021-02-02 00:00;76;171;164;335
2021;February;6;2021-02-02 00:00;77;144;140;284
2021;February;6;2021-02-02 00:00;78;143;148;291
2021;February;6;2021-02-02 00:00;79;125;116;241
2021;February;6;2021-02-02 00:00;80;102;93;195
2021;February;6;2021-02-02 00:00;81;79;111;190
2021;February;6;2021-02-02 00:00;82;84;77;161
2021;February;6;2021-02-02 00:00;83;83;70;153
2021;February;6;2021-02-02 00:00;84;66;63;129
2021;February;6;2021-02-02 00:00;85;80;51;131
2021;February;6;2021-02-02 00:00;86;50;50;100
2021;February;6;2021-02-02 00:00;87;51;36;87
2021;February;6;2021-02-02 00:00;88;48;33;81
2021;February;6;2021-02-02 00:00;89;25;26;51
2021;February;6;2021-02-02 00:00;90;27;19;46
2021;February;6;2021-02-02 00:00;91;31;16;47
2021;February;6;2021-02-02 00:00;92;25;17;42
2021;February;6;2021-02-02 00:00;93;15;8;23
2021;February;6;2021-02-02 00:00;94;20;6;26
2021;February;6;2021-02-02 00:00;95;9;3;12
2021;February;6;2021-02-02 00:00;96;14;4;18
2021;February;6;2021-02-02 00:00;97;6;1;7
2021;February;6;2021-02-02 00:00;98;1;3;4
2021;February;6;2021-02-02 00:00;99;4;0;4
2021;February;6;2021-02-02 00:00;100;1;1;2
2021;February;6;2021-02-02 00:00;101;1;1;2
2021;February;6;2021-02-02 00:00;102;0;1;1
2021;February;6;2021-02-02 00:00;109;1;0;1
2021;February;7;2021-02-10 00:00;0;24;27;51
2021;February;7;2021-02-10 00:00;1;209;180;389
2021;February;7;2021-02-10 00:00;2;194;211;405
2021;February;7;2021-02-10 00:00;3;212;236;448
2021;February;7;2021-02-10 00:00;4;207;224;431
2021;February;7;2021-02-10 00:00;5;208;234;442
2021;February;7;2021-02-10 00:00;6;216;236;452
2021;February;7;2021-02-10 00:00;7;214;252;466
2021;February;7;2021-02-10 00:00;8;221;246;467
2021;February;7;2021-02-10 00:00;9;209;214;423
2021;February;7;2021-02-10 00:00;10;226;240;466
2021;February;7;2021-02-10 00:00;11;237;241;478
2021;February;7;2021-02-10 00:00;12;213;235;448
2021;February;7;2021-02-10 00:00;13;212;207;419
2021;February;7;2021-02-10 00:00;14;197;209;406
2021;February;7;2021-02-10 00:00;15;232;212;444
2021;February;7;2021-02-10 00:00;16;194;222;416
2021;February;7;2021-02-10 00:00;17;193;211;404
2021;February;7;2021-02-10 00:00;18;178;193;371
2021;February;7;2021-02-10 00:00;19;189;226;415
2021;February;7;2021-02-10 00:00;20;139;182;321
2021;February;7;2021-02-10 00:00;21;162;188;350
2021;February;7;2021-02-10 00:00;22;143;196;339
2021;February;7;2021-02-10 00:00;23;127;151;278
2021;February;7;2021-02-10 00:00;24;134;169;303
2021;February;7;2021-02-10 00:00;25;143;166;309
2021;February;7;2021-02-10 00:00;26;148;181;329
2021;February;7;2021-02-10 00:00;27;188;185;373
2021;February;7;2021-02-10 00:00;28;174;207;381
2021;February;7;2021-02-10 00:00;29;211;182;393
2021;February;7;2021-02-10 00:00;30;203;238;441
2021;February;7;2021-02-10 00:00;31;241;231;472
2021;February;7;2021-02-10 00:00;32;209;233;442
2021;February;7;2021-02-10 00:00;33;230;226;456
2021;February;7;2021-02-10 00:00;34;238;236;474
2021;February;7;2021-02-10 00:00;35;215;214;429
2021;February;7;2021-02-10 00:00;36;218;235;453
2021;February;7;2021-02-10 00:00;37;215;221;436
2021;February;7;2021-02-10 00:00;38;224;202;426
2021;February;7;2021-02-10 00:00;39;227;228;455
2021;February;7;2021-02-10 00:00;40;187;223;410
2021;February;7;2021-02-10 00:00;41;252;227;479
2021;February;7;2021-02-10 00:00;42;214;188;402
2021;February;7;2021-02-10 00:00;43;207;210;417
2021;February;7;2021-02-10 00:00;44;203;219;422
2021;February;7;2021-02-10 00:00;45;223;223;446
2021;February;7;2021-02-10 00:00;46;219;247;466
2021;February;7;2021-02-10 00:00;47;226;278;504
2021;February;7;2021-02-10 00:00;48;220;230;450
2021;February;7;2021-02-10 00:00;49;226;264;490
2021;February;7;2021-02-10 00:00;50;209;218;427
2021;February;7;2021-02-10 00:00;51;200;215;415
2021;February;7;2021-02-10 00:00;52;195;194;389
2021;February;7;2021-02-10 00:00;53;207;220;427
2021;February;7;2021-02-10 00:00;54;239;231;470
2021;February;7;2021-02-10 00:00;55;187;212;399
2021;February;7;2021-02-10 00:00;56;191;215;406
2021;February;7;2021-02-10 00:00;57;189;216;405
2021;February;7;2021-02-10 00:00;58;174;213;387
2021;February;7;2021-02-10 00:00;59;184;183;367
2021;February;7;2021-02-10 00:00;60;153;166;319
2021;February;7;2021-02-10 00:00;61;157;148;305
2021;February;7;2021-02-10 00:00;62;145;154;299
2021;February;7;2021-02-10 00:00;63;148;142;290
2021;February;7;2021-02-10 00:00;64;135;145;280
2021;February;7;2021-02-10 00:00;65;145;154;299
2021;February;7;2021-02-10 00:00;66;127;112;239
2021;February;7;2021-02-10 00:00;67;127;136;263
2021;February;7;2021-02-10 00:00;68;144;128;272
2021;February;7;2021-02-10 00:00;69;131;144;275
2021;February;7;2021-02-10 00:00;70;140;123;263
2021;February;7;2021-02-10 00:00;71;135;146;281
2021;February;7;2021-02-10 00:00;72;142;151;293
2021;February;7;2021-02-10 00:00;73;168;151;319
2021;February;7;2021-02-10 00:00;74;148;142;290
2021;February;7;2021-02-10 00:00;75;179;136;315
2021;February;7;2021-02-10 00:00;76;171;164;335
2021;February;7;2021-02-10 00:00;77;144;140;284
2021;February;7;2021-02-10 00:00;78;143;148;291
2021;February;7;2021-02-10 00:00;79;124;116;240
2021;February;7;2021-02-10 00:00;80;102;93;195
2021;February;7;2021-02-10 00:00;81;79;111;190
2021;February;7;2021-02-10 00:00;82;84;77;161
2021;February;7;2021-02-10 00:00;83;83;70;153
2021;February;7;2021-02-10 00:00;84;66;62;128
2021;February;7;2021-02-10 00:00;85;79;51;130
2021;February;7;2021-02-10 00:00;86;50;50;100
2021;February;7;2021-02-10 00:00;87;51;35;86
2021;February;7;2021-02-10 00:00;88;48;33;81
2021;February;7;2021-02-10 00:00;89;25;26;51
2021;February;7;2021-02-10 00:00;90;27;19;46
2021;February;7;2021-02-10 00:00;91;31;16;47
2021;February;7;2021-02-10 00:00;92;24;17;41
2021;February;7;2021-02-10 00:00;93;15;7;22
2021;February;7;2021-02-10 00:00;94;20;6;26
2021;February;7;2021-02-10 00:00;95;9;3;12
2021;February;7;2021-02-10 00:00;96;14;4;18
2021;February;7;2021-02-10 00:00;97;6;1;7
2021;February;7;2021-02-10 00:00;98;1;3;4
2021;February;7;2021-02-10 00:00;99;4;0;4
2021;February;7;2021-02-10 00:00;100;1;1;2
2021;February;7;2021-02-10 00:00;101;1;1;2
2021;February;7;2021-02-10 00:00;102;0;1;1
2021;February;7;2021-02-10 00:00;109;1;0;1
2021;February;8;2021-02-16 00:00;0;31;34;65
2021;February;8;2021-02-16 00:00;1;211;181;392
2021;February;8;2021-02-16 00:00;2;195;210;405
2021;February;8;2021-02-16 00:00;3;213;236;449
2021;February;8;2021-02-16 00:00;4;207;224;431
2021;February;8;2021-02-16 00:00;5;208;234;442
2021;February;8;2021-02-16 00:00;6;217;237;454
2021;February;8;2021-02-16 00:00;7;213;252;465
2021;February;8;2021-02-16 00:00;8;220;247;467
2021;February;8;2021-02-16 00:00;9;209;214;423
2021;February;8;2021-02-16 00:00;10;226;240;466
2021;February;8;2021-02-16 00:00;11;238;241;479
2021;February;8;2021-02-16 00:00;12;213;234;447
2021;February;8;2021-02-16 00:00;13;212;207;419
2021;February;8;2021-02-16 00:00;14;197;209;406
2021;February;8;2021-02-16 00:00;15;232;212;444
2021;February;8;2021-02-16 00:00;16;194;222;416
2021;February;8;2021-02-16 00:00;17;192;210;402
2021;February;8;2021-02-16 00:00;18;178;193;371
2021;February;8;2021-02-16 00:00;19;189;226;415
2021;February;8;2021-02-16 00:00;20;136;182;318
2021;February;8;2021-02-16 00:00;21;162;188;350
2021;February;8;2021-02-16 00:00;22;143;197;340
2021;February;8;2021-02-16 00:00;23;125;151;276
2021;February;8;2021-02-16 00:00;24;134;169;303
2021;February;8;2021-02-16 00:00;25;143;167;310
2021;February;8;2021-02-16 00:00;26;148;180;328
2021;February;8;2021-02-16 00:00;27;188;184;372
2021;February;8;2021-02-16 00:00;28;176;208;384
2021;February;8;2021-02-16 00:00;29;213;181;394
2021;February;8;2021-02-16 00:00;30;205;240;445
2021;February;8;2021-02-16 00:00;31;242;231;473
2021;February;8;2021-02-16 00:00;32;208;233;441
2021;February;8;2021-02-16 00:00;33;231;225;456
2021;February;8;2021-02-16 00:00;34;237;237;474
2021;February;8;2021-02-16 00:00;35;214;214;428
2021;February;8;2021-02-16 00:00;36;218;236;454
2021;February;8;2021-02-16 00:00;37;214;221;435
2021;February;8;2021-02-16 00:00;38;224;201;425
2021;February;8;2021-02-16 00:00;39;227;228;455
2021;February;8;2021-02-16 00:00;40;188;222;410
2021;February;8;2021-02-16 00:00;41;252;227;479
2021;February;8;2021-02-16 00:00;42;214;188;402
2021;February;8;2021-02-16 00:00;43;206;210;416
2021;February;8;2021-02-16 00:00;44;203;219;422
2021;February;8;2021-02-16 00:00;45;222;223;445
2021;February;8;2021-02-16 00:00;46;219;247;466
2021;February;8;2021-02-16 00:00;47;226;277;503
2021;February;8;2021-02-16 00:00;48;220;230;450
2021;February;8;2021-02-16 00:00;49;226;264;490
2021;February;8;2021-02-16 00:00;50;210;218;428
2021;February;8;2021-02-16 00:00;51;200;215;415
2021;February;8;2021-02-16 00:00;52;195;193;388
2021;February;8;2021-02-16 00:00;53;207;220;427
2021;February;8;2021-02-16 00:00;54;239;231;470
2021;February;8;2021-02-16 00:00;55;187;212;399
2021;February;8;2021-02-16 00:00;56;191;215;406
2021;February;8;2021-02-16 00:00;57;189;215;404
2021;February;8;2021-02-16 00:00;58;173;213;386
2021;February;8;2021-02-16 00:00;59;184;183;367
2021;February;8;2021-02-16 00:00;60;153;166;319
2021;February;8;2021-02-16 00:00;61;157;148;305
2021;February;8;2021-02-16 00:00;62;145;154;299
2021;February;8;2021-02-16 00:00;63;148;142;290
2021;February;8;2021-02-16 00:00;64;135;145;280
2021;February;8;2021-02-16 00:00;65;145;154;299
2021;February;8;2021-02-16 00:00;66;127;111;238
2021;February;8;2021-02-16 00:00;67;127;136;263
2021;February;8;2021-02-16 00:00;68;144;128;272
2021;February;8;2021-02-16 00:00;69;131;144;275
2021;February;8;2021-02-16 00:00;70;140;123;263
2021;February;8;2021-02-16 00:00;71;135;146;281
2021;February;8;2021-02-16 00:00;72;142;151;293
2021;February;8;2021-02-16 00:00;73;168;151;319
2021;February;8;2021-02-16 00:00;74;148;143;291
2021;February;8;2021-02-16 00:00;75;179;136;315
2021;February;8;2021-02-16 00:00;76;171;164;335
2021;February;8;2021-02-16 00:00;77;144;140;284
2021;February;8;2021-02-16 00:00;78;143;148;291
2021;February;8;2021-02-16 00:00;79;124;116;240
2021;February;8;2021-02-16 00:00;80;102;93;195
2021;February;8;2021-02-16 00:00;81;79;111;190
2021;February;8;2021-02-16 00:00;82;85;77;162
2021;February;8;2021-02-16 00:00;83;83;70;153
2021;February;8;2021-02-16 00:00;84;66;62;128
2021;February;8;2021-02-16 00:00;85;79;51;130
2021;February;8;2021-02-16 00:00;86;50;49;99
2021;February;8;2021-02-16 00:00;87;51;35;86
2021;February;8;2021-02-16 00:00;88;48;33;81
2021;February;8;2021-02-16 00:00;89;25;26;51
2021;February;8;2021-02-16 00:00;90;27;19;46
2021;February;8;2021-02-16 00:00;91;31;16;47
2021;February;8;2021-02-16 00:00;92;24;17;41
2021;February;8;2021-02-16 00:00;93;15;7;22
2021;February;8;2021-02-16 00:00;94;20;6;26
2021;February;8;2021-02-16 00:00;95;9;3;12
2021;February;8;2021-02-16 00:00;96;14;4;18
2021;February;8;2021-02-16 00:00;97;6;1;7
2021;February;8;2021-02-16 00:00;98;1;3;4
2021;February;8;2021-02-16 00:00;99;4;0;4
2021;February;8;2021-02-16 00:00;100;1;1;2
2021;February;8;2021-02-16 00:00;101;1;1;2
2021;February;8;2021-02-16 00:00;102;0;1;1
2021;February;8;2021-02-16 00:00;109;1;0;1
2021;February;9;2021-02-23 00:00;0;36;39;75
2021;February;9;2021-02-23 00:00;1;212;180;392
2021;February;9;2021-02-23 00:00;2;195;211;406
2021;February;9;2021-02-23 00:00;3;214;236;450
2021;February;9;2021-02-23 00:00;4;207;225;432
2021;February;9;2021-02-23 00:00;5;208;234;442
2021;February;9;2021-02-23 00:00;6;218;237;455
2021;February;9;2021-02-23 00:00;7;213;252;465
2021;February;9;2021-02-23 00:00;8;219;247;466
2021;February;9;2021-02-23 00:00;9;209;214;423
2021;February;9;2021-02-23 00:00;10;226;240;466
2021;February;9;2021-02-23 00:00;11;238;241;479
2021;February;9;2021-02-23 00:00;12;213;234;447
2021;February;9;2021-02-23 00:00;13;212;207;419
2021;February;9;2021-02-23 00:00;14;197;209;406
2021;February;9;2021-02-23 00:00;15;232;212;444
2021;February;9;2021-02-23 00:00;16;194;222;416
2021;February;9;2021-02-23 00:00;17;192;210;402
2021;February;9;2021-02-23 00:00;18;178;193;371
2021;February;9;2021-02-23 00:00;19;188;226;414
2021;February;9;2021-02-23 00:00;20;137;182;319
2021;February;9;2021-02-23 00:00;21;161;188;349
2021;February;9;2021-02-23 00:00;22;144;198;342
2021;February;9;2021-02-23 00:00;23;125;150;275
2021;February;9;2021-02-23 00:00;24;134;168;302
2021;February;9;2021-02-23 00:00;25;144;169;313
2021;February;9;2021-02-23 00:00;26;150;180;330
2021;February;9;2021-02-23 00:00;27;187;186;373
2021;February;9;2021-02-23 00:00;28;175;208;383
2021;February;9;2021-02-23 00:00;29;212;179;391
2021;February;9;2021-02-23 00:00;30;205;241;446
2021;February;9;2021-02-23 00:00;31;242;233;475
2021;February;9;2021-02-23 00:00;32;206;233;439
2021;February;9;2021-02-23 00:00;33;231;225;456
2021;February;9;2021-02-23 00:00;34;237;237;474
2021;February;9;2021-02-23 00:00;35;214;215;429
2021;February;9;2021-02-23 00:00;36;217;235;452
2021;February;9;2021-02-23 00:00;37;213;221;434
2021;February;9;2021-02-23 00:00;38;225;201;426
2021;February;9;2021-02-23 00:00;39;227;228;455
2021;February;9;2021-02-23 00:00;40;189;222;411
2021;February;9;2021-02-23 00:00;41;252;227;479
2021;February;9;2021-02-23 00:00;42;214;188;402
2021;February;9;2021-02-23 00:00;43;206;209;415
2021;February;9;2021-02-23 00:00;44;203;219;422
2021;February;9;2021-02-23 00:00;45;222;223;445
2021;February;9;2021-02-23 00:00;46;219;247;466
2021;February;9;2021-02-23 00:00;47;226;276;502
2021;February;9;2021-02-23 00:00;48;220;229;449
2021;February;9;2021-02-23 00:00;49;226;266;492
2021;February;9;2021-02-23 00:00;50;210;218;428
2021;February;9;2021-02-23 00:00;51;200;215;415
2021;February;9;2021-02-23 00:00;52;195;193;388
2021;February;9;2021-02-23 00:00;53;208;220;428
2021;February;9;2021-02-23 00:00;54;239;232;471
2021;February;9;2021-02-23 00:00;55;187;212;399
2021;February;9;2021-02-23 00:00;56;191;215;406
2021;February;9;2021-02-23 00:00;57;189;215;404
2021;February;9;2021-02-23 00:00;58;173;213;386
2021;February;9;2021-02-23 00:00;59;184;183;367
2021;February;9;2021-02-23 00:00;60;153;165;318
2021;February;9;2021-02-23 00:00;61;157;148;305
2021;February;9;2021-02-23 00:00;62;145;154;299
2021;February;9;2021-02-23 00:00;63;147;142;289
2021;February;9;2021-02-23 00:00;64;136;145;281
2021;February;9;2021-02-23 00:00;65;145;154;299
2021;February;9;2021-02-23 00:00;66;127;111;238
2021;February;9;2021-02-23 00:00;67;128;136;264
2021;February;9;2021-02-23 00:00;68;144;128;272
2021;February;9;2021-02-23 00:00;69;131;144;275
2021;February;9;2021-02-23 00:00;70;140;123;263
2021;February;9;2021-02-23 00:00;71;135;145;280
2021;February;9;2021-02-23 00:00;72;142;151;293
2021;February;9;2021-02-23 00:00;73;169;151;320
2021;February;9;2021-02-23 00:00;74;148;143;291
2021;February;9;2021-02-23 00:00;75;178;136;314
2021;February;9;2021-02-23 00:00;76;170;164;334
2021;February;9;2021-02-23 00:00;77;144;140;284
2021;February;9;2021-02-23 00:00;78;143;148;291
2021;February;9;2021-02-23 00:00;79;124;116;240
2021;February;9;2021-02-23 00:00;80;102;93;195
2021;February;9;2021-02-23 00:00;81;78;111;189
2021;February;9;2021-02-23 00:00;82;85;77;162
2021;February;9;2021-02-23 00:00;83;83;70;153
2021;February;9;2021-02-23 00:00;84;66;62;128
2021;February;9;2021-02-23 00:00;85;79;51;130
2021;February;9;2021-02-23 00:00;86;50;50;100
2021;February;9;2021-02-23 00:00;87;50;35;85
2021;February;9;2021-02-23 00:00;88;48;33;81
2021;February;9;2021-02-23 00:00;89;25;26;51
2021;February;9;2021-02-23 00:00;90;27;19;46
2021;February;9;2021-02-23 00:00;91;31;15;46
2021;February;9;2021-02-23 00:00;92;23;17;40
2021;February;9;2021-02-23 00:00;93;15;7;22
2021;February;9;2021-02-23 00:00;94;20;6;26
2021;February;9;2021-02-23 00:00;95;9;3;12
2021;February;9;2021-02-23 00:00;96;14;4;18
2021;February;9;2021-02-23 00:00;97;6;1;7
2021;February;9;2021-02-23 00:00;98;1;3;4
2021;February;9;2021-02-23 00:00;99;4;0;4
2021;February;9;2021-02-23 00:00;100;1;1;2
2021;February;9;2021-02-23 00:00;101;1;0;1
2021;February;9;2021-02-23 00:00;102;0;1;1
2021;February;9;2021-02-23 00:00;109;1;0;1
2021;March;10;2021-03-02 00:00;0;39;42;81
2021;March;10;2021-03-02 00:00;1;212;181;393
2021;March;10;2021-03-02 00:00;2;195;211;406
2021;March;10;2021-03-02 00:00;3;215;238;453
2021;March;10;2021-03-02 00:00;4;207;224;431
2021;March;10;2021-03-02 00:00;5;208;235;443
2021;March;10;2021-03-02 00:00;6;220;237;457
2021;March;10;2021-03-02 00:00;7;213;253;466
2021;March;10;2021-03-02 00:00;8;219;247;466
2021;March;10;2021-03-02 00:00;9;210;213;423
2021;March;10;2021-03-02 00:00;10;226;240;466
2021;March;10;2021-03-02 00:00;11;238;241;479
2021;March;10;2021-03-02 00:00;12;213;234;447
2021;March;10;2021-03-02 00:00;13;212;207;419
2021;March;10;2021-03-02 00:00;14;197;210;407
2021;March;10;2021-03-02 00:00;15;231;212;443
2021;March;10;2021-03-02 00:00;16;195;223;418
2021;March;10;2021-03-02 00:00;17;192;212;404
2021;March;10;2021-03-02 00:00;18;177;194;371
2021;March;10;2021-03-02 00:00;19;187;226;413
2021;March;10;2021-03-02 00:00;20;136;182;318
2021;March;10;2021-03-02 00:00;21;160;188;348
2021;March;10;2021-03-02 00:00;22;143;196;339
2021;March;10;2021-03-02 00:00;23;123;150;273
2021;March;10;2021-03-02 00:00;24;136;168;304
2021;March;10;2021-03-02 00:00;25;145;171;316
2021;March;10;2021-03-02 00:00;26;151;179;330
2021;March;10;2021-03-02 00:00;27;189;187;376
2021;March;10;2021-03-02 00:00;28;174;208;382
2021;March;10;2021-03-02 00:00;29;211;182;393
2021;March;10;2021-03-02 00:00;30;205;242;447
2021;March;10;2021-03-02 00:00;31;242;233;475
2021;March;10;2021-03-02 00:00;32;206;232;438
2021;March;10;2021-03-02 00:00;33;231;225;456
2021;March;10;2021-03-02 00:00;34;237;237;474
2021;March;10;2021-03-02 00:00;35;214;213;427
2021;March;10;2021-03-02 00:00;36;217;236;453
2021;March;10;2021-03-02 00:00;37;211;219;430
2021;March;10;2021-03-02 00:00;38;225;201;426
2021;March;10;2021-03-02 00:00;39;228;229;457
2021;March;10;2021-03-02 00:00;40;188;221;409
2021;March;10;2021-03-02 00:00;41;253;227;480
2021;March;10;2021-03-02 00:00;42;213;188;401
2021;March;10;2021-03-02 00:00;43;205;209;414
2021;March;10;2021-03-02 00:00;44;203;219;422
2021;March;10;2021-03-02 00:00;45;222;223;445
2021;March;10;2021-03-02 00:00;46;219;247;466
2021;March;10;2021-03-02 00:00;47;226;277;503
2021;March;10;2021-03-02 00:00;48;221;229;450
2021;March;10;2021-03-02 00:00;49;227;265;492
2021;March;10;2021-03-02 00:00;50;211;218;429
2021;March;10;2021-03-02 00:00;51;200;215;415
2021;March;10;2021-03-02 00:00;52;195;193;388
2021;March;10;2021-03-02 00:00;53;208;220;428
2021;March;10;2021-03-02 00:00;54;239;232;471
2021;March;10;2021-03-02 00:00;55;187;212;399
2021;March;10;2021-03-02 00:00;56;191;215;406
2021;March;10;2021-03-02 00:00;57;189;214;403
2021;March;10;2021-03-02 00:00;58;171;213;384
2021;March;10;2021-03-02 00:00;59;183;184;367
2021;March;10;2021-03-02 00:00;60;153;164;317
2021;March;10;2021-03-02 00:00;61;157;146;303
2021;March;10;2021-03-02 00:00;62;145;154;299
2021;March;10;2021-03-02 00:00;63;146;142;288
2021;March;10;2021-03-02 00:00;64;136;145;281
2021;March;10;2021-03-02 00:00;65;145;154;299
2021;March;10;2021-03-02 00:00;66;127;110;237
2021;March;10;2021-03-02 00:00;67;128;136;264
2021;March;10;2021-03-02 00:00;68;143;128;271
2021;March;10;2021-03-02 00:00;69;131;144;275
2021;March;10;2021-03-02 00:00;70;140;123;263
2021;March;10;2021-03-02 00:00;71;134;144;278
2021;March;10;2021-03-02 00:00;72;142;151;293
2021;March;10;2021-03-02 00:00;73;169;151;320
2021;March;10;2021-03-02 00:00;74;148;143;291
2021;March;10;2021-03-02 00:00;75;178;136;314
2021;March;10;2021-03-02 00:00;76;170;165;335
2021;March;10;2021-03-02 00:00;77;145;140;285
2021;March;10;2021-03-02 00:00;78;143;148;291
2021;March;10;2021-03-02 00:00;79;124;117;241
2021;March;10;2021-03-02 00:00;80;102;92;194
2021;March;10;2021-03-02 00:00;81;78;111;189
2021;March;10;2021-03-02 00:00;82;84;76;160
2021;March;10;2021-03-02 00:00;83;83;70;153
2021;March;10;2021-03-02 00:00;84;67;62;129
2021;March;10;2021-03-02 00:00;85;79;51;130
2021;March;10;2021-03-02 00:00;86;50;50;100
2021;March;10;2021-03-02 00:00;87;50;35;85
2021;March;10;2021-03-02 00:00;88;48;33;81
2021;March;10;2021-03-02 00:00;89;24;26;50
2021;March;10;2021-03-02 00:00;90;27;19;46
2021;March;10;2021-03-02 00:00;91;31;15;46
2021;March;10;2021-03-02 00:00;92;23;16;39
2021;March;10;2021-03-02 00:00;93;15;7;22
2021;March;10;2021-03-02 00:00;94;20;6;26
2021;March;10;2021-03-02 00:00;95;9;3;12
2021;March;10;2021-03-02 00:00;96;14;4;18
2021;March;10;2021-03-02 00:00;97;6;1;7
2021;March;10;2021-03-02 00:00;98;1;3;4
2021;March;10;2021-03-02 00:00;99;4;0;4
2021;March;10;2021-03-02 00:00;100;1;1;2
2021;March;10;2021-03-02 00:00;101;1;0;1
2021;March;10;2021-03-02 00:00;102;0;1;1
2021;March;10;2021-03-02 00:00;109;1;0;1
2021;March;11;2021-03-09 00:00;0;42;44;86
2021;March;11;2021-03-09 00:00;1;212;181;393
2021;March;11;2021-03-09 00:00;2;196;211;407
2021;March;11;2021-03-09 00:00;3;213;238;451
2021;March;11;2021-03-09 00:00;4;206;224;430
2021;March;11;2021-03-09 00:00;5;206;235;441
2021;March;11;2021-03-09 00:00;6;220;237;457
2021;March;11;2021-03-09 00:00;7;213;253;466
2021;March;11;2021-03-09 00:00;8;219;247;466
2021;March;11;2021-03-09 00:00;9;210;212;422
2021;March;11;2021-03-09 00:00;10;226;240;466
2021;March;11;2021-03-09 00:00;11;237;241;478
2021;March;11;2021-03-09 00:00;12;213;234;447
2021;March;11;2021-03-09 00:00;13;213;207;420
2021;March;11;2021-03-09 00:00;14;197;210;407
2021;March;11;2021-03-09 00:00;15;231;212;443
2021;March;11;2021-03-09 00:00;16;195;223;418
2021;March;11;2021-03-09 00:00;17;192;212;404
2021;March;11;2021-03-09 00:00;18;177;195;372
2021;March;11;2021-03-09 00:00;19;187;225;412
2021;March;11;2021-03-09 00:00;20;136;182;318
2021;March;11;2021-03-09 00:00;21;160;189;349
2021;March;11;2021-03-09 00:00;22;141;196;337
2021;March;11;2021-03-09 00:00;23;123;150;273
2021;March;11;2021-03-09 00:00;24;136;168;304
2021;March;11;2021-03-09 00:00;25;145;171;316
2021;March;11;2021-03-09 00:00;26;152;180;332
2021;March;11;2021-03-09 00:00;27;190;186;376
2021;March;11;2021-03-09 00:00;28;173;209;382
2021;March;11;2021-03-09 00:00;29;211;184;395
2021;March;11;2021-03-09 00:00;30;204;241;445
2021;March;11;2021-03-09 00:00;31;242;233;475
2021;March;11;2021-03-09 00:00;32;206;233;439
2021;March;11;2021-03-09 00:00;33;230;225;455
2021;March;11;2021-03-09 00:00;34;236;239;475
2021;March;11;2021-03-09 00:00;35;214;213;427
2021;March;11;2021-03-09 00:00;36;219;235;454
2021;March;11;2021-03-09 00:00;37;211;219;430
2021;March;11;2021-03-09 00:00;38;225;201;426
2021;March;11;2021-03-09 00:00;39;227;229;456
2021;March;11;2021-03-09 00:00;40;188;221;409
2021;March;11;2021-03-09 00:00;41;254;226;480
2021;March;11;2021-03-09 00:00;42;214;189;403
2021;March;11;2021-03-09 00:00;43;205;209;414
2021;March;11;2021-03-09 00:00;44;203;219;422
2021;March;11;2021-03-09 00:00;45;222;224;446
2021;March;11;2021-03-09 00:00;46;219;248;467
2021;March;11;2021-03-09 00:00;47;226;276;502
2021;March;11;2021-03-09 00:00;48;221;229;450
2021;March;11;2021-03-09 00:00;49;226;264;490
2021;March;11;2021-03-09 00:00;50;212;218;430
2021;March;11;2021-03-09 00:00;51;200;216;416
2021;March;11;2021-03-09 00:00;52;195;193;388
2021;March;11;2021-03-09 00:00;53;208;220;428
2021;March;11;2021-03-09 00:00;54;239;235;474
2021;March;11;2021-03-09 00:00;55;187;212;399
2021;March;11;2021-03-09 00:00;56;191;214;405
2021;March;11;2021-03-09 00:00;57;189;214;403
2021;March;11;2021-03-09 00:00;58;171;213;384
2021;March;11;2021-03-09 00:00;59;183;184;367
2021;March;11;2021-03-09 00:00;60;153;164;317
2021;March;11;2021-03-09 00:00;61;156;145;301
2021;March;11;2021-03-09 00:00;62;145;154;299
2021;March;11;2021-03-09 00:00;63;146;142;288
2021;March;11;2021-03-09 00:00;64;136;145;281
2021;March;11;2021-03-09 00:00;65;145;154;299
2021;March;11;2021-03-09 00:00;66;127;110;237
2021;March;11;2021-03-09 00:00;67;128;136;264
2021;March;11;2021-03-09 00:00;68;143;128;271
2021;March;11;2021-03-09 00:00;69;131;144;275
2021;March;11;2021-03-09 00:00;70;140;123;263
2021;March;11;2021-03-09 00:00;71;134;144;278
2021;March;11;2021-03-09 00:00;72;142;151;293
2021;March;11;2021-03-09 00:00;73;169;151;320
2021;March;11;2021-03-09 00:00;74;148;143;291
2021;March;11;2021-03-09 00:00;75;178;135;313
2021;March;11;2021-03-09 00:00;76;170;165;335
2021;March;11;2021-03-09 00:00;77;145;140;285
2021;March;11;2021-03-09 00:00;78;143;147;290
2021;March;11;2021-03-09 00:00;79;124;117;241
2021;March;11;2021-03-09 00:00;80;102;92;194
2021;March;11;2021-03-09 00:00;81;78;111;189
2021;March;11;2021-03-09 00:00;82;84;76;160
2021;March;11;2021-03-09 00:00;83;83;70;153
2021;March;11;2021-03-09 00:00;84;67;62;129
2021;March;11;2021-03-09 00:00;85;79;51;130
2021;March;11;2021-03-09 00:00;86;50;50;100
2021;March;11;2021-03-09 00:00;87;50;35;85
2021;March;11;2021-03-09 00:00;88;48;33;81
2021;March;11;2021-03-09 00:00;89;24;26;50
2021;March;11;2021-03-09 00:00;90;27;19;46
2021;March;11;2021-03-09 00:00;91;31;15;46
2021;March;11;2021-03-09 00:00;92;23;16;39
2021;March;11;2021-03-09 00:00;93;15;7;22
2021;March;11;2021-03-09 00:00;94;20;6;26
2021;March;11;2021-03-09 00:00;95;9;3;12
2021;March;11;2021-03-09 00:00;96;14;4;18
2021;March;11;2021-03-09 00:00;97;6;1;7
2021;March;11;2021-03-09 00:00;98;1;3;4
2021;March;11;2021-03-09 00:00;99;4;0;4
2021;March;11;2021-03-09 00:00;100;1;1;2
2021;March;11;2021-03-09 00:00;101;1;0;1
2021;March;11;2021-03-09 00:00;102;0;1;1
2021;March;11;2021-03-09 00:00;109;1;0;1
2021;March;12;2021-03-16 00:00;0;43;49;92
2021;March;12;2021-03-16 00:00;1;212;182;394
2021;March;12;2021-03-16 00:00;2;196;212;408
2021;March;12;2021-03-16 00:00;3;213;239;452
2021;March;12;2021-03-16 00:00;4;204;223;427
2021;March;12;2021-03-16 00:00;5;208;235;443
2021;March;12;2021-03-16 00:00;6;219;237;456
2021;March;12;2021-03-16 00:00;7;212;253;465
2021;March;12;2021-03-16 00:00;8;219;246;465
2021;March;12;2021-03-16 00:00;9;210;211;421
2021;March;12;2021-03-16 00:00;10;226;239;465
2021;March;12;2021-03-16 00:00;11;238;241;479
2021;March;12;2021-03-16 00:00;12;213;234;447
2021;March;12;2021-03-16 00:00;13;213;207;420
2021;March;12;2021-03-16 00:00;14;197;209;406
2021;March;12;2021-03-16 00:00;15;231;212;443
2021;March;12;2021-03-16 00:00;16;195;223;418
2021;March;12;2021-03-16 00:00;17;192;213;405
2021;March;12;2021-03-16 00:00;18;179;195;374
2021;March;12;2021-03-16 00:00;19;186;225;411
2021;March;12;2021-03-16 00:00;20;137;183;320
2021;March;12;2021-03-16 00:00;21;160;190;350
2021;March;12;2021-03-16 00:00;22;141;196;337
2021;March;12;2021-03-16 00:00;23;121;151;272
2021;March;12;2021-03-16 00:00;24;137;167;304
2021;March;12;2021-03-16 00:00;25;144;171;315
2021;March;12;2021-03-16 00:00;26;151;179;330
2021;March;12;2021-03-16 00:00;27;190;187;377
2021;March;12;2021-03-16 00:00;28;173;207;380
2021;March;12;2021-03-16 00:00;29;212;184;396
2021;March;12;2021-03-16 00:00;30;204;242;446
2021;March;12;2021-03-16 00:00;31;243;233;476
2021;March;12;2021-03-16 00:00;32;207;235;442
2021;March;12;2021-03-16 00:00;33;230;225;455
2021;March;12;2021-03-16 00:00;34;236;241;477
2021;March;12;2021-03-16 00:00;35;214;213;427
2021;March;12;2021-03-16 00:00;36;220;235;455
2021;March;12;2021-03-16 00:00;37;210;219;429
2021;March;12;2021-03-16 00:00;38;226;200;426
2021;March;12;2021-03-16 00:00;39;226;229;455
2021;March;12;2021-03-16 00:00;40;189;223;412
2021;March;12;2021-03-16 00:00;41;254;226;480
2021;March;12;2021-03-16 00:00;42;214;189;403
2021;March;12;2021-03-16 00:00;43;205;208;413
2021;March;12;2021-03-16 00:00;44;203;219;422
2021;March;12;2021-03-16 00:00;45;222;224;446
2021;March;12;2021-03-16 00:00;46;219;249;468
2021;March;12;2021-03-16 00:00;47;226;276;502
2021;March;12;2021-03-16 00:00;48;220;229;449
2021;March;12;2021-03-16 00:00;49;226;264;490
2021;March;12;2021-03-16 00:00;50;210;218;428
2021;March;12;2021-03-16 00:00;51;200;216;416
2021;March;12;2021-03-16 00:00;52;195;192;387
2021;March;12;2021-03-16 00:00;53;208;220;428
2021;March;12;2021-03-16 00:00;54;239;234;473
2021;March;12;2021-03-16 00:00;55;187;212;399
2021;March;12;2021-03-16 00:00;56;191;214;405
2021;March;12;2021-03-16 00:00;57;189;214;403
2021;March;12;2021-03-16 00:00;58;171;213;384
2021;March;12;2021-03-16 00:00;59;183;185;368
2021;March;12;2021-03-16 00:00;60;153;164;317
2021;March;12;2021-03-16 00:00;61;156;145;301
2021;March;12;2021-03-16 00:00;62;145;154;299
2021;March;12;2021-03-16 00:00;63;146;142;288
2021;March;12;2021-03-16 00:00;64;136;145;281
2021;March;12;2021-03-16 00:00;65;145;154;299
2021;March;12;2021-03-16 00:00;66;128;110;238
2021;March;12;2021-03-16 00:00;67;128;136;264
2021;March;12;2021-03-16 00:00;68;143;128;271
2021;March;12;2021-03-16 00:00;69;131;144;275
2021;March;12;2021-03-16 00:00;70;140;123;263
2021;March;12;2021-03-16 00:00;71;134;145;279
2021;March;12;2021-03-16 00:00;72;142;151;293
2021;March;12;2021-03-16 00:00;73;169;151;320
2021;March;12;2021-03-16 00:00;74;148;143;291
2021;March;12;2021-03-16 00:00;75;178;135;313
2021;March;12;2021-03-16 00:00;76;170;165;335
2021;March;12;2021-03-16 00:00;77;145;140;285
2021;March;12;2021-03-16 00:00;78;143;147;290
2021;March;12;2021-03-16 00:00;79;124;117;241
2021;March;12;2021-03-16 00:00;80;102;92;194
2021;March;12;2021-03-16 00:00;81;78;111;189
2021;March;12;2021-03-16 00:00;82;84;76;160
2021;March;12;2021-03-16 00:00;83;83;69;152
2021;March;12;2021-03-16 00:00;84;67;62;129
2021;March;12;2021-03-16 00:00;85;79;50;129
2021;March;12;2021-03-16 00:00;86;50;50;100
2021;March;12;2021-03-16 00:00;87;50;35;85
2021;March;12;2021-03-16 00:00;88;48;33;81
2021;March;12;2021-03-16 00:00;89;24;26;50
2021;March;12;2021-03-16 00:00;90;27;19;46
2021;March;12;2021-03-16 00:00;91;31;15;46
2021;March;12;2021-03-16 00:00;92;23;16;39
2021;March;12;2021-03-16 00:00;93;15;7;22
2021;March;12;2021-03-16 00:00;94;20;6;26
2021;March;12;2021-03-16 00:00;95;9;3;12
2021;March;12;2021-03-16 00:00;96;14;4;18
2021;March;12;2021-03-16 00:00;97;6;1;7
2021;March;12;2021-03-16 00:00;98;1;3;4
2021;March;12;2021-03-16 00:00;99;4;0;4
2021;March;12;2021-03-16 00:00;100;1;1;2
2021;March;12;2021-03-16 00:00;101;1;0;1
2021;March;12;2021-03-16 00:00;102;0;1;1
2021;March;12;2021-03-16 00:00;109;1;0;1
2021;March;13;2021-03-23 00:00;0;45;55;100
2021;March;13;2021-03-23 00:00;1;212;182;394
2021;March;13;2021-03-23 00:00;2;196;213;409
2021;March;13;2021-03-23 00:00;3;214;239;453
2021;March;13;2021-03-23 00:00;4;204;223;427
2021;March;13;2021-03-23 00:00;5;209;235;444
2021;March;13;2021-03-23 00:00;6;219;237;456
2021;March;13;2021-03-23 00:00;7;212;253;465
2021;March;13;2021-03-23 00:00;8;219;245;464
2021;March;13;2021-03-23 00:00;9;210;211;421
2021;March;13;2021-03-23 00:00;10;226;239;465
2021;March;13;2021-03-23 00:00;11;239;241;480
2021;March;13;2021-03-23 00:00;12;213;234;447
2021;March;13;2021-03-23 00:00;13;212;207;419
2021;March;13;2021-03-23 00:00;14;197;209;406
2021;March;13;2021-03-23 00:00;15;231;212;443
2021;March;13;2021-03-23 00:00;16;195;223;418
2021;March;13;2021-03-23 00:00;17;192;213;405
2021;March;13;2021-03-23 00:00;18;178;194;372
2021;March;13;2021-03-23 00:00;19;186;226;412
2021;March;13;2021-03-23 00:00;20;136;185;321
2021;March;13;2021-03-23 00:00;21;160;191;351
2021;March;13;2021-03-23 00:00;22;141;195;336
2021;March;13;2021-03-23 00:00;23;123;153;276
2021;March;13;2021-03-23 00:00;24;137;167;304
2021;March;13;2021-03-23 00:00;25;143;169;312
2021;March;13;2021-03-23 00:00;26;151;179;330
2021;March;13;2021-03-23 00:00;27;190;187;377
2021;March;13;2021-03-23 00:00;28;173;207;380
2021;March;13;2021-03-23 00:00;29;213;185;398
2021;March;13;2021-03-23 00:00;30;204;241;445
2021;March;13;2021-03-23 00:00;31;241;235;476
2021;March;13;2021-03-23 00:00;32;207;235;442
2021;March;13;2021-03-23 00:00;33;228;225;453
2021;March;13;2021-03-23 00:00;34;236;240;476
2021;March;13;2021-03-23 00:00;35;215;214;429
2021;March;13;2021-03-23 00:00;36;220;234;454
2021;March;13;2021-03-23 00:00;37;210;219;429
2021;March;13;2021-03-23 00:00;38;226;200;426
2021;March;13;2021-03-23 00:00;39;225;231;456
2021;March;13;2021-03-23 00:00;40;190;224;414
2021;March;13;2021-03-23 00:00;41;253;227;480
2021;March;13;2021-03-23 00:00;42;214;189;403
2021;March;13;2021-03-23 00:00;43;205;208;413
2021;March;13;2021-03-23 00:00;44;203;219;422
2021;March;13;2021-03-23 00:00;45;222;223;445
2021;March;13;2021-03-23 00:00;46;219;248;467
2021;March;13;2021-03-23 00:00;47;226;276;502
2021;March;13;2021-03-23 00:00;48;220;229;449
2021;March;13;2021-03-23 00:00;49;226;264;490
2021;March;13;2021-03-23 00:00;50;210;218;428
2021;March;13;2021-03-23 00:00;51;200;215;415
2021;March;13;2021-03-23 00:00;52;195;192;387
2021;March;13;2021-03-23 00:00;53;208;220;428
2021;March;13;2021-03-23 00:00;54;239;233;472
2021;March;13;2021-03-23 00:00;55;187;212;399
2021;March;13;2021-03-23 00:00;56;191;214;405
2021;March;13;2021-03-23 00:00;57;189;214;403
2021;March;13;2021-03-23 00:00;58;171;213;384
2021;March;13;2021-03-23 00:00;59;183;185;368
2021;March;13;2021-03-23 00:00;60;153;164;317
2021;March;13;2021-03-23 00:00;61;155;145;300
2021;March;13;2021-03-23 00:00;62;145;153;298
2021;March;13;2021-03-23 00:00;63;146;142;288
2021;March;13;2021-03-23 00:00;64;136;145;281
2021;March;13;2021-03-23 00:00;65;145;154;299
2021;March;13;2021-03-23 00:00;66;128;111;239
2021;March;13;2021-03-23 00:00;67;128;136;264
2021;March;13;2021-03-23 00:00;68;144;129;273
2021;March;13;2021-03-23 00:00;69;131;144;275
2021;March;13;2021-03-23 00:00;70;140;123;263
2021;March;13;2021-03-23 00:00;71;134;145;279
2021;March;13;2021-03-23 00:00;72;141;151;292
2021;March;13;2021-03-23 00:00;73;169;151;320
2021;March;13;2021-03-23 00:00;74;148;143;291
2021;March;13;2021-03-23 00:00;75;178;135;313
2021;March;13;2021-03-23 00:00;76;170;166;336
2021;March;13;2021-03-23 00:00;77;145;140;285
2021;March;13;2021-03-23 00:00;78;143;147;290
2021;March;13;2021-03-23 00:00;79;123;117;240
2021;March;13;2021-03-23 00:00;80;102;92;194
2021;March;13;2021-03-23 00:00;81;78;111;189
2021;March;13;2021-03-23 00:00;82;84;76;160
2021;March;13;2021-03-23 00:00;83;83;69;152
2021;March;13;2021-03-23 00:00;84;67;62;129
2021;March;13;2021-03-23 00:00;85;79;50;129
2021;March;13;2021-03-23 00:00;86;50;50;100
2021;March;13;2021-03-23 00:00;87;50;35;85
2021;March;13;2021-03-23 00:00;88;48;32;80
2021;March;13;2021-03-23 00:00;89;24;26;50
2021;March;13;2021-03-23 00:00;90;27;19;46
2021;March;13;2021-03-23 00:00;91;31;15;46
2021;March;13;2021-03-23 00:00;92;23;16;39
2021;March;13;2021-03-23 00:00;93;15;7;22
2021;March;13;2021-03-23 00:00;94;20;6;26
2021;March;13;2021-03-23 00:00;95;9;3;12
2021;March;13;2021-03-23 00:00;96;13;4;17
2021;March;13;2021-03-23 00:00;97;6;1;7
2021;March;13;2021-03-23 00:00;98;1;3;4
2021;March;13;2021-03-23 00:00;99;4;0;4
2021;March;13;2021-03-23 00:00;100;1;1;2
2021;March;13;2021-03-23 00:00;101;1;0;1
2021;March;13;2021-03-23 00:00;102;0;1;1
2021;March;13;2021-03-23 00:00;109;1;0;1
2021;March;14;2021-03-30 00:00;0;50;61;111
2021;March;14;2021-03-30 00:00;1;213;182;395
2021;March;14;2021-03-30 00:00;2;196;214;410
2021;March;14;2021-03-30 00:00;3;214;239;453
2021;March;14;2021-03-30 00:00;4;204;223;427
2021;March;14;2021-03-30 00:00;5;209;235;444
2021;March;14;2021-03-30 00:00;6;219;237;456
2021;March;14;2021-03-30 00:00;7;213;254;467
2021;March;14;2021-03-30 00:00;8;218;245;463
2021;March;14;2021-03-30 00:00;9;210;211;421
2021;March;14;2021-03-30 00:00;10;226;239;465
2021;March;14;2021-03-30 00:00;11;239;241;480
2021;March;14;2021-03-30 00:00;12;213;234;447
2021;March;14;2021-03-30 00:00;13;212;207;419
2021;March;14;2021-03-30 00:00;14;197;209;406
2021;March;14;2021-03-30 00:00;15;231;212;443
2021;March;14;2021-03-30 00:00;16;195;222;417
2021;March;14;2021-03-30 00:00;17;191;213;404
2021;March;14;2021-03-30 00:00;18;178;194;372
2021;March;14;2021-03-30 00:00;19;186;227;413
2021;March;14;2021-03-30 00:00;20;136;185;321
2021;March;14;2021-03-30 00:00;21;160;191;351
2021;March;14;2021-03-30 00:00;22;141;194;335
2021;March;14;2021-03-30 00:00;23;124;152;276
2021;March;14;2021-03-30 00:00;24;138;167;305
2021;March;14;2021-03-30 00:00;25;143;168;311
2021;March;14;2021-03-30 00:00;26;151;179;330
2021;March;14;2021-03-30 00:00;27;188;187;375
2021;March;14;2021-03-30 00:00;28;173;206;379
2021;March;14;2021-03-30 00:00;29;214;184;398
2021;March;14;2021-03-30 00:00;30;204;241;445
2021;March;14;2021-03-30 00:00;31;239;238;477
2021;March;14;2021-03-30 00:00;32;207;235;442
2021;March;14;2021-03-30 00:00;33;228;225;453
2021;March;14;2021-03-30 00:00;34;236;239;475
2021;March;14;2021-03-30 00:00;35;215;214;429
2021;March;14;2021-03-30 00:00;36;221;234;455
2021;March;14;2021-03-30 00:00;37;209;219;428
2021;March;14;2021-03-30 00:00;38;226;200;426
2021;March;14;2021-03-30 00:00;39;225;231;456
2021;March;14;2021-03-30 00:00;40;190;223;413
2021;March;14;2021-03-30 00:00;41;253;227;480
2021;March;14;2021-03-30 00:00;42;214;189;403
2021;March;14;2021-03-30 00:00;43;205;208;413
2021;March;14;2021-03-30 00:00;44;204;219;423
2021;March;14;2021-03-30 00:00;45;222;223;445
2021;March;14;2021-03-30 00:00;46;220;248;468
2021;March;14;2021-03-30 00:00;47;226;278;504
2021;March;14;2021-03-30 00:00;48;219;228;447
2021;March;14;2021-03-30 00:00;49;226;264;490
2021;March;14;2021-03-30 00:00;50;210;218;428
2021;March;14;2021-03-30 00:00;51;200;215;415
2021;March;14;2021-03-30 00:00;52;194;192;386
2021;March;14;2021-03-30 00:00;53;208;219;427
2021;March;14;2021-03-30 00:00;54;239;233;472
2021;March;14;2021-03-30 00:00;55;187;213;400
2021;March;14;2021-03-30 00:00;56;191;214;405
2021;March;14;2021-03-30 00:00;57;189;214;403
2021;March;14;2021-03-30 00:00;58;171;213;384
2021;March;14;2021-03-30 00:00;59;183;186;369
2021;March;14;2021-03-30 00:00;60;153;164;317
2021;March;14;2021-03-30 00:00;61;155;145;300
2021;March;14;2021-03-30 00:00;62;145;153;298
2021;March;14;2021-03-30 00:00;63;146;142;288
2021;March;14;2021-03-30 00:00;64;136;145;281
2021;March;14;2021-03-30 00:00;65;145;154;299
2021;March;14;2021-03-30 00:00;66;128;111;239
2021;March;14;2021-03-30 00:00;67;128;136;264
2021;March;14;2021-03-30 00:00;68;144;129;273
2021;March;14;2021-03-30 00:00;69;131;144;275
2021;March;14;2021-03-30 00:00;70;140;123;263
2021;March;14;2021-03-30 00:00;71;134;145;279
2021;March;14;2021-03-30 00:00;72;141;151;292
2021;March;14;2021-03-30 00:00;73;169;151;320
2021;March;14;2021-03-30 00:00;74;148;143;291
2021;March;14;2021-03-30 00:00;75;177;135;312
2021;March;14;2021-03-30 00:00;76;170;166;336
2021;March;14;2021-03-30 00:00;77;145;139;284
2021;March;14;2021-03-30 00:00;78;143;147;290
2021;March;14;2021-03-30 00:00;79;123;117;240
2021;March;14;2021-03-30 00:00;80;103;92;195
2021;March;14;2021-03-30 00:00;81;78;111;189
2021;March;14;2021-03-30 00:00;82;84;76;160
2021;March;14;2021-03-30 00:00;83;83;69;152
2021;March;14;2021-03-30 00:00;84;67;62;129
2021;March;14;2021-03-30 00:00;85;79;50;129
2021;March;14;2021-03-30 00:00;86;50;50;100
2021;March;14;2021-03-30 00:00;87;50;35;85
2021;March;14;2021-03-30 00:00;88;48;32;80
2021;March;14;2021-03-30 00:00;89;24;26;50
2021;March;14;2021-03-30 00:00;90;27;19;46
2021;March;14;2021-03-30 00:00;91;31;15;46
2021;March;14;2021-03-30 00:00;92;23;16;39
2021;March;14;2021-03-30 00:00;93;15;7;22
2021;March;14;2021-03-30 00:00;94;20;6;26
2021;March;14;2021-03-30 00:00;95;9;3;12
2021;March;14;2021-03-30 00:00;96;13;4;17
2021;March;14;2021-03-30 00:00;97;6;1;7
2021;March;14;2021-03-30 00:00;98;1;3;4
2021;March;14;2021-03-30 00:00;99;4;0;4
2021;March;14;2021-03-30 00:00;100;1;1;2
2021;March;14;2021-03-30 00:00;101;1;0;1
2021;March;14;2021-03-30 00:00;102;0;1;1
2021;March;14;2021-03-30 00:00;109;1;0;1
2021;April;15;2021-04-06 00:00;0;52;67;119
2021;April;15;2021-04-06 00:00;1;213;185;398
2021;April;15;2021-04-06 00:00;2;198;214;412
2021;April;15;2021-04-06 00:00;3;217;239;456
2021;April;15;2021-04-06 00:00;4;203;226;429
2021;April;15;2021-04-06 00:00;5;209;234;443
2021;April;15;2021-04-06 00:00;6;219;236;455
2021;April;15;2021-04-06 00:00;7;214;253;467
2021;April;15;2021-04-06 00:00;8;218;243;461
2021;April;15;2021-04-06 00:00;9;210;213;423
2021;April;15;2021-04-06 00:00;10;226;240;466
2021;April;15;2021-04-06 00:00;11;237;240;477
2021;April;15;2021-04-06 00:00;12;215;233;448
2021;April;15;2021-04-06 00:00;13;213;207;420
2021;April;15;2021-04-06 00:00;14;197;209;406
2021;April;15;2021-04-06 00:00;15;230;212;442
2021;April;15;2021-04-06 00:00;16;197;221;418
2021;April;15;2021-04-06 00:00;17;189;214;403
2021;April;15;2021-04-06 00:00;18;178;194;372
2021;April;15;2021-04-06 00:00;19;187;227;414
2021;April;15;2021-04-06 00:00;20;136;184;320
2021;April;15;2021-04-06 00:00;21;161;191;352
2021;April;15;2021-04-06 00:00;22;143;195;338
2021;April;15;2021-04-06 00:00;23;126;155;281
2021;April;15;2021-04-06 00:00;24;138;166;304
2021;April;15;2021-04-06 00:00;25;144;169;313
2021;April;15;2021-04-06 00:00;26;153;178;331
2021;April;15;2021-04-06 00:00;27;188;185;373
2021;April;15;2021-04-06 00:00;28;173;207;380
2021;April;15;2021-04-06 00:00;29;214;184;398
2021;April;15;2021-04-06 00:00;30;204;241;445
2021;April;15;2021-04-06 00:00;31;240;238;478
2021;April;15;2021-04-06 00:00;32;208;238;446
2021;April;15;2021-04-06 00:00;33;228;226;454
2021;April;15;2021-04-06 00:00;34;237;239;476
2021;April;15;2021-04-06 00:00;35;215;215;430
2021;April;15;2021-04-06 00:00;36;221;235;456
2021;April;15;2021-04-06 00:00;37;209;220;429
2021;April;15;2021-04-06 00:00;38;225;201;426
2021;April;15;2021-04-06 00:00;39;226;231;457
2021;April;15;2021-04-06 00:00;40;191;223;414
2021;April;15;2021-04-06 00:00;41;253;225;478
2021;April;15;2021-04-06 00:00;42;215;189;404
2021;April;15;2021-04-06 00:00;43;205;209;414
2021;April;15;2021-04-06 00:00;44;204;219;423
2021;April;15;2021-04-06 00:00;45;223;223;446
2021;April;15;2021-04-06 00:00;46;220;250;470
2021;April;15;2021-04-06 00:00;47;226;277;503
2021;April;15;2021-04-06 00:00;48;219;228;447
2021;April;15;2021-04-06 00:00;49;226;263;489
2021;April;15;2021-04-06 00:00;50;209;219;428
2021;April;15;2021-04-06 00:00;51;200;214;414
2021;April;15;2021-04-06 00:00;52;192;192;384
2021;April;15;2021-04-06 00:00;53;208;219;427
2021;April;15;2021-04-06 00:00;54;239;233;472
2021;April;15;2021-04-06 00:00;55;187;212;399
2021;April;15;2021-04-06 00:00;56;192;214;406
2021;April;15;2021-04-06 00:00;57;189;214;403
2021;April;15;2021-04-06 00:00;58;171;213;384
2021;April;15;2021-04-06 00:00;59;183;185;368
2021;April;15;2021-04-06 00:00;60;153;164;317
2021;April;15;2021-04-06 00:00;61;155;145;300
2021;April;15;2021-04-06 00:00;62;145;153;298
2021;April;15;2021-04-06 00:00;63;146;140;286
2021;April;15;2021-04-06 00:00;64;136;145;281
2021;April;15;2021-04-06 00:00;65;146;154;300
2021;April;15;2021-04-06 00:00;66;128;111;239
2021;April;15;2021-04-06 00:00;67;128;136;264
2021;April;15;2021-04-06 00:00;68;144;129;273
2021;April;15;2021-04-06 00:00;69;131;143;274
2021;April;15;2021-04-06 00:00;70;140;123;263
2021;April;15;2021-04-06 00:00;71;134;145;279
2021;April;15;2021-04-06 00:00;72;141;151;292
2021;April;15;2021-04-06 00:00;73;169;151;320
2021;April;15;2021-04-06 00:00;74;148;143;291
2021;April;15;2021-04-06 00:00;75;177;135;312
2021;April;15;2021-04-06 00:00;76;169;166;335
2021;April;15;2021-04-06 00:00;77;145;139;284
2021;April;15;2021-04-06 00:00;78;143;146;289
2021;April;15;2021-04-06 00:00;79;123;117;240
2021;April;15;2021-04-06 00:00;80;103;92;195
2021;April;15;2021-04-06 00:00;81;78;111;189
2021;April;15;2021-04-06 00:00;82;84;76;160
2021;April;15;2021-04-06 00:00;83;83;69;152
2021;April;15;2021-04-06 00:00;84;66;62;128
2021;April;15;2021-04-06 00:00;85;79;50;129
2021;April;15;2021-04-06 00:00;86;50;50;100
2021;April;15;2021-04-06 00:00;87;49;35;84
2021;April;15;2021-04-06 00:00;88;48;32;80
2021;April;15;2021-04-06 00:00;89;24;26;50
2021;April;15;2021-04-06 00:00;90;26;19;45
2021;April;15;2021-04-06 00:00;91;31;15;46
2021;April;15;2021-04-06 00:00;92;23;16;39
2021;April;15;2021-04-06 00:00;93;15;7;22
2021;April;15;2021-04-06 00:00;94;20;6;26
2021;April;15;2021-04-06 00:00;95;9;3;12
2021;April;15;2021-04-06 00:00;96;13;4;17
2021;April;15;2021-04-06 00:00;97;6;1;7
2021;April;15;2021-04-06 00:00;98;1;3;4
2021;April;15;2021-04-06 00:00;99;4;0;4
2021;April;15;2021-04-06 00:00;100;1;1;2
2021;April;15;2021-04-06 00:00;101;1;0;1
2021;April;15;2021-04-06 00:00;102;0;1;1
2021;April;15;2021-04-06 00:00;109;1;0;1
2021;April;16;2021-04-13 00:00;0;55;71;126
2021;April;16;2021-04-13 00:00;1;213;185;398
2021;April;16;2021-04-13 00:00;2;198;214;412
2021;April;16;2021-04-13 00:00;3;217;239;456
2021;April;16;2021-04-13 00:00;4;203;226;429
2021;April;16;2021-04-13 00:00;5;210;235;445
2021;April;16;2021-04-13 00:00;6;220;236;456
2021;April;16;2021-04-13 00:00;7;214;253;467
2021;April;16;2021-04-13 00:00;8;218;243;461
2021;April;16;2021-04-13 00:00;9;210;213;423
2021;April;16;2021-04-13 00:00;10;225;240;465
2021;April;16;2021-04-13 00:00;11;237;240;477
2021;April;16;2021-04-13 00:00;12;215;233;448
2021;April;16;2021-04-13 00:00;13;213;207;420
2021;April;16;2021-04-13 00:00;14;197;209;406
2021;April;16;2021-04-13 00:00;15;230;212;442
2021;April;16;2021-04-13 00:00;16;197;221;418
2021;April;16;2021-04-13 00:00;17;189;214;403
2021;April;16;2021-04-13 00:00;18;177;194;371
2021;April;16;2021-04-13 00:00;19;187;226;413
2021;April;16;2021-04-13 00:00;20;134;184;318
2021;April;16;2021-04-13 00:00;21;161;190;351
2021;April;16;2021-04-13 00:00;22;143;194;337
2021;April;16;2021-04-13 00:00;23;126;154;280
2021;April;16;2021-04-13 00:00;24;137;166;303
2021;April;16;2021-04-13 00:00;25;144;169;313
2021;April;16;2021-04-13 00:00;26;153;177;330
2021;April;16;2021-04-13 00:00;27;189;185;374
2021;April;16;2021-04-13 00:00;28;173;206;379
2021;April;16;2021-04-13 00:00;29;216;183;399
2021;April;16;2021-04-13 00:00;30;204;241;445
2021;April;16;2021-04-13 00:00;31;240;238;478
2021;April;16;2021-04-13 00:00;32;207;238;445
2021;April;16;2021-04-13 00:00;33;227;226;453
2021;April;16;2021-04-13 00:00;34;237;240;477
2021;April;16;2021-04-13 00:00;35;215;216;431
2021;April;16;2021-04-13 00:00;36;221;235;456
2021;April;16;2021-04-13 00:00;37;209;220;429
2021;April;16;2021-04-13 00:00;38;225;200;425
2021;April;16;2021-04-13 00:00;39;226;230;456
2021;April;16;2021-04-13 00:00;40;192;223;415
2021;April;16;2021-04-13 00:00;41;253;226;479
2021;April;16;2021-04-13 00:00;42;215;189;404
2021;April;16;2021-04-13 00:00;43;205;209;414
2021;April;16;2021-04-13 00:00;44;204;219;423
2021;April;16;2021-04-13 00:00;45;223;223;446
2021;April;16;2021-04-13 00:00;46;220;250;470
2021;April;16;2021-04-13 00:00;47;226;277;503
2021;April;16;2021-04-13 00:00;48;219;229;448
2021;April;16;2021-04-13 00:00;49;226;263;489
2021;April;16;2021-04-13 00:00;50;209;219;428
2021;April;16;2021-04-13 00:00;51;200;214;414
2021;April;16;2021-04-13 00:00;52;192;192;384
2021;April;16;2021-04-13 00:00;53;208;219;427
2021;April;16;2021-04-13 00:00;54;238;233;471
2021;April;16;2021-04-13 00:00;55;187;212;399
2021;April;16;2021-04-13 00:00;56;192;214;406
2021;April;16;2021-04-13 00:00;57;189;214;403
2021;April;16;2021-04-13 00:00;58;171;213;384
2021;April;16;2021-04-13 00:00;59;183;185;368
2021;April;16;2021-04-13 00:00;60;153;164;317
2021;April;16;2021-04-13 00:00;61;155;145;300
2021;April;16;2021-04-13 00:00;62;145;153;298
2021;April;16;2021-04-13 00:00;63;146;140;286
2021;April;16;2021-04-13 00:00;64;136;145;281
2021;April;16;2021-04-13 00:00;65;146;154;300
2021;April;16;2021-04-13 00:00;66;128;111;239
2021;April;16;2021-04-13 00:00;67;128;137;265
2021;April;16;2021-04-13 00:00;68;144;129;273
2021;April;16;2021-04-13 00:00;69;131;143;274
2021;April;16;2021-04-13 00:00;70;140;123;263
2021;April;16;2021-04-13 00:00;71;133;145;278
2021;April;16;2021-04-13 00:00;72;141;151;292
2021;April;16;2021-04-13 00:00;73;170;151;321
2021;April;16;2021-04-13 00:00;74;148;143;291
2021;April;16;2021-04-13 00:00;75;177;135;312
2021;April;16;2021-04-13 00:00;76;169;167;336
2021;April;16;2021-04-13 00:00;77;145;139;284
2021;April;16;2021-04-13 00:00;78;143;146;289
2021;April;16;2021-04-13 00:00;79;122;117;239
2021;April;16;2021-04-13 00:00;80;103;92;195
2021;April;16;2021-04-13 00:00;81;78;111;189
2021;April;16;2021-04-13 00:00;82;84;76;160
2021;April;16;2021-04-13 00:00;83;83;69;152
2021;April;16;2021-04-13 00:00;84;66;62;128
2021;April;16;2021-04-13 00:00;85;79;50;129
2021;April;16;2021-04-13 00:00;86;49;50;99
2021;April;16;2021-04-13 00:00;87;49;35;84
2021;April;16;2021-04-13 00:00;88;48;32;80
2021;April;16;2021-04-13 00:00;89;24;25;49
2021;April;16;2021-04-13 00:00;90;25;19;44
2021;April;16;2021-04-13 00:00;91;30;15;45
2021;April;16;2021-04-13 00:00;92;23;16;39
2021;April;16;2021-04-13 00:00;93;15;7;22
2021;April;16;2021-04-13 00:00;94;20;6;26
2021;April;16;2021-04-13 00:00;95;9;3;12
2021;April;16;2021-04-13 00:00;96;13;4;17
2021;April;16;2021-04-13 00:00;97;6;1;7
2021;April;16;2021-04-13 00:00;98;1;3;4
2021;April;16;2021-04-13 00:00;99;4;0;4
2021;April;16;2021-04-13 00:00;100;1;1;2
2021;April;16;2021-04-13 00:00;101;1;0;1
2021;April;16;2021-04-13 00:00;102;0;1;1
2021;April;16;2021-04-13 00:00;109;1;0;1
2021;April;17;2021-04-20 00:00;0;59;74;133
2021;April;17;2021-04-20 00:00;1;212;186;398
2021;April;17;2021-04-20 00:00;2;198;214;412
2021;April;17;2021-04-20 00:00;3;217;239;456
2021;April;17;2021-04-20 00:00;4;204;226;430
2021;April;17;2021-04-20 00:00;5;210;234;444
2021;April;17;2021-04-20 00:00;6;220;237;457
2021;April;17;2021-04-20 00:00;7;214;253;467
2021;April;17;2021-04-20 00:00;8;219;243;462
2021;April;17;2021-04-20 00:00;9;211;213;424
2021;April;17;2021-04-20 00:00;10;225;240;465
2021;April;17;2021-04-20 00:00;11;237;240;477
2021;April;17;2021-04-20 00:00;12;215;233;448
2021;April;17;2021-04-20 00:00;13;213;207;420
2021;April;17;2021-04-20 00:00;14;197;209;406
2021;April;17;2021-04-20 00:00;15;230;212;442
2021;April;17;2021-04-20 00:00;16;197;221;418
2021;April;17;2021-04-20 00:00;17;189;214;403
2021;April;17;2021-04-20 00:00;18;177;194;371
2021;April;17;2021-04-20 00:00;19;187;226;413
2021;April;17;2021-04-20 00:00;20;134;184;318
2021;April;17;2021-04-20 00:00;21;160;190;350
2021;April;17;2021-04-20 00:00;22;141;193;334
2021;April;17;2021-04-20 00:00;23;127;155;282
2021;April;17;2021-04-20 00:00;24;136;167;303
2021;April;17;2021-04-20 00:00;25;144;169;313
2021;April;17;2021-04-20 00:00;26;151;177;328
2021;April;17;2021-04-20 00:00;27;189;185;374
2021;April;17;2021-04-20 00:00;28;171;206;377
2021;April;17;2021-04-20 00:00;29;215;184;399
2021;April;17;2021-04-20 00:00;30;204;239;443
2021;April;17;2021-04-20 00:00;31;240;238;478
2021;April;17;2021-04-20 00:00;32;208;238;446
2021;April;17;2021-04-20 00:00;33;227;227;454
2021;April;17;2021-04-20 00:00;34;236;241;477
2021;April;17;2021-04-20 00:00;35;216;216;432
2021;April;17;2021-04-20 00:00;36;222;232;454
2021;April;17;2021-04-20 00:00;37;209;220;429
2021;April;17;2021-04-20 00:00;38;225;200;425
2021;April;17;2021-04-20 00:00;39;226;229;455
2021;April;17;2021-04-20 00:00;40;192;223;415
2021;April;17;2021-04-20 00:00;41;252;225;477
2021;April;17;2021-04-20 00:00;42;215;189;404
2021;April;17;2021-04-20 00:00;43;205;209;414
2021;April;17;2021-04-20 00:00;44;204;218;422
2021;April;17;2021-04-20 00:00;45;223;223;446
2021;April;17;2021-04-20 00:00;46;220;251;471
2021;April;17;2021-04-20 00:00;47;226;277;503
2021;April;17;2021-04-20 00:00;48;219;229;448
2021;April;17;2021-04-20 00:00;49;226;263;489
2021;April;17;2021-04-20 00:00;50;209;219;428
2021;April;17;2021-04-20 00:00;51;200;214;414
2021;April;17;2021-04-20 00:00;52;192;192;384
2021;April;17;2021-04-20 00:00;53;208;218;426
2021;April;17;2021-04-20 00:00;54;238;233;471
2021;April;17;2021-04-20 00:00;55;187;212;399
2021;April;17;2021-04-20 00:00;56;192;214;406
2021;April;17;2021-04-20 00:00;57;189;214;403
2021;April;17;2021-04-20 00:00;58;171;214;385
2021;April;17;2021-04-20 00:00;59;183;185;368
2021;April;17;2021-04-20 00:00;60;153;164;317
2021;April;17;2021-04-20 00:00;61;155;145;300
2021;April;17;2021-04-20 00:00;62;145;152;297
2021;April;17;2021-04-20 00:00;63;146;141;287
2021;April;17;2021-04-20 00:00;64;136;145;281
2021;April;17;2021-04-20 00:00;65;146;154;300
2021;April;17;2021-04-20 00:00;66;128;111;239
2021;April;17;2021-04-20 00:00;67;128;137;265
2021;April;17;2021-04-20 00:00;68;144;128;272
2021;April;17;2021-04-20 00:00;69;131;143;274
2021;April;17;2021-04-20 00:00;70;140;123;263
2021;April;17;2021-04-20 00:00;71;133;145;278
2021;April;17;2021-04-20 00:00;72;141;150;291
2021;April;17;2021-04-20 00:00;73;170;151;321
2021;April;17;2021-04-20 00:00;74;148;143;291
2021;April;17;2021-04-20 00:00;75;177;135;312
2021;April;17;2021-04-20 00:00;76;169;167;336
2021;April;17;2021-04-20 00:00;77;145;139;284
2021;April;17;2021-04-20 00:00;78;143;145;288
2021;April;17;2021-04-20 00:00;79;121;116;237
2021;April;17;2021-04-20 00:00;80;103;92;195
2021;April;17;2021-04-20 00:00;81;78;111;189
2021;April;17;2021-04-20 00:00;82;84;76;160
2021;April;17;2021-04-20 00:00;83;82;69;151
2021;April;17;2021-04-20 00:00;84;66;62;128
2021;April;17;2021-04-20 00:00;85;79;50;129
2021;April;17;2021-04-20 00:00;86;49;50;99
2021;April;17;2021-04-20 00:00;87;49;35;84
2021;April;17;2021-04-20 00:00;88;48;32;80
2021;April;17;2021-04-20 00:00;89;24;25;49
2021;April;17;2021-04-20 00:00;90;25;19;44
2021;April;17;2021-04-20 00:00;91;30;15;45
2021;April;17;2021-04-20 00:00;92;23;16;39
2021;April;17;2021-04-20 00:00;93;15;7;22
2021;April;17;2021-04-20 00:00;94;20;6;26
2021;April;17;2021-04-20 00:00;95;9;3;12
2021;April;17;2021-04-20 00:00;96;13;4;17
2021;April;17;2021-04-20 00:00;97;6;1;7
2021;April;17;2021-04-20 00:00;98;1;3;4
2021;April;17;2021-04-20 00:00;99;4;0;4
2021;April;17;2021-04-20 00:00;100;1;1;2
2021;April;17;2021-04-20 00:00;101;1;0;1
2021;April;17;2021-04-20 00:00;102;0;1;1
2021;April;17;2021-04-20 00:00;109;1;0;1
